ID,x,y,last_snow,first_snow,ssl,swi,sfgws,year,scv,sos,eos,dop,pkv,climatic_balance,T_max_summer,TTP,Elev,DAH
8500,510918.098,5317555.876,0,0,0,75.096,0,2001,1,84,295,177,0.850445806890035,132.4,18.6461538461538,93,1225.56853483384,1.46245862315649
8500,510918.098,5317555.876,86,68,18,32.092,0,2002,1,119,308,176,0.854139507482373,16.8,18.7835164835165,57,1225.56853483384,1.46245862315649
8500,510918.098,5317555.876,167,73,94,37.132,0,2003,2,112,273,162,0.848604133335601,-183.3,23.7846153846154,50,1225.56853483384,1.46245862315649
8500,510918.098,5317555.876,168,93,75,20.98,0,2004,2,131,310,192,0.827436077723798,172.3,18.1252747252747,61,1225.56853483384,1.46245862315649
8500,510918.098,5317555.876,0,0,0,39.471,0,2005,0,116,311,176,0.85153027628324,30.6,18.5846153846154,60,1225.56853483384,1.46245862315649
8500,510918.098,5317555.876,181,67,114,59.097,4,2006,2,99,322,177,0.832459420321115,135.7,19.5065934065934,78,1225.56853483384,1.46245862315649
8500,510918.098,5317555.876,0,0,0,40.009,0,2007,0,103,301,168,0.830340613631517,409.3,17.4857142857143,65,1225.56853483384,1.46245862315649
8500,510918.098,5317555.876,134,55,79,26.403,0,2008,2,121,306,169,0.890146146507036,164.5,18.1175824175824,48,1225.56853483384,1.46245862315649
8500,510918.098,5317555.876,176,67,109,46.082,0,2009,2,98,301,161,0.858489127452046,128,19.1692307692308,63,1225.56853483384,1.46245862315649
8500,510918.098,5317555.876,180,93,87,26.191,0,2010,1,124,295,177,0.830451396881439,150.1,19.1098901098901,53,1225.56853483384,1.46245862315649
8500,510918.098,5317555.876,81,54,27,31.733,0,2011,1,102,320,168,0.804996561628982,247.5,18.0252747252747,66,1225.56853483384,1.46245862315649
8500,510918.098,5317555.876,161,80,81,40.893,0,2012,2,115,307,170,0.838039074744041,242,19.010989010989,55,1225.56853483384,1.46245862315649
8500,510918.098,5317555.876,180,79,101,32.283,0,2013,2,123,298,177,0.834048555446242,-87.9,19.8054945054945,54,1225.56853483384,1.46245862315649
8500,510918.098,5317555.876,160,52,108,42.28,0,2014,2,103,319,177,0.852133939451657,260.2,18.2120879120879,74,1225.56853483384,1.46245862315649
8500,510918.098,5317555.876,169,93,76,40.306,0,2015,1,112,327,176,0.846675726884867,-110.3,21.1989010989011,64,1225.56853483384,1.46245862315649
8500,510918.098,5317555.876,180,93,87,32.22,0,2016,1,123,320,177,0.855854749244608,32.5,19.3307692307692,54,1225.56853483384,1.46245862315649
8500,510918.098,5317555.876,148,94,54,31.754,0,2017,1,119,298,169,0.80008900167798,47.8,20.7450549450549,50,1225.56853483384,1.46245862315649
8500,510918.098,5317555.876,171,82,89,40.445,0,2018,2,103,302,177,0.826247398197614,-151.8,21.7142857142857,74,1225.56853483384,1.46245862315649
8500,510918.098,5317555.876,163,93,70,25.263,0,2019,1,127,326,176,0.80356733153692,-106.5,21.9758241758242,49,1225.56853483384,1.46245862315649
8500,510918.098,5317555.876,0,0,0,32.317,0,2020,0,109,283,169,0.796336767115361,-11.7,20.0010989010989,60,1225.56853483384,1.46245862315649
8502,510918.098,5317092.563,86,85,1,115.971,21,2001,3,52,328,185,0.834344107592947,132.4,18.6461538461538,133,1142.74512046594,-1.08870150214735
8502,510918.098,5317092.563,86,83,3,37.146,0,2002,1,113,313,169,0.877145225546227,16.8,18.7835164835165,56,1142.74512046594,-1.08870150214735
8502,510918.098,5317092.563,163,93,70,40.232,0,2003,1,108,303,161,0.877388109259541,-183.3,23.7846153846154,53,1142.74512046594,-1.08870150214735
8502,510918.098,5317092.563,170,59,111,35.727,0,2004,2,115,318,168,0.844323240284227,172.3,18.1252747252747,53,1142.74512046594,-1.08870150214735
8502,510918.098,5317092.563,152,103,49,50.254,0,2005,1,106,312,169,0.880005008141877,30.6,18.5846153846154,63,1142.74512046594,-1.08870150214735
8502,510918.098,5317092.563,191,61,130,32.146,0,2006,2,123,335,177,0.840188058084522,135.7,19.5065934065934,54,1142.74512046594,-1.08870150214735
8502,510918.098,5317092.563,165,96,69,46.158,0,2007,2,96,301,234,0.83865151249319,409.3,17.4857142857143,138,1142.74512046594,-1.08870150214735
8502,510918.098,5317092.563,81,67,14,26.403,0,2008,1,121,303,241,0.877909944398838,164.5,18.1175824175824,120,1142.74512046594,-1.08870150214735
8502,510918.098,5317092.563,182,60,122,35.88,0,2009,2,109,301,153,0.865413721288331,128,19.1692307692308,44,1142.74512046594,-1.08870150214735
8502,510918.098,5317092.563,176,69,107,31.469,0,2010,2,117,306,161,0.843953216966598,150.1,19.1098901098901,44,1142.74512046594,-1.08870150214735
8502,510918.098,5317092.563,126,94,32,39.169,0,2011,1,94,316,152,0.849405805732652,247.5,18.0252747252747,58,1142.74512046594,-1.08870150214735
8502,510918.098,5317092.563,158,81,77,46.311,0,2012,3,110,299,193,0.854987648557323,242,19.010989010989,83,1142.74512046594,-1.08870150214735
8502,510918.098,5317092.563,177,93,84,31.272,0,2013,2,124,306,208,0.810090405296902,-87.9,19.8054945054945,84,1142.74512046594,-1.08870150214735
8502,510918.098,5317092.563,159,68,91,43.773,0,2014,2,101,317,162,0.872362011882172,260.2,18.2120879120879,61,1142.74512046594,-1.08870150214735
8502,510918.098,5317092.563,163,94,69,65.494,4,2015,1,89,318,169,0.882091135124421,-110.3,21.1989010989011,80,1142.74512046594,-1.08870150214735
8502,510918.098,5317092.563,170,93,77,35.544,0,2016,2,120,323,217,0.848189140604566,32.5,19.3307692307692,97,1142.74512046594,-1.08870150214735
8502,510918.098,5317092.563,137,98,39,48.799,4,2017,1,97,293,162,0.8476232633296,47.8,20.7450549450549,65,1142.74512046594,-1.08870150214735
8502,510918.098,5317092.563,173,56,117,38.487,0,2018,2,105,308,161,0.859838154615532,-151.8,21.7142857142857,56,1142.74512046594,-1.08870150214735
8502,510918.098,5317092.563,140,97,43,35.326,3,2019,1,116,323,161,0.809575852702327,-106.5,21.9758241758242,45,1142.74512046594,-1.08870150214735
8502,510918.098,5317092.563,0,0,0,38.315,0,2020,0,100,291,160,0.812863565747426,-11.7,20.0010989010989,60,1142.74512046594,-1.08870150214735
9823,512308.036,5315470.969,110,93,17,73.784,8,2001,3,85,331,217,0.823236493476001,132.4,18.6461538461538,132,930.582908779053,1.44648311273647
9823,512308.036,5315470.969,0,0,0,52.497,0,2002,0,95,326,240,0.861158831073374,16.8,18.7835164835165,145,930.582908779053,1.44648311273647
9823,512308.036,5315470.969,143,93,50,56.145,7,2003,1,90,328,160,0.833216715371321,-183.3,23.7846153846154,70,930.582908779053,1.44648311273647
9823,512308.036,5315470.969,136,94,42,63.68,4,2004,2,88,335,184,0.844093685131169,172.3,18.1252747252747,96,930.582908779053,1.44648311273647
9823,512308.036,5315470.969,145,122,23,55.748,0,2005,2,101,317,264,0.872545650554108,30.6,18.5846153846154,163,930.582908779053,1.44648311273647
9823,512308.036,5315470.969,184,76,108,33.051,0,2006,3,122,339,217,0.858637553185945,135.7,19.5065934065934,95,930.582908779053,1.44648311273647
9823,512308.036,5315470.969,0,0,0,100.146,0,2007,0,47,299,193,0.847882189293994,409.3,17.4857142857143,146,930.582908779053,1.44648311273647
9823,512308.036,5315470.969,0,0,0,59.288,0,2008,0,92,309,162,0.871670200662721,164.5,18.1175824175824,70,930.582908779053,1.44648311273647
9823,512308.036,5315470.969,166,58,108,41.284,0,2009,2,103,330,161,0.860515264328718,128,19.1692307692308,58,930.582908779053,1.44648311273647
9823,512308.036,5315470.969,158,93,65,40.083,0,2010,1,107,310,176,0.86638801653734,150.1,19.1098901098901,69,930.582908779053,1.44648311273647
9823,512308.036,5315470.969,86,64,22,55.491,0,2011,1,76,322,162,0.851209047417632,247.5,18.0252747252747,86,930.582908779053,1.44648311273647
9823,512308.036,5315470.969,132,93,39,63.247,3,2012,2,90,318,194,0.846112967948911,242,19.010989010989,104,930.582908779053,1.44648311273647
9823,512308.036,5315470.969,178,94,84,40.389,0,2013,1,115,326,177,0.858369970846715,-87.9,19.8054945054945,62,930.582908779053,1.44648311273647
9823,512308.036,5315470.969,0,0,0,55.405,0,2014,0,87,318,176,0.846524604367979,260.2,18.2120879120879,89,930.582908779053,1.44648311273647
9823,512308.036,5315470.969,151,93,58,56.13,1,2015,1,96,340,160,0.840187463480169,-110.3,21.1989010989011,64,930.582908779053,1.44648311273647
9823,512308.036,5315470.969,165,93,72,54.159,4,2016,1,104,335,161,0.888710514307025,32.5,19.3307692307692,57,930.582908779053,1.44648311273647
9823,512308.036,5315470.969,0,0,0,84.183,0,2017,0,64,310,209,0.857992097829989,47.8,20.7450549450549,145,930.582908779053,1.44648311273647
9823,512308.036,5315470.969,86,63,23,45.644,0,2018,1,98,331,153,0.868671153731709,-151.8,21.7142857142857,55,930.582908779053,1.44648311273647
9823,512308.036,5315470.969,104,95,9,58.546,8,2019,1,90,337,168,0.818068641862739,-106.5,21.9758241758242,78,930.582908779053,1.44648311273647
9823,512308.036,5315470.969,0,0,0,77.012,0,2020,0,63,318,209,0.808536638573314,-11.7,20.0010989010989,146,930.582908779053,1.44648311273647
10049,512539.693,5313849.374,0,0,0,47.343,0,2001,3,107,321,226,0.875126756231989,132.4,18.6461538461538,119,1076.09717615558,0.0287814143343743
10049,512539.693,5313849.374,86,82,4,42.374,0,2002,1,107,288,218,0.890195812367214,16.8,18.7835164835165,111,1076.09717615558,0.0287814143343743
10049,512539.693,5313849.374,153,93,60,42.698,0,2003,1,105,319,146,0.859613148313894,-183.3,23.7846153846154,41,1076.09717615558,0.0287814143343743
10049,512539.693,5313849.374,147,103,44,41.497,0,2004,2,109,313,225,0.854268028645595,172.3,18.1252747252747,116,1076.09717615558,0.0287814143343743
10049,512539.693,5313849.374,0,0,0,56.964,0,2005,0,100,312,232,0.852381381300903,30.6,18.5846153846154,132,1076.09717615558,0.0287814143343743
10049,512539.693,5313849.374,176,64,112,54.189,1,2006,2,103,339,154,0.856338178763631,135.7,19.5065934065934,51,1076.09717615558,0.0287814143343743
10049,512539.693,5313849.374,0,0,0,62.64,0,2007,0,80,292,217,0.858277049861437,409.3,17.4857142857143,137,1076.09717615558,0.0287814143343743
10049,512539.693,5313849.374,0,0,0,24.401,0,2008,0,123,303,217,0.899925339709932,164.5,18.1175824175824,94,1076.09717615558,0.0287814143343743
10049,512539.693,5313849.374,171,59,112,38.612,0,2009,2,106,300,194,0.898680580500279,128,19.1692307692308,88,1076.09717615558,0.0287814143343743
10049,512539.693,5313849.374,164,93,71,31.469,0,2010,2,117,304,185,0.847825376307605,150.1,19.1098901098901,68,1076.09717615558,0.0287814143343743
10049,512539.693,5313849.374,86,67,19,43.075,0,2011,1,90,321,224,0.845927941860887,247.5,18.0252747252747,134,1076.09717615558,0.0287814143343743
10049,512539.693,5313849.374,148,99,49,47.261,0,2012,2,109,295,208,0.882368495742177,242,19.010989010989,99,1076.09717615558,0.0287814143343743
10049,512539.693,5313849.374,161,97,64,32.283,0,2013,2,123,298,200,0.867460908343235,-87.9,19.8054945054945,77,1076.09717615558,0.0287814143343743
10049,512539.693,5313849.374,86,69,17,51.86,0,2014,1,91,316,217,0.884270626803291,260.2,18.2120879120879,126,1076.09717615558,0.0287814143343743
10049,512539.693,5313849.374,163,93,70,48.544,0,2015,1,103,330,146,0.822888748269696,-110.3,21.1989010989011,43,1076.09717615558,0.0287814143343743
10049,512539.693,5313849.374,161,109,52,55.194,4,2016,1,103,307,193,0.849822361258938,32.5,19.3307692307692,90,1076.09717615558,0.0287814143343743
10049,512539.693,5313849.374,133,93,40,47.127,4,2017,2,99,310,224,0.851764875974267,47.8,20.7450549450549,125,1076.09717615558,0.0287814143343743
10049,512539.693,5313849.374,160,93,67,42.46,0,2018,1,101,304,153,0.889607133332679,-151.8,21.7142857142857,52,1076.09717615558,0.0287814143343743
10049,512539.693,5313849.374,147,93,54,41.224,3,2019,1,109,336,177,0.800201620353445,-106.5,21.9758241758242,68,1076.09717615558,0.0287814143343743
10049,512539.693,5313849.374,95,93,2,39.824,0,2020,1,98,307,153,0.80853174076328,-11.7,20.0010989010989,55,1076.09717615558,0.0287814143343743
10269,512771.349,5313617.718,0,0,0,58.477,0,2001,1,98,309,225,0.859834523282161,132.4,18.6461538461538,127,1070.00031768107,0.401819897640895
10269,512771.349,5313617.718,105,81,24,38.867,0,2002,3,111,298,224,0.870589044973732,16.8,18.7835164835165,113,1070.00031768107,0.401819897640895
10269,512771.349,5313617.718,0,0,0,38.686,0,2003,0,110,313,152,0.862640890887911,-183.3,23.7846153846154,42,1070.00031768107,0.401819897640895
10269,512771.349,5313617.718,146,93,53,38.617,0,2004,2,112,304,218,0.876967911440837,172.3,18.1252747252747,106,1070.00031768107,0.401819897640895
10269,512771.349,5313617.718,0,0,0,47.011,0,2005,0,109,313,154,0.849693556605343,30.6,18.5846153846154,45,1070.00031768107,0.401819897640895
10269,512771.349,5313617.718,178,100,78,51.728,1,2006,1,105,335,153,0.857043671068321,135.7,19.5065934065934,48,1070.00031768107,0.401819897640895
10269,512771.349,5313617.718,105,93,12,63.658,8,2007,2,79,290,217,0.873730870253487,409.3,17.4857142857143,138,1070.00031768107,0.401819897640895
10269,512771.349,5313617.718,85,83,2,24.401,0,2008,1,123,301,209,0.90370279448813,164.5,18.1175824175824,86,1070.00031768107,0.401819897640895
10269,512771.349,5313617.718,170,59,111,36.797,0,2009,2,108,296,193,0.891543096209226,128,19.1692307692308,85,1070.00031768107,0.401819897640895
10269,512771.349,5313617.718,159,93,66,29.214,0,2010,1,120,305,177,0.828758842915857,150.1,19.1098901098901,57,1070.00031768107,0.401819897640895
10269,512771.349,5313617.718,86,70,16,39.169,0,2011,1,94,319,145,0.856575324314653,247.5,18.0252747252747,51,1070.00031768107,0.401819897640895
10269,512771.349,5313617.718,153,93,60,43.275,0,2012,2,113,295,210,0.874691864206295,242,19.010989010989,97,1070.00031768107,0.401819897640895
10269,512771.349,5313617.718,173,93,80,28.284,0,2013,2,127,297,200,0.886083607371943,-87.9,19.8054945054945,73,1070.00031768107,0.401819897640895
10269,512771.349,5313617.718,141,115,26,48.524,0,2014,1,95,316,153,0.837861867514867,260.2,18.2120879120879,58,1070.00031768107,0.401819897640895
10269,512771.349,5313617.718,159,116,43,44.792,0,2015,1,107,329,146,0.861458880518612,-110.3,21.1989010989011,39,1070.00031768107,0.401819897640895
10269,512771.349,5313617.718,158,95,63,57.281,4,2016,2,101,302,185,0.880782013948858,32.5,19.3307692307692,84,1070.00031768107,0.401819897640895
10269,512771.349,5313617.718,120,94,26,42.509,4,2017,2,105,295,218,0.871345922654824,47.8,20.7450549450549,113,1070.00031768107,0.401819897640895
10269,512771.349,5313617.718,93,93,0,56.049,0,2018,1,89,292,153,0.872457566433916,-151.8,21.7142857142857,64,1070.00031768107,0.401819897640895
10269,512771.349,5313617.718,129,93,36,36.996,3,2019,2,114,328,185,0.786513370843286,-106.5,21.9758241758242,71,1070.00031768107,0.401819897640895
10269,512771.349,5313617.718,94,94,0,40.605,0,2020,2,97,301,185,0.81472853198764,-11.7,20.0010989010989,88,1070.00031768107,0.401819897640895
12223,514856.256,5317555.876,0,0,0,147.663,0,2001,1,25,332,233,0.877074312984289,132.4,18.6461538461538,208,936.728409547591,-1.50745812611129
12223,514856.256,5317555.876,86,85,1,75.181,6,2002,1,75,315,161,0.861290230968421,16.8,18.7835164835165,86,936.728409547591,-1.50745812611129
12223,514856.256,5317555.876,0,0,0,61.485,0,2003,0,84,334,153,0.848050039163135,-183.3,23.7846153846154,69,936.728409547591,-1.50745812611129
12223,514856.256,5317555.876,134,93,41,53.411,3,2004,2,98,328,265,0.878346889522521,172.3,18.1252747252747,167,936.728409547591,-1.50745812611129
12223,514856.256,5317555.876,0,0,0,64.837,0,2005,0,93,321,161,0.875955777650399,30.6,18.5846153846154,68,936.728409547591,-1.50745812611129
12223,514856.256,5317555.876,186,93,93,41.973,1,2006,2,113,341,242,0.825331487910202,135.7,19.5065934065934,129,936.728409547591,-1.50745812611129
12223,514856.256,5317555.876,0,0,0,94.368,0,2007,0,52,311,178,0.842595273930608,409.3,17.4857142857143,126,936.728409547591,-1.50745812611129
12223,514856.256,5317555.876,0,0,0,122.802,0,2008,0,35,310,241,0.865490180578601,164.5,18.1175824175824,206,936.728409547591,-1.50745812611129
12223,514856.256,5317555.876,161,63,98,42.202,0,2009,2,102,325,161,0.882852803363152,128,19.1692307692308,59,936.728409547591,-1.50745812611129
12223,514856.256,5317555.876,0,0,0,49.284,0,2010,0,98,315,160,0.85479116036896,150.1,19.1098901098901,62,936.728409547591,-1.50745812611129
12223,514856.256,5317555.876,86,74,12,60.721,0,2011,1,70,319,145,0.844447890399939,247.5,18.0252747252747,75,936.728409547591,-1.50745812611129
12223,514856.256,5317555.876,121,93,28,65.811,3,2012,2,87,325,240,0.818506278488217,242,19.010989010989,153,936.728409547591,-1.50745812611129
12223,514856.256,5317555.876,159,93,66,46.377,0,2013,1,109,325,169,0.842217542855508,-87.9,19.8054945054945,60,936.728409547591,-1.50745812611129
12223,514856.256,5317555.876,0,0,0,119.645,0,2014,0,28,320,169,0.836193889681809,260.2,18.2120879120879,141,936.728409547591,-1.50745812611129
12223,514856.256,5317555.876,143,94,49,60.002,3,2015,1,93,343,160,0.861521539033813,-110.3,21.1989010989011,67,936.728409547591,-1.50745812611129
12223,514856.256,5317555.876,153,98,55,68.286,4,2016,1,91,339,170,0.868678321751928,32.5,19.3307692307692,79,936.728409547591,-1.50745812611129
12223,514856.256,5317555.876,105,93,12,75.095,4,2017,1,71,313,161,0.834897589393221,47.8,20.7450549450549,90,936.728409547591,-1.50745812611129
12223,514856.256,5317555.876,0,0,0,60.473,0,2018,0,85,340,152,0.848356033626756,-151.8,21.7142857142857,67,936.728409547591,-1.50745812611129
12223,514856.256,5317555.876,0,0,0,63.347,0,2019,0,85,338,154,0.817332776085902,-106.5,21.9758241758242,69,936.728409547591,-1.50745812611129
12223,514856.256,5317555.876,0,0,0,61.35,0,2020,0,75,317,161,0.850295728102436,-11.7,20.0010989010989,86,936.728409547591,-1.50745812611129
12441,515087.913,5317787.532,0,0,0,129.317,0,2001,1,40,335,169,0.861254669170073,132.4,18.6461538461538,129,962.904482894329,0.0590671412368781
12441,515087.913,5317787.532,86,85,1,67.656,6,2002,1,81,333,154,0.864946438974352,16.8,18.7835164835165,73,962.904482894329,0.0590671412368781
12441,515087.913,5317787.532,93,93,0,53.498,7,2003,1,93,333,145,0.839225875236676,-183.3,23.7846153846154,52,962.904482894329,0.0590671412368781
12441,515087.913,5317787.532,131,94,37,61.559,3,2004,1,90,335,161,0.843692292272295,172.3,18.1252747252747,71,962.904482894329,0.0590671412368781
12441,515087.913,5317787.532,0,0,0,70.524,0,2005,0,88,322,153,0.884744044673961,30.6,18.5846153846154,65,962.904482894329,0.0590671412368781
12441,515087.913,5317787.532,180,93,87,51.728,1,2006,2,105,344,266,0.848550637358796,135.7,19.5065934065934,161,962.904482894329,0.0590671412368781
12441,515087.913,5317787.532,0,0,0,95.454,0,2007,0,51,319,170,0.847245522604018,409.3,17.4857142857143,119,962.904482894329,0.0590671412368781
12441,515087.913,5317787.532,0,0,0,72.777,0,2008,0,80,314,161,0.852658764197389,164.5,18.1175824175824,81,962.904482894329,0.0590671412368781
12441,515087.913,5317787.532,160,63,97,46.082,0,2009,2,98,326,160,0.877526424815795,128,19.1692307692308,62,962.904482894329,0.0590671412368781
12441,515087.913,5317787.532,0,0,0,57.842,0,2010,0,91,318,161,0.85335358593284,150.1,19.1098901098901,70,962.904482894329,0.0590671412368781
12441,515087.913,5317787.532,86,75,11,77.799,10,2011,1,52,324,145,0.844777740569136,247.5,18.0252747252747,93,962.904482894329,0.0590671412368781
12441,515087.913,5317787.532,123,93,30,60.018,3,2012,1,94,330,153,0.840182690425029,242,19.010989010989,59,962.904482894329,0.0590671412368781
12441,515087.913,5317787.532,159,95,64,47.433,0,2013,1,108,323,168,0.858071992400607,-87.9,19.8054945054945,60,962.904482894329,0.0590671412368781
12441,515087.913,5317787.532,0,0,0,69.022,0,2014,0,72,320,160,0.844982399402276,260.2,18.2120879120879,88,962.904482894329,0.0590671412368781
12441,515087.913,5317787.532,153,96,57,54.933,0,2015,1,97,345,146,0.869722098149137,-110.3,21.1989010989011,49,962.904482894329,0.0590671412368781
12441,515087.913,5317787.532,155,105,50,68.286,4,2016,1,91,335,185,0.82109817473099,32.5,19.3307692307692,94,962.904482894329,0.0590671412368781
12441,515087.913,5317787.532,106,93,13,73.924,4,2017,1,72,314,160,0.843439651244427,47.8,20.7450549450549,88,962.904482894329,0.0590671412368781
12441,515087.913,5317787.532,0,0,0,50.232,0,2018,0,94,343,152,0.874969832807959,-151.8,21.7142857142857,58,962.904482894329,0.0590671412368781
12441,515087.913,5317787.532,95,94,1,58.546,8,2019,1,90,328,160,0.822195589466524,-106.5,21.9758241758242,70,962.904482894329,0.0590671412368781
12441,515087.913,5317787.532,0,0,0,66.373,0,2020,0,71,321,153,0.834213193093982,-11.7,20.0010989010989,82,962.904482894329,0.0590671412368781
12641,515319.569,5322189.003,86,86,0,112.702,22,2001,1,51,325,209,0.827354964498002,2.3,18.3043956043956,158,1047.72914220899,-0.706861082845245
12641,515319.569,5322189.003,123,84,39,39.127,0,2002,2,110,315,177,0.827455703230854,17,18.367032967033,67,1047.72914220899,-0.706861082845245
12641,515319.569,5322189.003,145,93,52,36.234,1,2003,1,109,326,168,0.801546348802586,-202.5,23.1824175824176,59,1047.72914220899,-0.706861082845245
12641,515319.569,5322189.003,138,93,45,36.69,0,2004,1,112,322,169,0.88797134416719,121.9,17.978021978022,57,1047.72914220899,-0.706861082845245
12641,515319.569,5322189.003,153,93,60,53.285,0,2005,2,101,316,169,0.861975766897493,-39.2,18.1494505494505,68,1047.72914220899,-0.706861082845245
12641,515319.569,5322189.003,184,68,116,33.01,1,2006,2,119,338,169,0.852516008525058,40.8,19.1318681318681,50,1047.72914220899,-0.706861082845245
12641,515319.569,5322189.003,0,0,0,64.711,0,2007,0,78,300,178,0.867763739524882,255.4,17.3461538461538,100,1047.72914220899,-0.706861082845245
12641,515319.569,5322189.003,83,62,21,28.932,0,2008,1,118,306,194,0.81275207136526,25.7,17.7142857142857,76,1047.72914220899,-0.706861082845245
12641,515319.569,5322189.003,169,60,109,43.574,0,2009,2,100,308,162,0.882186174597281,27.7,18.6934065934066,62,1047.72914220899,-0.706861082845245
12641,515319.569,5322189.003,154,76,78,30.089,0,2010,2,116,311,184,0.870215967027401,84.7,18.4769230769231,68,1047.72914220899,-0.706861082845245
12641,515319.569,5322189.003,0,0,0,42.72,0,2011,0,88,323,154,0.835559576066506,122.2,17.8593406593407,66,1047.72914220899,-0.706861082845245
12641,515319.569,5322189.003,152,103,49,47.824,1,2012,1,105,311,169,0.868392081905857,17.4,19.3263736263736,64,1047.72914220899,-0.706861082845245
12641,515319.569,5322189.003,157,79,78,42.21,0,2013,2,112,294,169,0.875107169593176,-176.5,19.5032967032967,57,1047.72914220899,-0.706861082845245
12641,515319.569,5322189.003,142,95,47,46.411,0,2014,1,92,321,153,0.817037285123383,86.5,18.3582417582418,61,1047.72914220899,-0.706861082845245
12641,515319.569,5322189.003,141,102,39,43.431,0,2015,1,105,332,176,0.853480086941658,-204.4,21.3131868131868,71,1047.72914220899,-0.706861082845245
12641,515319.569,5322189.003,161,93,68,45.09,5,2016,2,110,331,186,0.878052368445731,-19.3,19.621978021978,76,1047.72914220899,-0.706861082845245
12641,515319.569,5322189.003,121,93,28,45.289,6,2017,1,97,300,168,0.823675865145746,-58,20.1758241758242,71,1047.72914220899,-0.706861082845245
12641,515319.569,5322189.003,162,77,85,45.298,0,2018,2,100,293,161,0.851595493337991,-127.7,20.8450549450549,61,1047.72914220899,-0.706861082845245
12641,515319.569,5322189.003,149,82,67,34.323,3,2019,2,115,336,169,0.815769096932823,-102.5,20.9692307692308,54,1047.72914220899,-0.706861082845245
12641,515319.569,5322189.003,0,0,0,39.699,0,2020,0,94,310,186,0.79229742732201,-100,19.1989010989011,92,1047.72914220899,-0.706861082845245
12660,515319.569,5317787.532,0,0,0,52.027,0,2001,1,103,335,176,0.853329654933632,132.4,18.6461538461538,73,910.247394901214,1.42343008285331
12660,515319.569,5317787.532,0,0,0,62.627,0,2002,0,85,330,153,0.858942312732094,16.8,18.7835164835165,68,910.247394901214,1.42343008285331
12660,515319.569,5317787.532,144,93,51,56.145,7,2003,1,90,332,152,0.838260574912492,-183.3,23.7846153846154,62,910.247394901214,1.42343008285331
12660,515319.569,5317787.532,149,93,56,48.696,0,2004,1,102,334,169,0.849734808380603,172.3,18.1252747252747,67,910.247394901214,1.42343008285331
12660,515319.569,5317787.532,0,0,0,61.745,0,2005,0,96,322,154,0.868165081404862,30.6,18.5846153846154,58,910.247394901214,1.42343008285331
12660,515319.569,5317787.532,178,77,101,47.914,1,2006,3,108,342,264,0.87347879090941,135.7,19.5065934065934,156,910.247394901214,1.42343008285331
12660,515319.569,5317787.532,0,0,0,83.994,0,2007,0,61,311,137,0.838855502240623,409.3,17.4857142857143,76,910.247394901214,1.42343008285331
12660,515319.569,5317787.532,0,0,0,81.652,0,2008,0,73,311,241,0.853927260237932,164.5,18.1175824175824,168,910.247394901214,1.42343008285331
12660,515319.569,5317787.532,164,61,103,45.078,0,2009,2,99,327,161,0.881045306356237,128,19.1692307692308,62,910.247394901214,1.42343008285331
12660,515319.569,5317787.532,150,97,53,46.039,1,2010,1,101,317,161,0.859406592540838,150.1,19.1098901098901,60,910.247394901214,1.42343008285331
12660,515319.569,5317787.532,86,80,6,64.274,1,2011,1,66,323,145,0.845927279597177,247.5,18.0252747252747,79,910.247394901214,1.42343008285331
12660,515319.569,5317787.532,135,94,41,61.609,3,2012,1,92,325,153,0.852124815618522,242,19.010989010989,61,910.247394901214,1.42343008285331
12660,515319.569,5317787.532,152,93,59,46.377,0,2013,1,109,321,168,0.865767790786841,-87.9,19.8054945054945,59,910.247394901214,1.42343008285331
12660,515319.569,5317787.532,0,0,0,72.963,0,2014,0,68,342,162,0.842952975731372,260.2,18.2120879120879,94,910.247394901214,1.42343008285331
12660,515319.569,5317787.532,155,96,59,53.782,0,2015,1,98,342,161,0.912873730888111,-110.3,21.1989010989011,63,910.247394901214,1.42343008285331
12660,515319.569,5317787.532,163,93,70,62.839,4,2016,1,96,332,161,0.851320597006558,32.5,19.3307692307692,65,910.247394901214,1.42343008285331
12660,515319.569,5317787.532,121,93,28,67.487,4,2017,1,78,315,161,0.831540282125615,47.8,20.7450549450549,83,910.247394901214,1.42343008285331
12660,515319.569,5317787.532,116,94,22,63.649,3,2018,1,82,315,153,0.869073662565068,-151.8,21.7142857142857,71,910.247394901214,1.42343008285331
12660,515319.569,5317787.532,133,93,40,59.467,8,2019,1,89,338,154,0.817622671466701,-106.5,21.9758241758242,65,910.247394901214,1.42343008285331
12660,515319.569,5317787.532,0,0,0,123.273,0,2020,0,25,320,169,0.836804251624398,-11.7,20.0010989010989,144,910.247394901214,1.42343008285331
12661,515319.569,5317555.876,0,0,0,110.562,0,2001,1,57,341,161,0.837725727005004,132.4,18.6461538461538,104,932.306657630798,0.625949629273284
12661,515319.569,5317555.876,0,0,0,63.796,0,2002,0,84,339,153,0.859996764524484,16.8,18.7835164835165,69,932.306657630798,0.625949629273284
12661,515319.569,5317555.876,144,94,50,57.015,7,2003,1,89,336,153,0.866785013031175,-183.3,23.7846153846154,64,932.306657630798,0.625949629273284
12661,515319.569,5317555.876,151,94,57,53.411,3,2004,1,98,337,160,0.869385662583692,172.3,18.1252747252747,62,932.306657630798,0.625949629273284
12661,515319.569,5317555.876,0,0,0,63.785,0,2005,0,94,321,153,0.894102255022085,30.6,18.5846153846154,59,932.306657630798,0.625949629273284
12661,515319.569,5317555.876,177,76,101,46.659,1,2006,3,109,345,265,0.869576863344327,135.7,19.5065934065934,156,932.306657630798,0.625949629273284
12661,515319.569,5317555.876,0,0,0,91.246,0,2007,0,55,312,137,0.850026105537327,409.3,17.4857142857143,82,932.306657630798,0.625949629273284
12661,515319.569,5317555.876,0,0,0,79.005,0,2008,0,75,314,161,0.834793148878444,164.5,18.1175824175824,86,932.306657630798,0.625949629273284
12661,515319.569,5317555.876,167,63,104,39.486,0,2009,2,105,328,153,0.888188578194748,128,19.1692307692308,48,932.306657630798,0.625949629273284
12661,515319.569,5317555.876,152,94,58,42.027,0,2010,1,105,320,161,0.865029530558816,150.1,19.1098901098901,56,932.306657630798,0.625949629273284
12661,515319.569,5317555.876,86,80,6,62.476,0,2011,1,68,324,153,0.872515501396565,247.5,18.0252747252747,85,932.306657630798,0.625949629273284
12661,515319.569,5317555.876,136,93,43,60.018,3,2012,1,94,324,153,0.85675845215388,242,19.010989010989,59,932.306657630798,0.625949629273284
12661,515319.569,5317555.876,153,93,60,48.526,0,2013,1,107,311,161,0.86975208347313,-87.9,19.8054945054945,54,932.306657630798,0.625949629273284
12661,515319.569,5317555.876,93,93,0,68.082,3,2014,1,73,345,160,0.852664821213557,260.2,18.2120879120879,87,932.306657630798,0.625949629273284
12661,515319.569,5317555.876,150,93,57,64.124,4,2015,1,90,346,160,0.915360014167779,-110.3,21.1989010989011,70,932.306657630798,0.625949629273284
12661,515319.569,5317555.876,162,93,69,68.286,4,2016,1,91,336,161,0.871088705047148,32.5,19.3307692307692,70,932.306657630798,0.625949629273284
12661,515319.569,5317555.876,121,93,28,68.564,4,2017,1,77,309,153,0.843115302994284,47.8,20.7450549450549,76,932.306657630798,0.625949629273284
12661,515319.569,5317555.876,129,93,36,51.344,0,2018,1,93,310,146,0.874913861001436,-151.8,21.7142857142857,53,932.306657630798,0.625949629273284
12661,515319.569,5317555.876,133,94,39,59.467,8,2019,1,89,339,153,0.834695761966716,-106.5,21.9758241758242,64,932.306657630798,0.625949629273284
12661,515319.569,5317555.876,0,0,0,120.366,0,2020,0,28,321,152,0.850278622598742,-11.7,20.0010989010989,124,932.306657630798,0.625949629273284
12841,515551.225,5326590.474,0,0,0,61.884,0,2001,1,93,299,177,0.875350444701322,2.3,18.3043956043956,84,1158.73053669339,1.07574789205534
12841,515551.225,5326590.474,93,68,25,31.482,0,2002,3,119,293,194,0.856758081498149,17,18.367032967033,75,1158.73053669339,1.07574789205534
12841,515551.225,5326590.474,153,85,68,30.476,0,2003,2,116,297,161,0.843935126755412,-202.5,23.1824175824176,45,1158.73053669339,1.07574789205534
12841,515551.225,5326590.474,153,93,60,30.354,0,2004,2,119,305,193,0.830469597605273,121.9,17.978021978022,74,1158.73053669339,1.07574789205534
12841,515551.225,5326590.474,0,0,0,48.9,0,2005,0,105,305,169,0.866514630326482,-39.2,18.1494505494505,64,1158.73053669339,1.07574789205534
12841,515551.225,5326590.474,177,60,117,42.062,1,2006,2,110,326,177,0.858876186812341,40.8,19.1318681318681,67,1158.73053669339,1.07574789205534
12841,515551.225,5326590.474,0,0,0,39.397,0,2007,0,103,302,209,0.839407558881841,255.4,17.3461538461538,106,1158.73053669339,1.07574789205534
12841,515551.225,5326590.474,86,74,12,45.001,2,2008,1,104,305,176,0.862447856123255,25.7,17.7142857142857,72,1158.73053669339,1.07574789205534
12841,515551.225,5326590.474,178,57,121,34.381,0,2009,3,110,298,233,0.835442034287592,27.7,18.6934065934066,123,1158.73053669339,1.07574789205534
12841,515551.225,5326590.474,158,65,93,27.817,0,2010,3,119,307,185,0.849865226939862,84.7,18.4769230769231,66,1158.73053669339,1.07574789205534
12841,515551.225,5326590.474,86,51,35,37.501,0,2011,1,94,309,161,0.852351179155912,122.2,17.8593406593407,67,1158.73053669339,1.07574789205534
12841,515551.225,5326590.474,150,71,79,35.312,0,2012,2,118,302,169,0.881656198835662,17.4,19.3263736263736,51,1158.73053669339,1.07574789205534
12841,515551.225,5326590.474,156,99,57,21.923,0,2013,1,132,303,185,0.859744437281742,-176.5,19.5032967032967,53,1158.73053669339,1.07574789205534
12841,515551.225,5326590.474,0,0,0,49.646,0,2014,0,88,322,193,0.886698434257503,86.5,18.3582417582418,105,1158.73053669339,1.07574789205534
12841,515551.225,5326590.474,153,83,70,37.258,0,2015,2,112,314,152,0.824388954415372,-204.4,21.3131868131868,40,1158.73053669339,1.07574789205534
12841,515551.225,5326590.474,161,93,68,43.927,5,2016,2,111,316,185,0.860882114031073,-19.3,19.621978021978,74,1158.73053669339,1.07574789205534
12841,515551.225,5326590.474,123,94,29,42.865,6,2017,2,100,298,224,0.849112262730017,-58,20.1758241758242,124,1158.73053669339,1.07574789205534
12841,515551.225,5326590.474,0,0,0,58.56,0,2018,0,88,314,162,0.83818291508994,-127.7,20.8450549450549,74,1158.73053669339,1.07574789205534
12841,515551.225,5326590.474,142,82,60,32.564,3,2019,2,117,318,169,0.818784258589155,-102.5,20.9692307692308,52,1158.73053669339,1.07574789205534
12841,515551.225,5326590.474,0,0,0,34.828,0,2020,0,100,288,201,0.82192325475273,-100,19.1989010989011,101,1158.73053669339,1.07574789205534
12842,515551.225,5326358.817,0,0,0,72.741,0,2001,1,84,323,185,0.872062950016105,2.3,18.3043956043956,101,1153.07893006895,1.26158534690751
12842,515551.225,5326358.817,93,71,22,34.042,0,2002,3,116,297,232,0.860990404100028,17,18.367032967033,116,1153.07893006895,1.26158534690751
12842,515551.225,5326358.817,151,78,73,29.649,0,2003,2,117,296,161,0.830864089222234,-202.5,23.1824175824176,44,1153.07893006895,1.26158534690751
12842,515551.225,5326358.817,155,93,62,31.216,0,2004,1,118,306,178,0.838210410303802,121.9,17.978021978022,60,1153.07893006895,1.26158534690751
12842,515551.225,5326358.817,0,0,0,45.778,0,2005,0,108,310,177,0.882536351400145,-39.2,18.1494505494505,69,1153.07893006895,1.26158534690751
12842,515551.225,5326358.817,178,63,115,37.889,1,2006,3,114,327,216,0.876988057182363,40.8,19.1318681318681,102,1153.07893006895,1.26158534690751
12842,515551.225,5326358.817,0,0,0,44.769,0,2007,0,97,304,177,0.845014904814815,255.4,17.3461538461538,80,1153.07893006895,1.26158534690751
12842,515551.225,5326358.817,86,75,11,16.014,0,2008,1,132,305,240,0.834111299485307,25.7,17.7142857142857,108,1153.07893006895,1.26158534690751
12842,515551.225,5326358.817,175,56,119,36.225,0,2009,2,108,290,169,0.875731436948856,27.7,18.6934065934066,61,1153.07893006895,1.26158534690751
12842,515551.225,5326358.817,159,63,96,27.101,0,2010,2,120,308,177,0.855084377922631,84.7,18.4769230769231,57,1153.07893006895,1.26158534690751
12842,515551.225,5326358.817,85,51,34,37.501,0,2011,1,94,314,162,0.834979867544254,122.2,17.8593406593407,68,1153.07893006895,1.26158534690751
12842,515551.225,5326358.817,146,74,72,39.698,0,2012,2,114,300,170,0.893307395999365,17.4,19.3263736263736,56,1153.07893006895,1.26158534690751
12842,515551.225,5326358.817,155,93,62,33.244,0,2013,1,121,302,177,0.862682010313623,-176.5,19.5032967032967,56,1153.07893006895,1.26158534690751
12842,515551.225,5326358.817,0,0,0,41.13,0,2014,0,99,322,200,0.885578486257436,86.5,18.3582417582418,101,1153.07893006895,1.26158534690751
12842,515551.225,5326358.817,151,83,68,38.096,0,2015,2,111,305,154,0.83403060706351,-204.4,21.3131868131868,43,1153.07893006895,1.26158534690751
12842,515551.225,5326358.817,167,93,74,38.544,4,2016,2,116,320,186,0.870350499994855,-19.3,19.621978021978,70,1153.07893006895,1.26158534690751
12842,515551.225,5326358.817,121,93,28,41.334,6,2017,2,102,298,217,0.832782792643822,-58,20.1758241758242,115,1153.07893006895,1.26158534690751
12842,515551.225,5326358.817,0,0,0,42.254,0,2018,0,103,306,161,0.853334872854109,-127.7,20.8450549450549,58,1153.07893006895,1.26158534690751
12842,515551.225,5326358.817,144,81,63,30.739,3,2019,2,119,326,169,0.808756137301689,-102.5,20.9692307692308,50,1153.07893006895,1.26158534690751
12842,515551.225,5326358.817,0,0,0,34.08,0,2020,0,101,301,184,0.817780297008642,-100,19.1989010989011,83,1153.07893006895,1.26158534690751
12880,515551.225,5317555.876,0,0,0,147.663,0,2001,1,25,337,160,0.839949074740779,132.4,18.6461538461538,135,902.209068974999,0.281319728248853
12880,515551.225,5317555.876,0,0,0,67.656,0,2002,0,81,339,153,0.849569505780317,16.8,18.7835164835165,72,902.209068974999,0.281319728248853
12880,515551.225,5317555.876,145,93,52,52.553,6,2003,1,94,336,152,0.863997890136617,-183.3,23.7846153846154,58,902.209068974999,0.281319728248853
12880,515551.225,5317555.876,150,97,53,52.205,2,2004,1,99,338,154,0.852639303920079,172.3,18.1252747252747,55,902.209068974999,0.281319728248853
12880,515551.225,5317555.876,0,0,0,142.207,0,2005,0,24,315,154,0.878494468001021,30.6,18.5846153846154,130,902.209068974999,0.281319728248853
12880,515551.225,5317555.876,180,74,106,44.224,1,2006,3,111,346,266,0.850700122304034,135.7,19.5065934065934,155,902.209068974999,0.281319728248853
12880,515551.225,5317555.876,0,0,0,91.246,0,2007,0,55,325,226,0.803511000004444,409.3,17.4857142857143,171,902.209068974999,0.281319728248853
12880,515551.225,5317555.876,0,0,0,66.14,0,2008,0,86,314,241,0.826603842891586,164.5,18.1175824175824,155,902.209068974999,0.281319728248853
12880,515551.225,5317555.876,158,63,95,53.709,0,2009,2,91,330,146,0.844979036875134,128,19.1692307692308,55,902.209068974999,0.281319728248853
12880,515551.225,5317555.876,152,97,55,43.019,0,2010,1,104,320,160,0.84747572684419,150.1,19.1098901098901,56,902.209068974999,0.281319728248853
12880,515551.225,5317555.876,86,80,6,57.234,0,2011,1,74,326,145,0.850249126775914,247.5,18.0252747252747,71,902.209068974999,0.281319728248853
12880,515551.225,5317555.876,136,93,43,60.018,3,2012,1,94,329,153,0.857854657598147,242,19.010989010989,59,902.209068974999,0.281319728248853
12880,515551.225,5317555.876,151,93,58,49.661,0,2013,1,106,310,168,0.862252065707946,-87.9,19.8054945054945,62,902.209068974999,0.281319728248853
12880,515551.225,5317555.876,93,93,0,70.952,3,2014,1,70,347,153,0.839961188443421,260.2,18.2120879120879,83,902.209068974999,0.281319728248853
12880,515551.225,5317555.876,151,93,58,60.002,3,2015,1,93,344,153,0.868356895904614,-110.3,21.1989010989011,60,902.209068974999,0.281319728248853
12880,515551.225,5317555.876,165,93,72,62.839,4,2016,1,96,341,168,0.869409934598212,32.5,19.3307692307692,72,902.209068974999,0.281319728248853
12880,515551.225,5317555.876,121,93,28,68.564,4,2017,1,77,305,160,0.815194329040225,47.8,20.7450549450549,83,902.209068974999,0.281319728248853
12880,515551.225,5317555.876,129,93,36,50.232,0,2018,1,94,311,146,0.854180139890973,-151.8,21.7142857142857,52,902.209068974999,0.281319728248853
12880,515551.225,5317555.876,133,94,39,54.999,7,2019,1,94,338,154,0.809252772099634,-106.5,21.9758241758242,60,902.209068974999,0.281319728248853
12880,515551.225,5317555.876,0,0,0,79.545,0,2020,0,61,323,153,0.826225589378771,-11.7,20.0010989010989,92,902.209068974999,0.281319728248853
13034,515782.882,5332613.539,93,93,0,44.032,5,2001,4,108,312,192,0.86986602496612,100,18.3626373626374,84,1179.3096652026,1.0008628271913
13034,515782.882,5332613.539,86,86,0,27.519,0,2002,1,122,304,184,0.871973565536675,41,18.3835164835165,62,1179.3096652026,1.0008628271913
13034,515782.882,5332613.539,162,93,69,33.072,0,2003,1,113,325,168,0.86102771808662,-198.1,23.2098901098901,55,1179.3096652026,1.0008628271913
13034,515782.882,5332613.539,158,93,65,27.712,0,2004,2,122,335,186,0.872414667615291,194.8,17.9131868131868,64,1179.3096652026,1.0008628271913
13034,515782.882,5332613.539,0,0,0,44.278,0,2005,0,110,300,177,0.874968700007786,31,18.1571428571429,67,1179.3096652026,1.0008628271913
13034,515782.882,5332613.539,191,83,108,20.244,0,2006,3,133,320,192,0.878553722779661,78,19.0967032967033,59,1179.3096652026,1.0008628271913
13034,515782.882,5332613.539,0,0,0,40.266,0,2007,0,102,294,177,0.872282218599417,310.2,17.2868131868132,75,1179.3096652026,1.0008628271913
13034,515782.882,5332613.539,86,59,27,19.676,0,2008,1,126,297,224,0.849040552532266,32.2,17.7648351648352,98,1179.3096652026,1.0008628271913
13034,515782.882,5332613.539,171,61,110,37.049,0,2009,2,104,307,169,0.892404870544468,41.4,18.6175824175824,65,1179.3096652026,1.0008628271913
13034,515782.882,5332613.539,167,93,74,25.647,0,2010,1,120,307,162,0.815132491693579,115,18.5978021978022,42,1179.3096652026,1.0008628271913
13034,515782.882,5332613.539,127,65,62,38.265,1,2011,3,92,319,192,0.847761741518943,115.3,18.0241758241758,100,1179.3096652026,1.0008628271913
13034,515782.882,5332613.539,152,93,59,24.553,0,2012,2,127,305,185,0.890913297988474,65.6,19.6395604395604,58,1179.3096652026,1.0008628271913
13034,515782.882,5332613.539,179,62,117,25.168,0,2013,3,129,293,186,0.878202530776781,-171.9,19.6505494505495,57,1179.3096652026,1.0008628271913
13034,515782.882,5332613.539,0,0,0,40.582,0,2014,0,97,314,209,0.863636700249427,167.8,18.5373626373626,112,1179.3096652026,1.0008628271913
13034,515782.882,5332613.539,165,93,72,31.651,0,2015,1,118,334,176,0.894470924184416,-170.8,21.5274725274725,58,1179.3096652026,1.0008628271913
13034,515782.882,5332613.539,171,100,71,27.686,0,2016,1,126,334,185,0.886115144035624,32.4,19.6758241758242,59,1179.3096652026,1.0008628271913
13034,515782.882,5332613.539,130,94,36,31.882,3,2017,2,114,293,216,0.865418328866841,-13.5,20.0351648351648,102,1179.3096652026,1.0008628271913
13034,515782.882,5332613.539,162,66,96,33.279,0,2018,2,111,320,177,0.882376036692887,-156.4,20.7978021978022,66,1179.3096652026,1.0008628271913
13034,515782.882,5332613.539,156,93,63,29.434,4,2019,2,120,316,185,0.847776273551802,-80.5,20.9483516483516,65,1179.3096652026,1.0008628271913
13034,515782.882,5332613.539,134,97,37,34.656,1,2020,1,98,287,177,0.820025653142222,-24.1,19.2450549450549,79,1179.3096652026,1.0008628271913
13062,515782.882,5326127.161,0,0,0,89.943,0,2001,1,71,311,184,0.874666178520476,2.3,18.3043956043956,113,1159.9922205197,-0.177764444392325
13062,515782.882,5326127.161,115,93,22,34.042,0,2002,2,116,288,194,0.871417972061083,17,18.367032967033,78,1159.9922205197,-0.177764444392325
13062,515782.882,5326127.161,155,93,62,32.131,0,2003,1,114,305,162,0.868163475277955,-202.5,23.1824175824176,48,1159.9922205197,-0.177764444392325
13062,515782.882,5326127.161,150,99,51,31.216,0,2004,1,118,301,178,0.85259672140885,121.9,17.978021978022,60,1159.9922205197,-0.177764444392325
13062,515782.882,5326127.161,153,129,24,46.844,0,2005,1,107,301,177,0.888886638849056,-39.2,18.1494505494505,70,1159.9922205197,-0.177764444392325
13062,515782.882,5326127.161,173,66,107,40.973,1,2006,2,111,323,162,0.860015555405093,40.8,19.1318681318681,51,1159.9922205197,-0.177764444392325
13062,515782.882,5326127.161,168,141,27,42.903,0,2007,1,99,300,177,0.855318429594012,255.4,17.3461538461538,78,1159.9922205197,-0.177764444392325
13062,515782.882,5326127.161,0,0,0,21.904,0,2008,0,125,303,216,0.86645434200902,25.7,17.7142857142857,91,1159.9922205197,-0.177764444392325
13062,515782.882,5326127.161,159,62,97,33.478,0,2009,2,111,296,177,0.94877530141554,27.7,18.6934065934066,66,1159.9922205197,-0.177764444392325
13062,515782.882,5326127.161,162,74,88,29.313,0,2010,2,117,302,177,0.871300624402973,84.7,18.4769230769231,60,1159.9922205197,-0.177764444392325
13062,515782.882,5326127.161,93,61,32,35.76,0,2011,2,96,317,169,0.855429965797396,122.2,17.8593406593407,73,1159.9922205197,-0.177764444392325
13062,515782.882,5326127.161,0,0,0,43.512,0,2012,0,110,307,168,0.884945614368082,17.4,19.3263736263736,58,1159.9922205197,-0.177764444392325
13062,515782.882,5326127.161,164,68,96,31.145,0,2013,2,123,304,185,0.880646747168376,-176.5,19.5032967032967,62,1159.9922205197,-0.177764444392325
13062,515782.882,5326127.161,0,0,0,42.597,0,2014,0,97,318,170,0.901283836277865,86.5,18.3582417582418,73,1159.9922205197,-0.177764444392325
13062,515782.882,5326127.161,145,93,52,36.444,0,2015,1,113,323,168,0.89663503146822,-204.4,21.3131868131868,55,1159.9922205197,-0.177764444392325
13062,515782.882,5326127.161,162,99,63,39.597,5,2016,1,115,317,186,0.861605855609627,-19.3,19.621978021978,71,1159.9922205197,-0.177764444392325
13062,515782.882,5326127.161,0,0,0,40.588,0,2017,0,103,296,201,0.865624036821671,-58,20.1758241758242,98,1159.9922205197,-0.177764444392325
13062,515782.882,5326127.161,165,53,112,38.172,0,2018,2,107,304,162,0.864437905016667,-127.7,20.8450549450549,55,1159.9922205197,-0.177764444392325
13062,515782.882,5326127.161,160,82,78,31.658,3,2019,2,118,314,169,0.846974598081959,-102.5,20.9692307692308,51,1159.9922205197,-0.177764444392325
13062,515782.882,5326127.161,0,0,0,32.638,0,2020,0,103,299,185,0.806094215335898,-100,19.1989010989011,82,1159.9922205197,-0.177764444392325
13098,515782.882,5317787.532,80,73,7,90.315,9,2001,0,73,337,154,0.843092569454103,132.4,18.6461538461538,81,815.371687775356,-1.35369296881322
13098,515782.882,5317787.532,0,0,0,110.669,0,2002,0,45,346,241,0.844087000985013,16.8,18.7835164835165,196,815.371687775356,-1.35369296881322
13098,515782.882,5317787.532,144,96,48,57.015,7,2003,1,89,333,162,0.824055085154261,-183.3,23.7846153846154,73,815.371687775356,-1.35369296881322
13098,515782.882,5317787.532,135,93,42,57.608,3,2004,2,94,338,273,0.838736509028288,172.3,18.1252747252747,179,815.371687775356,-1.35369296881322
13098,515782.882,5317787.532,0,0,0,136.511,0,2005,0,29,324,178,0.891287745545804,30.6,18.5846153846154,149,815.371687775356,-1.35369296881322
13098,515782.882,5317787.532,183,80,103,43.073,1,2006,3,112,342,257,0.853700645942837,135.7,19.5065934065934,145,815.371687775356,-1.35369296881322
13098,515782.882,5317787.532,0,0,0,124.462,0,2007,0,25,323,178,0.858422282856579,409.3,17.4857142857143,153,815.371687775356,-1.35369296881322
13098,515782.882,5317787.532,0,0,0,41.961,0,2008,0,107,311,162,0.861693416910189,164.5,18.1175824175824,55,815.371687775356,-1.35369296881322
13098,515782.882,5317787.532,155,60,95,47.106,0,2009,2,97,324,176,0.883416466833483,128,19.1692307692308,79,815.371687775356,-1.35369296881322
13098,515782.882,5317787.532,161,93,68,42.027,0,2010,2,105,316,225,0.85430744478251,150.1,19.1098901098901,120,815.371687775356,-1.35369296881322
13098,515782.882,5317787.532,0,0,0,97.291,0,2011,0,32,324,250,0.842929925289264,247.5,18.0252747252747,218,815.371687775356,-1.35369296881322
13098,515782.882,5317787.532,126,93,33,64.085,3,2012,2,89,316,193,0.834676798317899,242,19.010989010989,104,815.371687775356,-1.35369296881322
13098,515782.882,5317787.532,157,79,78,62.95,2,2013,2,95,322,169,0.870368899915356,-87.9,19.8054945054945,74,815.371687775356,-1.35369296881322
13098,515782.882,5317787.532,86,85,1,81.972,5,2014,1,60,320,250,0.923542497280101,260.2,18.2120879120879,190,815.371687775356,-1.35369296881322
13098,515782.882,5317787.532,143,93,50,64.124,4,2015,1,90,342,154,0.872528920456627,-110.3,21.1989010989011,64,815.371687775356,-1.35369296881322
13098,515782.882,5317787.532,162,93,69,62.839,4,2016,1,96,344,169,0.862520922861961,32.5,19.3307692307692,73,815.371687775356,-1.35369296881322
13098,515782.882,5317787.532,123,96,27,72.794,4,2017,1,73,323,169,0.838132897603722,47.8,20.7450549450549,96,815.371687775356,-1.35369296881322
13098,515782.882,5317787.532,0,0,0,122.252,0,2018,0,29,323,154,0.877225913483523,-151.8,21.7142857142857,125,815.371687775356,-1.35369296881322
13098,515782.882,5317787.532,0,0,0,69.904,0,2019,0,79,336,161,0.800210284749739,-106.5,21.9758241758242,82,815.371687775356,-1.35369296881322
13098,515782.882,5317787.532,0,0,0,125.222,0,2020,0,23,321,153,0.814359358472114,-11.7,20.0010989010989,130,815.371687775356,-1.35369296881322
13099,515782.882,5317555.876,0,0,0,87.369,0,2001,2,75,326,153,0.851205699097378,132.4,18.6461538461538,78,876.653837417257,0.374347843418792
13099,515782.882,5317555.876,0,0,0,61.495,0,2002,0,86,343,176,0.828049452396718,16.8,18.7835164835165,90,876.653837417257,0.374347843418792
13099,515782.882,5317555.876,151,115,36,47.101,2,2003,1,100,334,154,0.833314605171611,-183.3,23.7846153846154,54,876.653837417257,0.374347843418792
13099,515782.882,5317555.876,138,97,41,49.831,0,2004,1,101,338,169,0.82035178212935,172.3,18.1252747252747,68,876.653837417257,0.374347843418792
13099,515782.882,5317555.876,0,0,0,138.717,0,2005,0,27,315,162,0.848082989190792,30.6,18.5846153846154,135,876.653837417257,0.374347843418792
13099,515782.882,5317555.876,178,78,100,52.967,1,2006,3,104,345,265,0.836887320114746,135.7,19.5065934065934,161,876.653837417257,0.374347843418792
13099,515782.882,5317555.876,0,0,0,123.307,0,2007,0,26,322,137,0.817184579777979,409.3,17.4857142857143,111,876.653837417257,0.374347843418792
13099,515782.882,5317555.876,0,0,0,41.961,0,2008,0,107,310,162,0.843919082329098,164.5,18.1175824175824,55,876.653837417257,0.374347843418792
13099,515782.882,5317555.876,157,59,98,47.106,0,2009,2,97,326,153,0.847758052386806,128,19.1692307692308,56,876.653837417257,0.374347843418792
13099,515782.882,5317555.876,161,108,53,41.048,0,2010,2,106,317,224,0.825568022383114,150.1,19.1098901098901,118,876.653837417257,0.374347843418792
13099,515782.882,5317555.876,0,0,0,97.291,0,2011,0,32,327,153,0.817310855940969,247.5,18.0252747252747,121,876.653837417257,0.374347843418792
13099,515782.882,5317555.876,128,93,35,64.939,3,2012,1,88,308,162,0.853335144647103,242,19.010989010989,74,876.653837417257,0.374347843418792
13099,515782.882,5317555.876,159,78,81,49.661,0,2013,2,106,307,169,0.855122970252725,-87.9,19.8054945054945,63,876.653837417257,0.374347843418792
13099,515782.882,5317555.876,93,78,15,69.978,3,2014,3,71,322,257,0.893744531369857,260.2,18.2120879120879,186,876.653837417257,0.374347843418792
13099,515782.882,5317555.876,145,93,52,60.002,3,2015,1,93,340,154,0.865173467639858,-110.3,21.1989010989011,61,876.653837417257,0.374347843418792
13099,515782.882,5317555.876,161,115,46,66.039,4,2016,1,93,344,170,0.868080014305494,32.5,19.3307692307692,77,876.653837417257,0.374347843418792
13099,515782.882,5317555.876,123,93,30,64.178,4,2017,2,81,300,234,0.814278275747915,47.8,20.7450549450549,153,876.653837417257,0.374347843418792
13099,515782.882,5317555.876,93,93,0,60.473,1,2018,1,85,334,177,0.791273169783226,-151.8,21.7142857142857,92,876.653837417257,0.374347843418792
13099,515782.882,5317555.876,0,0,0,54.052,0,2019,0,95,338,161,0.79170226537726,-106.5,21.9758241758242,66,876.653837417257,0.374347843418792
13099,515782.882,5317555.876,0,0,0,77.012,0,2020,0,63,321,161,0.800970191431741,-11.7,20.0010989010989,98,876.653837417257,0.374347843418792
13267,516014.538,5329370.35,0,0,0,29.857,0,2001,2,121,327,177,0.884413618114669,100,18.3626373626374,56,1091.36142678308,-1.0657424425568
13267,516014.538,5329370.35,115,86,29,40.768,0,2002,2,106,299,178,0.848967786953337,41,18.3835164835165,72,1091.36142678308,-1.0657424425568
13267,516014.538,5329370.35,150,93,57,42.054,1,2003,1,102,326,161,0.843885735019099,-198.1,23.2098901098901,59,1091.36142678308,-1.0657424425568
13267,516014.538,5329370.35,146,97,49,36.447,0,2004,1,112,329,177,0.841886411475193,194.8,17.9131868131868,65,1091.36142678308,-1.0657424425568
13267,516014.538,5329370.35,0,0,0,58.461,0,2005,0,97,312,169,0.878817394932032,31,18.1571428571429,72,1091.36142678308,-1.0657424425568
13267,516014.538,5329370.35,172,69,103,31.819,0,2006,2,120,341,170,0.838706842792692,78,19.0967032967033,50,1091.36142678308,-1.0657424425568
13267,516014.538,5329370.35,102,93,9,76.526,10,2007,1,66,303,168,0.857836966366012,310.2,17.2868131868132,102,1091.36142678308,-1.0657424425568
13267,516014.538,5329370.35,86,63,23,33.26,0,2008,1,113,309,226,0.843892805166008,32.2,17.7648351648352,113,1091.36142678308,-1.0657424425568
13267,516014.538,5329370.35,151,65,86,49.266,0,2009,2,92,308,146,0.838839779151771,41.4,18.6175824175824,54,1091.36142678308,-1.0657424425568
13267,516014.538,5329370.35,157,75,82,29.272,0,2010,3,115,308,233,0.824618514520324,115,18.5978021978022,118,1091.36142678308,-1.0657424425568
13267,516014.538,5329370.35,93,85,8,44.101,1,2011,2,85,320,146,0.819948703114462,115.3,18.0241758241758,61,1091.36142678308,-1.0657424425568
13267,516014.538,5329370.35,137,93,44,39.462,0,2012,2,112,305,193,0.854207305537379,65.6,19.6395604395604,81,1091.36142678308,-1.0657424425568
13267,516014.538,5329370.35,163,65,98,27.172,0,2013,3,127,310,186,0.830711521447332,-171.9,19.6505494505495,59,1091.36142678308,-1.0657424425568
13267,516014.538,5329370.35,128,105,23,42.014,3,2014,1,95,336,168,0.842635940117786,167.8,18.5373626373626,73,1091.36142678308,-1.0657424425568
13267,516014.538,5329370.35,138,93,45,44.317,0,2015,2,103,339,218,0.772080663236477,-170.8,21.5274725274725,115,1091.36142678308,-1.0657424425568
13267,516014.538,5329370.35,157,121,36,49.305,7,2016,1,106,330,192,0.858416498032507,32.4,19.6758241758242,86,1091.36142678308,-1.0657424425568
13267,516014.538,5329370.35,113,93,20,42.088,7,2017,2,100,300,217,0.831741174107246,-13.5,20.0351648351648,117,1091.36142678308,-1.0657424425568
13267,516014.538,5329370.35,0,0,0,38.801,0,2018,0,105,316,160,0.871720936627452,-156.4,20.7978021978022,55,1091.36142678308,-1.0657424425568
13267,516014.538,5329370.35,134,83,51,39.513,4,2019,2,108,323,177,0.777124806876927,-80.5,20.9483516483516,69,1091.36142678308,-1.0657424425568
13267,516014.538,5329370.35,0,0,0,36.229,0,2020,0,96,305,192,0.818674575305489,-24.1,19.2450549450549,96,1091.36142678308,-1.0657424425568
13282,516014.538,5325895.505,0,0,0,120.285,0,2001,2,44,314,194,0.887825842328239,2.3,18.3043956043956,150,1126.55294163918,1.45468706670119
13282,516014.538,5325895.505,114,94,20,39.127,0,2002,2,110,290,201,0.901073568699907,17,18.367032967033,91,1126.55294163918,1.45468706670119
13282,516014.538,5325895.505,152,94,58,34.646,0,2003,1,111,308,170,0.872290667822706,-202.5,23.1824175824176,59,1126.55294163918,1.45468706670119
13282,516014.538,5325895.505,149,95,54,30.354,0,2004,1,119,313,178,0.877430821029173,121.9,17.978021978022,59,1126.55294163918,1.45468706670119
13282,516014.538,5325895.505,146,139,7,51.036,0,2005,1,103,307,186,0.896217208838844,-39.2,18.1494505494505,83,1126.55294163918,1.45468706670119
13282,516014.538,5325895.505,181,70,111,33.986,1,2006,2,118,332,168,0.888551603476142,40.8,19.1318681318681,50,1126.55294163918,1.45468706670119
13282,516014.538,5325895.505,165,146,19,43.827,0,2007,1,98,297,194,0.862377660837225,255.4,17.3461538461538,96,1126.55294163918,1.45468706670119
13282,516014.538,5325895.505,0,0,0,24.806,0,2008,0,122,299,177,0.888486018361608,25.7,17.7142857142857,55,1126.55294163918,1.45468706670119
13282,516014.538,5325895.505,168,61,107,29.239,0,2009,3,116,300,232,0.868006655933333,27.7,18.6934065934066,116,1126.55294163918,1.45468706670119
13282,516014.538,5325895.505,165,75,90,27.817,0,2010,2,119,299,176,0.878959982724153,84.7,18.4769230769231,57,1126.55294163918,1.45468706670119
13282,516014.538,5325895.505,82,59,23,36.626,0,2011,1,95,316,169,0.874426455061323,122.2,17.8593406593407,74,1126.55294163918,1.45468706670119
13282,516014.538,5325895.505,0,0,0,42.614,0,2012,0,111,301,168,0.895468769461099,17.4,19.3263736263736,57,1126.55294163918,1.45468706670119
13282,516014.538,5325895.505,168,67,101,27.966,0,2013,3,126,309,185,0.891848372096889,-176.5,19.5032967032967,59,1126.55294163918,1.45468706670119
13282,516014.538,5325895.505,0,0,0,40.408,0,2014,0,100,313,185,0.874857459819447,86.5,18.3582417582418,85,1126.55294163918,1.45468706670119
13282,516014.538,5325895.505,143,93,50,38.096,0,2015,1,111,323,161,0.883067358363991,-204.4,21.3131868131868,50,1126.55294163918,1.45468706670119
13282,516014.538,5325895.505,161,93,68,38.544,4,2016,2,116,319,185,0.88301620257872,-19.3,19.621978021978,69,1126.55294163918,1.45468706670119
13282,516014.538,5325895.505,93,93,0,33.908,2,2017,1,112,295,178,0.860194985312592,-58,20.1758241758242,66,1126.55294163918,1.45468706670119
13282,516014.538,5325895.505,164,53,111,42.254,0,2018,2,103,307,161,0.906346962242614,-127.7,20.8450549450549,58,1126.55294163918,1.45468706670119
13282,516014.538,5325895.505,157,82,75,32.564,3,2019,2,117,327,169,0.839643156208243,-102.5,20.9692307692308,52,1126.55294163918,1.45468706670119
13282,516014.538,5325895.505,0,0,0,38.008,0,2020,0,96,299,186,0.827680107131404,-100,19.1989010989011,90,1126.55294163918,1.45468706670119
13317,516014.538,5317787.532,93,93,0,80.723,8,2001,1,80,338,162,0.84492678320645,132.4,18.6461538461538,82,801.157725178408,1.43182198462785
13317,516014.538,5317787.532,0,0,0,113.117,0,2002,0,43,305,176,0.849522709275873,16.8,18.7835164835165,133,801.157725178408,1.43182198462785
13317,516014.538,5317787.532,143,95,48,59.667,7,2003,1,86,335,153,0.837861914269008,-183.3,23.7846153846154,67,801.157725178408,1.43182198462785
13317,516014.538,5317787.532,132,94,38,78.472,10,2004,2,75,336,242,0.818829493797989,172.3,18.1252747252747,167,801.157725178408,1.43182198462785
13317,516014.538,5317787.532,93,93,0,78.618,2,2005,1,81,315,170,0.867699003528765,30.6,18.5846153846154,89,801.157725178408,1.43182198462785
13317,516014.538,5317787.532,180,78,102,50.487,1,2006,3,106,340,258,0.840160911874054,135.7,19.5065934065934,152,801.157725178408,1.43182198462785
13317,516014.538,5317787.532,0,0,0,124.462,0,2007,0,25,332,185,0.85009577942799,409.3,17.4857142857143,160,801.157725178408,1.43182198462785
13317,516014.538,5317787.532,0,0,0,60.506,0,2008,0,91,311,233,0.856522727687693,164.5,18.1175824175824,142,801.157725178408,1.43182198462785
13317,516014.538,5317787.532,163,60,103,42.202,0,2009,2,102,329,169,0.893492608568179,128,19.1692307692308,67,801.157725178408,1.43182198462785
13317,516014.538,5317787.532,160,93,67,50.431,1,2010,1,97,317,177,0.851879778212102,150.1,19.1098901098901,80,801.157725178408,1.43182198462785
13317,516014.538,5317787.532,0,0,0,107.471,0,2011,0,22,324,257,0.836874262125566,247.5,18.0252747252747,235,801.157725178408,1.43182198462785
13317,516014.538,5317787.532,127,94,33,72.434,3,2012,2,80,319,248,0.849057952728739,242,19.010989010989,168,801.157725178408,1.43182198462785
13317,516014.538,5317787.532,158,80,78,67.267,6,2013,2,91,321,162,0.837152890512198,-87.9,19.8054945054945,71,801.157725178408,1.43182198462785
13317,516014.538,5317787.532,86,81,5,85.437,6,2014,1,57,321,161,0.843818548528574,260.2,18.2120879120879,104,801.157725178408,1.43182198462785
13317,516014.538,5317787.532,144,93,51,68.489,4,2015,1,86,345,146,0.859499083374953,-110.3,21.1989010989011,60,801.157725178408,1.43182198462785
13317,516014.538,5317787.532,162,93,69,62.839,4,2016,1,96,343,169,0.858852490752516,32.5,19.3307692307692,73,801.157725178408,1.43182198462785
13317,516014.538,5317787.532,125,97,28,71.696,4,2017,1,74,342,160,0.844675001943074,47.8,20.7450549450549,86,801.157725178408,1.43182198462785
13317,516014.538,5317787.532,0,0,0,140.925,0,2018,0,15,345,154,0.839950323212717,-151.8,21.7142857142857,139,801.157725178408,1.43182198462785
13317,516014.538,5317787.532,0,0,0,72.432,0,2019,0,77,336,161,0.805347193737689,-106.5,21.9758241758242,84,801.157725178408,1.43182198462785
13317,516014.538,5317787.532,0,0,0,124.242,0,2020,0,24,320,152,0.809361152135063,-11.7,20.0010989010989,128,801.157725178408,1.43182198462785
13318,516014.538,5317555.876,93,93,0,72.506,7,2001,2,86,323,200,0.820097184237086,132.4,18.6461538461538,114,842.380839445291,0.431721545619581
13318,516014.538,5317555.876,0,0,0,66.294,0,2002,0,82,343,217,0.815755187931961,16.8,18.7835164835165,135,842.380839445291,0.431721545619581
13318,516014.538,5317555.876,148,98,50,47.101,2,2003,1,100,329,161,0.827383511962103,-183.3,23.7846153846154,61,842.380839445291,0.431721545619581
13318,516014.538,5317555.876,140,103,37,47.591,0,2004,2,103,335,225,0.836768493003928,172.3,18.1252747252747,122,842.380839445291,0.431721545619581
13318,516014.538,5317555.876,148,93,55,68.189,2,2005,3,90,315,200,0.843180364768144,30.6,18.5846153846154,110,842.380839445291,0.431721545619581
13318,516014.538,5317555.876,180,78,102,46.659,1,2006,3,109,337,257,0.835048910361007,135.7,19.5065934065934,148,842.380839445291,0.431721545619581
13318,516014.538,5317555.876,0,0,0,119.98,0,2007,0,29,330,218,0.819014673380765,409.3,17.4857142857143,189,842.380839445291,0.431721545619581
13318,516014.538,5317555.876,0,0,0,38.526,0,2008,0,110,312,209,0.851885230619561,164.5,18.1175824175824,99,842.380839445291,0.431721545619581
13318,516014.538,5317555.876,156,61,95,49.231,0,2009,2,95,321,176,0.865266633363883,128,19.1692307692308,81,842.380839445291,0.431721545619581
13318,516014.538,5317555.876,160,96,64,41.048,0,2010,2,106,316,225,0.836235447834963,150.1,19.1098901098901,119,842.380839445291,0.431721545619581
13318,516014.538,5317555.876,0,0,0,53.703,0,2011,0,78,324,154,0.820006883279711,247.5,18.0252747252747,76,842.380839445291,0.431721545619581
13318,516014.538,5317555.876,128,93,35,64.085,3,2012,2,89,303,216,0.842976896107204,242,19.010989010989,127,842.380839445291,0.431721545619581
13318,516014.538,5317555.876,158,74,84,53.449,0,2013,2,103,306,177,0.84281739714739,-87.9,19.8054945054945,74,842.380839445291,0.431721545619581
13318,516014.538,5317555.876,86,78,8,71.946,3,2014,1,69,322,161,0.824429630179199,260.2,18.2120879120879,92,842.380839445291,0.431721545619581
13318,516014.538,5317555.876,145,93,52,61.373,3,2015,1,92,339,160,0.857184273856179,-110.3,21.1989010989011,68,842.380839445291,0.431721545619581
13318,516014.538,5317555.876,162,115,47,62.839,4,2016,1,96,340,169,0.867754646116736,32.5,19.3307692307692,73,842.380839445291,0.431721545619581
13318,516014.538,5317555.876,124,98,26,70.627,4,2017,2,75,299,233,0.800812674439227,47.8,20.7450549450549,158,842.380839445291,0.431721545619581
13318,516014.538,5317555.876,93,93,0,60.473,1,2018,1,85,324,169,0.800444395406584,-151.8,21.7142857142857,84,842.380839445291,0.431721545619581
13318,516014.538,5317555.876,0,0,0,54.999,0,2019,0,94,337,169,0.785652547226179,-106.5,21.9758241758242,75,842.380839445291,0.431721545619581
13318,516014.538,5317555.876,0,0,0,80.754,0,2020,0,60,318,184,0.810554652306357,-11.7,20.0010989010989,124,842.380839445291,0.431721545619581
13486,516246.194,5329370.35,0,0,0,61,0,2001,0,93,328,250,0.87973545182321,100,18.3626373626374,157,1068.90385584626,1.44812497988218
13486,516246.194,5329370.35,114,85,29,41.609,1,2002,2,105,342,169,0.854414592471332,41,18.3835164835165,64,1068.90385584626,1.44812497988218
13486,516246.194,5329370.35,155,93,62,38.59,1,2003,1,106,329,153,0.838532352933623,-198.1,23.2098901098901,47,1068.90385584626,1.44812497988218
13486,516246.194,5329370.35,152,98,54,39.265,0,2004,1,109,330,169,0.834659721672227,194.8,17.9131868131868,60,1068.90385584626,1.44812497988218
13486,516246.194,5329370.35,0,0,0,71.329,0,2005,0,85,314,161,0.863499614177396,31,18.1571428571429,76,1068.90385584626,1.44812497988218
13486,516246.194,5329370.35,174,63,111,30.898,0,2006,2,121,343,169,0.831969797673686,78,19.0967032967033,48,1068.90385584626,1.44812497988218
13486,516246.194,5329370.35,0,0,0,77.702,0,2007,0,65,303,162,0.874064939575236,310.2,17.2868131868132,97,1068.90385584626,1.44812497988218
13486,516246.194,5329370.35,86,61,25,45.751,1,2008,1,102,311,169,0.862553825353392,32.2,17.7648351648352,67,1068.90385584626,1.44812497988218
13486,516246.194,5329370.35,156,61,95,50.467,0,2009,2,91,313,153,0.880126868538833,41.4,18.6175824175824,62,1068.90385584626,1.44812497988218
13486,516246.194,5329370.35,164,75,89,28.516,0,2010,3,116,309,200,0.840177606928989,115,18.5978021978022,84,1068.90385584626,1.44812497988218
13486,516246.194,5329370.35,84,66,18,41.648,1,2011,1,88,320,145,0.842571740885683,115.3,18.0241758241758,57,1068.90385584626,1.44812497988218
13486,516246.194,5329370.35,93,82,11,45.297,1,2012,2,105,308,178,0.855244210367803,65.6,19.6395604395604,73,1068.90385584626,1.44812497988218
13486,516246.194,5329370.35,175,63,112,28.205,0,2013,2,126,305,185,0.856091444090899,-171.9,19.6505494505495,59,1068.90385584626,1.44812497988218
13486,516246.194,5329370.35,95,95,0,47.316,3,2014,2,88,320,216,0.855216290454156,167.8,18.5373626373626,128,1068.90385584626,1.44812497988218
13486,516246.194,5329370.35,144,93,51,48.288,0,2015,1,99,336,153,0.82620299731585,-170.8,21.5274725274725,54,1068.90385584626,1.44812497988218
13486,516246.194,5329370.35,151,93,58,56.995,7,2016,2,98,329,192,0.866319461985617,32.4,19.6758241758242,94,1068.90385584626,1.44812497988218
13486,516246.194,5329370.35,125,94,31,46.895,7,2017,2,94,302,210,0.816866904898209,-13.5,20.0351648351648,116,1068.90385584626,1.44812497988218
13486,516246.194,5329370.35,167,102,65,45.766,0,2018,1,98,310,153,0.862335207658587,-156.4,20.7978021978022,55,1068.90385584626,1.44812497988218
13486,516246.194,5329370.35,145,84,61,41.293,4,2019,2,106,328,169,0.803209526190621,-80.5,20.9483516483516,63,1068.90385584626,1.44812497988218
13486,516246.194,5329370.35,0,0,0,37.861,0,2020,0,94,318,185,0.797362177222503,-24.1,19.2450549450549,91,1068.90385584626,1.44812497988218
13527,516246.194,5319872.439,0,0,0,52.903,0,2001,2,101,328,177,0.901867471575059,2.3,18.3043956043956,76,1105.67970756716,0.190169326846745
13527,516246.194,5319872.439,102,85,17,39.127,0,2002,2,110,331,177,0.893330157576603,17,18.367032967033,67,1105.67970756716,0.190169326846745
13527,516246.194,5319872.439,152,83,69,37.036,1,2003,2,108,323,160,0.861592064172245,-202.5,23.1824175824176,52,1105.67970756716,0.190169326846745
13527,516246.194,5319872.439,149,93,56,32.981,0,2004,2,116,326,186,0.884124346314985,121.9,17.978021978022,70,1105.67970756716,0.190169326846745
13527,516246.194,5319872.439,0,0,0,47.867,0,2005,0,106,309,169,0.892228325861867,-39.2,18.1494505494505,63,1105.67970756716,0.190169326846745
13527,516246.194,5319872.439,173,70,103,39.918,1,2006,2,112,333,176,0.861448788864695,40.8,19.1318681318681,64,1105.67970756716,0.190169326846745
13527,516246.194,5319872.439,0,0,0,50.82,0,2007,0,91,299,177,0.895308260403403,255.4,17.3461538461538,86,1105.67970756716,0.190169326846745
13527,516246.194,5319872.439,85,66,19,35.767,0,2008,1,112,304,185,0.870069581132955,25.7,17.7142857142857,73,1105.67970756716,0.190169326846745
13527,516246.194,5319872.439,168,60,108,38.016,0,2009,2,106,307,170,0.906169051242206,27.7,18.6934065934066,64,1105.67970756716,0.190169326846745
13527,516246.194,5319872.439,162,93,69,30.089,0,2010,2,116,297,185,0.874880929688639,84.7,18.4769230769231,69,1105.67970756716,0.190169326846745
13527,516246.194,5319872.439,101,63,38,40.976,0,2011,2,90,317,162,0.890685471274879,122.2,17.8593406593407,72,1105.67970756716,0.190169326846745
13527,516246.194,5319872.439,0,0,0,44.404,0,2012,0,109,298,185,0.883823257310957,17.4,19.3263736263736,76,1105.67970756716,0.190169326846745
13527,516246.194,5319872.439,157,64,93,31.145,0,2013,3,123,303,185,0.866746676227752,-176.5,19.5032967032967,62,1105.67970756716,0.190169326846745
13527,516246.194,5319872.439,0,0,0,41.861,0,2014,0,98,318,178,0.869278927593777,86.5,18.3582417582418,80,1105.67970756716,0.190169326846745
13527,516246.194,5319872.439,159,79,80,38.957,0,2015,2,110,333,169,0.881171394924904,-204.4,21.3131868131868,59,1105.67970756716,0.190169326846745
13527,516246.194,5319872.439,161,93,68,38.544,4,2016,2,116,320,185,0.885190814296396,-19.3,19.621978021978,69,1105.67970756716,0.190169326846745
13527,516246.194,5319872.439,0,0,0,31.037,0,2017,0,116,308,170,0.851005295989582,-58,20.1758241758242,54,1105.67970756716,0.190169326846745
13527,516246.194,5319872.439,163,104,59,41.217,0,2018,1,104,324,161,0.886953803444398,-127.7,20.8450549450549,57,1105.67970756716,0.190169326846745
13527,516246.194,5319872.439,150,100,50,28.918,3,2019,1,121,326,170,0.821278574133235,-102.5,20.9692307692308,49,1105.67970756716,0.190169326846745
13527,516246.194,5319872.439,0,0,0,36.38,0,2020,0,98,311,177,0.82423359171693,-100,19.1989010989011,79,1105.67970756716,0.190169326846745
13528,516246.194,5319640.783,140,93,47,55.246,7,2001,3,99,337,177,0.889588533924598,2.3,18.3043956043956,78,1079.21480061346,-1.44578578819147
13528,516246.194,5319640.783,0,0,0,46.839,0,2002,0,101,327,176,0.895787208254846,17,18.367032967033,75,1079.21480061346,-1.44578578819147
13528,516246.194,5319640.783,131,93,38,38.704,1,2003,1,106,317,160,0.878056558621597,-202.5,23.1824175824176,54,1079.21480061346,-1.44578578819147
13528,516246.194,5319640.783,142,94,48,30.354,0,2004,2,119,324,193,0.887864431229553,121.9,17.978021978022,74,1079.21480061346,-1.44578578819147
13528,516246.194,5319640.783,137,120,17,49.955,0,2005,1,104,313,162,0.887390268881139,-39.2,18.1494505494505,58,1079.21480061346,-1.44578578819147
13528,516246.194,5319640.783,181,78,103,33.01,1,2006,2,119,335,170,0.874971507564075,40.8,19.1318681318681,51,1079.21480061346,-1.44578578819147
13528,516246.194,5319640.783,0,0,0,49.763,0,2007,0,92,303,170,0.875099648152315,255.4,17.3461538461538,78,1079.21480061346,-1.44578578819147
13528,516246.194,5319640.783,0,0,0,28.932,0,2008,0,118,307,177,0.873706998994627,25.7,17.7142857142857,59,1079.21480061346,-1.44578578819147
13528,516246.194,5319640.783,158,73,85,46.653,0,2009,2,97,309,154,0.86953664121723,27.7,18.6934065934066,57,1079.21480061346,-1.44578578819147
13528,516246.194,5319640.783,147,75,72,33.359,0,2010,3,112,308,185,0.87376445621672,84.7,18.4769230769231,73,1079.21480061346,-1.44578578819147
13528,516246.194,5319640.783,138,80,58,41.845,0,2011,2,89,320,161,0.888242927328334,122.2,17.8593406593407,72,1079.21480061346,-1.44578578819147
13528,516246.194,5319640.783,147,93,54,44.404,0,2012,1,109,312,170,0.900725282753458,17.4,19.3263736263736,61,1079.21480061346,-1.44578578819147
13528,516246.194,5319640.783,152,94,58,36.456,0,2013,1,118,304,177,0.863844637790522,-176.5,19.5032967032967,59,1079.21480061346,-1.44578578819147
13528,516246.194,5319640.783,93,93,0,42.597,0,2014,1,97,344,170,0.855931719432131,86.5,18.3582417582418,73,1079.21480061346,-1.44578578819147
13528,516246.194,5319640.783,0,0,0,42.522,0,2015,0,106,331,154,0.902189631623767,-204.4,21.3131868131868,48,1079.21480061346,-1.44578578819147
13528,516246.194,5319640.783,152,93,59,49.708,5,2016,2,106,331,185,0.876526990511037,-19.3,19.621978021978,79,1079.21480061346,-1.44578578819147
13528,516246.194,5319640.783,0,0,0,40.588,0,2017,0,103,311,170,0.874423778917759,-58,20.1758241758242,67,1079.21480061346,-1.44578578819147
13528,516246.194,5319640.783,155,94,61,43.252,0,2018,1,102,321,161,0.893562047373456,-127.7,20.8450549450549,59,1079.21480061346,-1.44578578819147
13528,516246.194,5319640.783,96,94,2,33.453,3,2019,1,116,334,178,0.79469206701989,-102.5,20.9692307692308,62,1079.21480061346,-1.44578578819147
13528,516246.194,5319640.783,0,0,0,39.699,0,2020,0,94,315,177,0.825601015573171,-100,19.1989010989011,83,1079.21480061346,-1.44578578819147
13537,516246.194,5317555.876,0,0,0,137.975,0,2001,1,33,327,201,0.840891304991263,132.4,18.6461538461538,168,816.063858770564,-1.33113322566704
13537,516246.194,5317555.876,101,93,8,57.26,1,2002,2,90,303,249,0.85047234442359,16.8,18.7835164835165,159,816.063858770564,-1.33113322566704
13537,516246.194,5317555.876,0,0,0,47.982,0,2003,0,99,327,186,0.828466823526855,-183.3,23.7846153846154,87,816.063858770564,-1.33113322566704
13537,516246.194,5317555.876,132,95,37,48.696,0,2004,2,102,332,216,0.830202688773535,172.3,18.1252747252747,114,816.063858770564,-1.33113322566704
13537,516246.194,5317555.876,93,93,0,74.018,2,2005,2,85,318,241,0.84038862874922,30.6,18.5846153846154,156,816.063858770564,-1.33113322566704
13537,516246.194,5317555.876,175,72,103,41.973,1,2006,2,113,334,177,0.819116401856532,135.7,19.5065934065934,64,816.063858770564,-1.33113322566704
13537,516246.194,5317555.876,0,0,0,85.418,0,2007,0,60,312,194,0.864976978829536,409.3,17.4857142857143,134,816.063858770564,-1.33113322566704
13537,516246.194,5317555.876,0,0,0,37.372,0,2008,0,111,312,217,0.876742510508225,164.5,18.1175824175824,106,816.063858770564,-1.33113322566704
13537,516246.194,5317555.876,146,62,84,49.231,0,2009,3,95,322,186,0.881636986009459,128,19.1692307692308,91,816.063858770564,-1.33113322566704
13537,516246.194,5317555.876,153,93,60,41.048,0,2010,2,106,320,209,0.839698703529273,150.1,19.1098901098901,103,816.063858770564,-1.33113322566704
13537,516246.194,5317555.876,0,0,0,95.35,0,2011,0,34,322,169,0.823716608876002,247.5,18.0252747252747,135,816.063858770564,-1.33113322566704
13537,516246.194,5317555.876,120,93,27,63.247,3,2012,2,90,321,201,0.847236239989339,242,19.010989010989,111,816.063858770564,-1.33113322566704
13537,516246.194,5317555.876,151,93,58,49.661,0,2013,1,106,316,177,0.839325578548063,-87.9,19.8054945054945,71,816.063858770564,-1.33113322566704
13537,516246.194,5317555.876,85,81,4,81.972,5,2014,1,60,349,202,0.864980608159314,260.2,18.2120879120879,142,816.063858770564,-1.33113322566704
13537,516246.194,5317555.876,93,93,0,57.379,2,2015,1,95,339,146,0.844047943754565,-110.3,21.1989010989011,51,816.063858770564,-1.33113322566704
13537,516246.194,5317555.876,147,94,53,72.685,4,2016,1,87,340,169,0.853516172111593,32.5,19.3307692307692,82,816.063858770564,-1.33113322566704
13537,516246.194,5317555.876,118,93,25,70.627,4,2017,2,75,301,217,0.820219830534658,47.8,20.7450549450549,142,816.063858770564,-1.33113322566704
13537,516246.194,5317555.876,0,0,0,71.771,0,2018,0,75,321,194,0.786152931742081,-151.8,21.7142857142857,119,816.063858770564,-1.33113322566704
13537,516246.194,5317555.876,127,94,33,55.89,8,2019,1,93,341,161,0.794576888432647,-106.5,21.9758241758242,68,816.063858770564,-1.33113322566704
13537,516246.194,5317555.876,0,0,0,74.5,0,2020,0,65,318,177,0.811294176382849,-11.7,20.0010989010989,112,816.063858770564,-1.33113322566704
13721,516477.851,5325663.848,0,0,0,122.611,0,2001,1,42,327,194,0.854370399408285,2.3,18.3043956043956,152,1000.90961813422,0.256128810825008
13721,516477.851,5325663.848,0,0,0,37.392,0,2002,0,112,288,210,0.870092763162292,17,18.367032967033,98,1000.90961813422,0.256128810825008
13721,516477.851,5325663.848,136,94,42,40.456,1,2003,1,104,313,177,0.830336647107764,-202.5,23.1824175824176,73,1000.90961813422,0.256128810825008
13721,516477.851,5325663.848,137,97,40,28.633,0,2004,1,121,331,177,0.843873318733725,121.9,17.978021978022,56,1000.90961813422,0.256128810825008
13721,516477.851,5325663.848,134,93,41,58.946,2,2005,3,96,308,184,0.873142227039477,-39.2,18.1494505494505,88,1000.90961813422,0.256128810825008
13721,516477.851,5325663.848,183,72,111,35.938,1,2006,3,116,339,250,0.81062567521788,40.8,19.1318681318681,134,1000.90961813422,0.256128810825008
13721,516477.851,5325663.848,0,0,0,54.039,0,2007,0,88,305,184,0.852390539021753,255.4,17.3461538461538,96,1000.90961813422,0.256128810825008
13721,516477.851,5325663.848,0,0,0,33.501,0,2008,0,114,307,177,0.831011854307973,25.7,17.7142857142857,63,1000.90961813422,0.256128810825008
13721,516477.851,5325663.848,162,61,101,35.299,0,2009,2,109,310,170,0.872077547211586,27.7,18.6934065934066,61,1000.90961813422,0.256128810825008
13721,516477.851,5325663.848,156,93,63,35.987,0,2010,1,109,299,176,0.83311033895643,84.7,18.4769230769231,67,1000.90961813422,0.256128810825008
13721,516477.851,5325663.848,131,59,72,42.72,0,2011,2,88,321,177,0.826923091992232,122.2,17.8593406593407,89,1000.90961813422,0.256128810825008
13721,516477.851,5325663.848,128,93,35,53.343,3,2012,1,98,314,169,0.86862019282933,17.4,19.3263736263736,71,1000.90961813422,0.256128810825008
13721,516477.851,5325663.848,155,93,62,40.26,0,2013,2,114,322,185,0.845100427029513,-176.5,19.5032967032967,71,1000.90961813422,0.256128810825008
13721,516477.851,5325663.848,0,0,0,60.633,0,2014,0,75,316,193,0.860476785527279,86.5,18.3582417582418,118,1000.90961813422,0.256128810825008
13721,516477.851,5325663.848,143,93,50,44.368,0,2015,1,104,338,169,0.901450833702073,-204.4,21.3131868131868,65,1000.90961813422,0.256128810825008
13721,516477.851,5325663.848,97,94,3,45.09,5,2016,2,110,330,193,0.859450837108298,-19.3,19.621978021978,83,1000.90961813422,0.256128810825008
13721,516477.851,5325663.848,110,93,17,50.507,6,2017,1,91,297,169,0.804284646303752,-58,20.1758241758242,78,1000.90961813422,0.256128810825008
13721,516477.851,5325663.848,86,56,30,50.763,0,2018,1,95,317,184,0.795826885214364,-127.7,20.8450549450549,89,1000.90961813422,0.256128810825008
13721,516477.851,5325663.848,127,94,33,40.516,3,2019,1,108,330,168,0.797066132867606,-102.5,20.9692307692308,60,1000.90961813422,0.256128810825008
13721,516477.851,5325663.848,0,0,0,53.659,0,2020,0,79,315,170,0.798115234141097,-100,19.1989010989011,91,1000.90961813422,0.256128810825008
13722,516477.851,5325432.192,0,0,0,57.519,0,2001,1,97,330,193,0.859010235037709,2.3,18.3043956043956,96,906.044847579878,0.0572144639915962
13722,516477.851,5325432.192,0,0,0,47.671,0,2002,0,100,290,217,0.849454630901791,17,18.367032967033,117,906.044847579878,0.0572144639915962
13722,516477.851,5325432.192,134,94,40,42.276,1,2003,1,102,328,177,0.828371852637424,-202.5,23.1824175824176,75,906.044847579878,0.0572144639915962
13722,516477.851,5325432.192,133,93,40,41.482,0,2004,1,107,331,169,0.804201768021967,121.9,17.978021978022,62,906.044847579878,0.0572144639915962
13722,516477.851,5325432.192,93,93,0,61.976,2,2005,1,93,312,169,0.852083386027236,-39.2,18.1494505494505,76,906.044847579878,0.0572144639915962
13722,516477.851,5325432.192,176,72,104,44.351,1,2006,2,108,343,177,0.837221660521376,40.8,19.1318681318681,69,906.044847579878,0.0572144639915962
13722,516477.851,5325432.192,0,0,0,96.765,0,2007,0,50,304,193,0.848518412128475,255.4,17.3461538461538,143,906.044847579878,0.0572144639915962
13722,516477.851,5325432.192,86,85,1,25.81,0,2008,1,121,309,178,0.854284065649696,25.7,17.7142857142857,57,906.044847579878,0.0572144639915962
13722,516477.851,5325432.192,158,62,96,45.603,0,2009,2,98,313,176,0.889760585044918,27.7,18.6934065934066,78,906.044847579878,0.0572144639915962
13722,516477.851,5325432.192,157,94,63,42.718,1,2010,2,102,302,193,0.859425165461486,84.7,18.4769230769231,91,906.044847579878,0.0572144639915962
13722,516477.851,5325432.192,133,60,73,46.905,0,2011,3,83,322,217,0.801317310723055,122.2,17.8593406593407,134,906.044847579878,0.0572144639915962
13722,516477.851,5325432.192,128,93,35,54.128,3,2012,1,97,314,168,0.850422352466934,17.4,19.3263736263736,71,906.044847579878,0.0572144639915962
13722,516477.851,5325432.192,155,94,61,43.21,0,2013,2,111,331,193,0.839859380282683,-176.5,19.5032967032967,82,906.044847579878,0.0572144639915962
13722,516477.851,5325432.192,0,0,0,64.19,0,2014,0,71,318,186,0.847469964312539,86.5,18.3582417582418,115,906.044847579878,0.0572144639915962
13722,516477.851,5325432.192,145,93,52,44.368,0,2015,1,104,340,162,0.843400840743988,-204.4,21.3131868131868,58,906.044847579878,0.0572144639915962
13722,516477.851,5325432.192,0,0,0,62.88,0,2016,0,93,334,201,0.858262660130794,-19.3,19.621978021978,108,906.044847579878,0.0572144639915962
13722,516477.851,5325432.192,112,93,19,54.29,6,2017,2,87,300,193,0.824750033415606,-58,20.1758241758242,106,906.044847579878,0.0572144639915962
13722,516477.851,5325432.192,86,59,27,57.41,0,2018,1,89,326,193,0.815659011189067,-127.7,20.8450549450549,104,906.044847579878,0.0572144639915962
13722,516477.851,5325432.192,124,94,30,46.267,7,2019,1,102,331,178,0.787242441144146,-102.5,20.9692307692308,76,906.044847579878,0.0572144639915962
13722,516477.851,5325432.192,0,0,0,36.38,0,2020,0,98,308,193,0.814513451713547,-100,19.1989010989011,95,906.044847579878,0.0572144639915962
13941,516709.507,5325432.192,0,0,0,126.281,0,2001,1,39,331,177,0.809295564435537,2.3,18.3043956043956,138,934.084995044617,-1.50898968475996
13941,516709.507,5325432.192,0,0,0,42.599,0,2002,0,106,305,185,0.817151704746295,17,18.367032967033,79,934.084995044617,-1.50898968475996
13941,516709.507,5325432.192,145,93,52,42.276,1,2003,1,102,322,160,0.850552866551398,-202.5,23.1824175824176,58,934.084995044617,-1.50898968475996
13941,516709.507,5325432.192,135,94,41,39.558,0,2004,2,109,337,185,0.77631758255773,121.9,17.978021978022,76,934.084995044617,-1.50898968475996
13941,516709.507,5325432.192,149,93,56,63.034,2,2005,2,92,319,162,0.81801101782833,-39.2,18.1494505494505,70,934.084995044617,-1.50898968475996
13941,516709.507,5325432.192,183,73,110,34.961,1,2006,3,117,345,250,0.793488175083358,40.8,19.1318681318681,133,934.084995044617,-1.50898968475996
13941,516709.507,5325432.192,0,0,0,113.042,0,2007,0,36,311,185,0.838508242991407,255.4,17.3461538461538,149,934.084995044617,-1.50898968475996
13941,516709.507,5325432.192,86,73,13,34.659,0,2008,1,113,312,178,0.830205178171799,25.7,17.7142857142857,65,934.084995044617,-1.50898968475996
13941,516709.507,5325432.192,158,61,97,44.576,0,2009,2,99,317,170,0.855144664235809,27.7,18.6934065934066,71,934.084995044617,-1.50898968475996
13941,516709.507,5325432.192,158,78,80,36.899,0,2010,3,108,299,185,0.806708591328395,84.7,18.4769230769231,77,934.084995044617,-1.50898968475996
13941,516709.507,5325432.192,86,62,24,53.013,2,2011,1,76,324,160,0.817045532147168,122.2,17.8593406593407,84,934.084995044617,-1.50898968475996
13941,516709.507,5325432.192,137,82,55,58.838,4,2012,2,91,316,168,0.839769825286972,17.4,19.3263736263736,77,934.084995044617,-1.50898968475996
13941,516709.507,5325432.192,175,93,82,37.487,0,2013,2,117,314,193,0.812625268587228,-176.5,19.5032967032967,76,934.084995044617,-1.50898968475996
13941,516709.507,5325432.192,0,0,0,73.179,0,2014,0,62,345,177,0.819559938270635,86.5,18.3582417582418,115,934.084995044617,-1.50898968475996
13941,516709.507,5325432.192,140,94,46,52.764,2,2015,1,96,343,161,0.830977603243447,-204.4,21.3131868131868,65,934.084995044617,-1.50898968475996
13941,516709.507,5325432.192,134,94,40,67.942,5,2016,1,88,338,162,0.888658353779593,-19.3,19.621978021978,74,934.084995044617,-1.50898968475996
13941,516709.507,5325432.192,107,93,14,79.058,8,2017,1,65,314,169,0.767935084998984,-58,20.1758241758242,104,934.084995044617,-1.50898968475996
13941,516709.507,5325432.192,0,0,0,62.887,0,2018,0,84,325,178,0.813041055335562,-127.7,20.8450549450549,94,934.084995044617,-1.50898968475996
13941,516709.507,5325432.192,141,95,46,45.292,6,2019,1,103,330,170,0.785691308597848,-102.5,20.9692307692308,67,934.084995044617,-1.50898968475996
13941,516709.507,5325432.192,0,0,0,101.778,0,2020,0,39,316,192,0.807842203222858,-100,19.1989010989011,153,934.084995044617,-1.50898968475996
16076,519026.071,5338173.292,0,0,0,48.404,0,2001,2,105,285,170,0.823756620759616,116.8,17.4,65,1204.01352399412,0.395889144370626
16076,519026.071,5338173.292,86,71,15,27.175,0,2002,1,123,298,193,0.84232252591085,52.7,17.567032967033,70,1204.01352399412,0.395889144370626
16076,519026.071,5338173.292,169,93,76,32.108,0,2003,1,116,322,169,0.844140789274091,-198,22.3252747252747,53,1204.01352399412,0.395889144370626
16076,519026.071,5338173.292,168,93,75,29.039,0,2004,2,121,327,193,0.848413403945357,209.7,17.0835164835165,72,1204.01352399412,0.395889144370626
16076,519026.071,5338173.292,158,93,65,37.43,0,2005,1,117,308,170,0.863113553335475,44.2,17.3054945054945,53,1204.01352399412,0.395889144370626
16076,519026.071,5338173.292,191,69,122,27.774,1,2006,2,126,335,177,0.832827210838907,92.3,18.2626373626374,51,1204.01352399412,0.395889144370626
16076,519026.071,5338173.292,0,0,0,37.96,0,2007,0,106,296,160,0.828905718198323,332.6,16.5076923076923,54,1204.01352399412,0.395889144370626
16076,519026.071,5338173.292,166,62,104,35.797,0,2008,2,111,299,185,0.848389344392982,50.1,16.9747252747253,74,1204.01352399412,0.395889144370626
16076,519026.071,5338173.292,178,58,120,33.61,0,2009,2,111,293,170,0.8706394959162,55,17.8153846153846,59,1204.01352399412,0.395889144370626
16076,519026.071,5338173.292,174,102,72,25.349,0,2010,1,122,302,178,0.850210895078908,133.1,17.7351648351648,56,1204.01352399412,0.395889144370626
16076,519026.071,5338173.292,93,68,25,33.726,1,2011,2,99,316,153,0.832541704266201,136.1,17.0351648351648,54,1204.01352399412,0.395889144370626
16076,519026.071,5338173.292,145,93,52,47.977,1,2012,1,104,304,176,0.866114443696986,88.9,18.4296703296703,72,1204.01352399412,0.395889144370626
16076,519026.071,5338173.292,185,116,69,27.855,1,2013,1,127,298,192,0.844200002750995,-156.9,18.6175824175824,65,1204.01352399412,0.395889144370626
16076,519026.071,5338173.292,156,44,112,38.138,3,2014,2,103,330,169,0.829814251988574,191.6,17.4516483516484,66,1204.01352399412,0.395889144370626
16076,519026.071,5338173.292,166,93,73,34.04,0,2015,2,116,331,201,0.85322845901869,-154.6,20.4153846153846,85,1204.01352399412,0.395889144370626
16076,519026.071,5338173.292,172,102,70,35.983,3,2016,1,119,338,185,0.848693998503544,50.9,18.5681318681319,66,1204.01352399412,0.395889144370626
16076,519026.071,5338173.292,150,94,56,29.833,1,2017,1,118,299,176,0.849119258610819,-2.3,19.1582417582418,58,1204.01352399412,0.395889144370626
16076,519026.071,5338173.292,167,61,106,44.029,0,2018,2,101,297,162,0.858239251152295,-151.3,19.9417582417582,61,1204.01352399412,0.395889144370626
16076,519026.071,5338173.292,156,95,61,28.448,4,2019,1,122,323,177,0.826555648617473,-73.4,20.0571428571429,55,1204.01352399412,0.395889144370626
16076,519026.071,5338173.292,0,0,0,28.469,0,2020,0,108,309,185,0.789503715117229,-13.6,18.3758241758242,77,1204.01352399412,0.395889144370626
16077,519026.071,5337941.635,0,0,0,53.14,0,2001,2,101,294,169,0.830601958027766,116.8,17.4,68,1154.50988729312,-1.49610363686302
16077,519026.071,5337941.635,93,69,24,27.175,0,2002,3,123,299,185,0.842629038204748,52.7,17.567032967033,62,1154.50988729312,-1.49610363686302
16077,519026.071,5337941.635,168,93,75,31.289,0,2003,1,117,314,162,0.841059792423497,-198,22.3252747252747,45,1154.50988729312,-1.49610363686302
16077,519026.071,5337941.635,166,93,73,29.039,0,2004,2,121,321,185,0.86034410845681,209.7,17.0835164835165,64,1154.50988729312,-1.49610363686302
16077,519026.071,5337941.635,159,93,66,38.543,0,2005,1,116,307,169,0.868687458761683,44.2,17.3054945054945,53,1154.50988729312,-1.49610363686302
16077,519026.071,5337941.635,190,68,122,32.448,1,2006,2,121,327,176,0.84627997745736,92.3,18.2626373626374,55,1154.50988729312,-1.49610363686302
16077,519026.071,5337941.635,0,0,0,38.738,0,2007,0,105,298,161,0.838021529648226,332.6,16.5076923076923,56,1154.50988729312,-1.49610363686302
16077,519026.071,5337941.635,166,62,104,32.386,0,2008,2,114,302,184,0.830426188013245,50.1,16.9747252747253,70,1154.50988729312,-1.49610363686302
16077,519026.071,5337941.635,175,59,116,47.531,0,2009,2,98,284,170,0.862357263441063,55,17.8153846153846,72,1154.50988729312,-1.49610363686302
16077,519026.071,5337941.635,174,101,73,25.349,0,2010,1,122,304,185,0.864855406042189,133.1,17.7351648351648,63,1154.50988729312,-1.49610363686302
16077,519026.071,5337941.635,86,71,15,30.511,1,2011,1,103,317,161,0.858493955955597,136.1,17.0351648351648,58,1154.50988729312,-1.49610363686302
16077,519026.071,5337941.635,144,93,51,43.658,0,2012,1,109,303,177,0.874896657798103,88.9,18.4296703296703,68,1154.50988729312,-1.49610363686302
16077,519026.071,5337941.635,189,93,96,25.798,1,2013,2,129,296,185,0.854374683693623,-156.9,18.6175824175824,56,1154.50988729312,-1.49610363686302
16077,519026.071,5337941.635,157,46,111,36.814,3,2014,2,105,327,170,0.835264757599175,191.6,17.4516483516484,65,1154.50988729312,-1.49610363686302
16077,519026.071,5337941.635,166,93,73,34.827,0,2015,2,115,320,184,0.833598011380598,-154.6,20.4153846153846,69,1154.50988729312,-1.49610363686302
16077,519026.071,5337941.635,177,93,84,35.983,3,2016,2,119,328,208,0.85266433007635,50.9,18.5681318681319,89,1154.50988729312,-1.49610363686302
16077,519026.071,5337941.635,150,93,57,27.443,0,2017,1,121,305,176,0.855596085877505,-2.3,19.1582417582418,55,1154.50988729312,-1.49610363686302
16077,519026.071,5337941.635,175,64,111,36.94,0,2018,2,108,294,161,0.866396110681031,-151.3,19.9417582417582,53,1154.50988729312,-1.49610363686302
16077,519026.071,5337941.635,158,93,65,26.669,4,2019,1,124,325,177,0.828893702972171,-73.4,20.0571428571429,53,1154.50988729312,-1.49610363686302
16077,519026.071,5337941.635,0,0,0,30.444,0,2020,0,105,297,186,0.8336315154595,-13.6,18.3758241758242,81,1154.50988729312,-1.49610363686302
16294,519257.727,5338404.948,145,97,48,33.71,0,2001,4,118,263,193,0.8616297249951,116.8,17.4,75,1280.59870144725,-0.441989984780123
16294,519257.727,5338404.948,84,59,25,23.157,0,2002,1,127,300,185,0.863913547549785,52.7,17.567032967033,58,1280.59870144725,-0.441989984780123
16294,519257.727,5338404.948,167,62,105,32.92,0,2003,2,115,298,170,0.858895072228704,-198,22.3252747252747,55,1280.59870144725,-0.441989984780123
16294,519257.727,5338404.948,162,100,62,20.014,0,2004,2,131,311,193,0.861926628528729,209.7,17.0835164835165,62,1280.59870144725,-0.441989984780123
16294,519257.727,5338404.948,162,93,69,32.157,0,2005,1,122,301,170,0.858186870742445,44.2,17.3054945054945,48,1280.59870144725,-0.441989984780123
16294,519257.727,5338404.948,195,64,131,18.152,1,2006,3,136,326,185,0.825023057444949,92.3,18.2626373626374,49,1280.59870144725,-0.441989984780123
16294,519257.727,5338404.948,93,93,0,39.541,0,2007,1,104,295,168,0.846700608489478,332.6,16.5076923076923,64,1280.59870144725,-0.441989984780123
16294,519257.727,5338404.948,178,109,69,6.123,0,2008,2,145,296,200,0.799361803282394,50.1,16.9747252747253,55,1280.59870144725,-0.441989984780123
16294,519257.727,5338404.948,181,65,116,24.036,0,2009,2,122,294,177,0.854822423449519,55,17.8153846153846,55,1280.59870144725,-0.441989984780123
16294,519257.727,5338404.948,176,76,100,20.929,0,2010,2,128,298,186,0.866260880258936,133.1,17.7351648351648,58,1280.59870144725,-0.441989984780123
16294,519257.727,5338404.948,141,66,75,28.941,0,2011,2,105,305,161,0.835101410507255,136.1,17.0351648351648,56,1280.59870144725,-0.441989984780123
16294,519257.727,5338404.948,162,93,69,31.399,0,2012,1,121,311,178,0.885851053599141,88.9,18.4296703296703,57,1280.59870144725,-0.441989984780123
16294,519257.727,5338404.948,181,66,115,17.728,1,2013,3,137,291,193,0.864457335940334,-156.9,18.6175824175824,56,1280.59870144725,-0.441989984780123
16294,519257.727,5338404.948,157,55,102,32.409,0,2014,3,112,323,201,0.855470828039613,191.6,17.4516483516484,89,1280.59870144725,-0.441989984780123
16294,519257.727,5338404.948,172,99,73,37.257,0,2015,2,112,308,201,0.861487807214542,-154.6,20.4153846153846,89,1280.59870144725,-0.441989984780123
16294,519257.727,5338404.948,174,124,50,21.442,0,2016,1,133,329,186,0.878028517347183,50.9,18.5681318681319,53,1280.59870144725,-0.441989984780123
16294,519257.727,5338404.948,144,93,51,23.411,0,2017,1,126,294,177,0.850167239109237,-2.3,19.1582417582418,51,1280.59870144725,-0.441989984780123
16294,519257.727,5338404.948,173,48,125,30.829,0,2018,2,115,288,177,0.854936116106248,-151.3,19.9417582417582,62,1280.59870144725,-0.441989984780123
16294,519257.727,5338404.948,151,75,76,23.027,0,2019,2,128,302,178,0.841506852969679,-73.4,20.0571428571429,50,1280.59870144725,-0.441989984780123
16294,519257.727,5338404.948,0,0,0,19.169,0,2020,0,124,304,225,0.807793408657278,-13.6,18.3758241758242,101,1280.59870144725,-0.441989984780123
16295,519257.727,5338173.292,0,0,0,40.345,0,2001,2,112,291,176,0.824056164994352,116.8,17.4,64,1239.55970892082,-0.257602657165653
16295,519257.727,5338173.292,93,69,24,25.202,0,2002,3,125,297,185,0.84999801149428,52.7,17.567032967033,60,1239.55970892082,-0.257602657165653
16295,519257.727,5338173.292,169,93,76,32.108,0,2003,1,116,311,162,0.845700053036515,-198,22.3252747252747,46,1239.55970892082,-0.257602657165653
16295,519257.727,5338173.292,167,99,68,23.915,0,2004,2,127,329,192,0.86251195235689,209.7,17.0835164835165,65,1239.55970892082,-0.257602657165653
16295,519257.727,5338173.292,160,93,67,35.225,0,2005,1,119,308,176,0.868493215998337,44.2,17.3054945054945,57,1239.55970892082,-0.257602657165653
16295,519257.727,5338173.292,194,69,125,23.03,1,2006,2,131,333,177,0.830394349555348,92.3,18.2626373626374,46,1239.55970892082,-0.257602657165653
16295,519257.727,5338173.292,0,0,0,41.204,0,2007,0,102,297,162,0.833783481303991,332.6,16.5076923076923,60,1239.55970892082,-0.257602657165653
16295,519257.727,5338173.292,170,62,108,28.83,0,2008,2,117,298,185,0.841743014196426,50.1,16.9747252747253,68,1239.55970892082,-0.257602657165653
16295,519257.727,5338173.292,183,58,125,28.202,0,2009,2,117,287,177,0.869585147166401,55,17.8153846153846,60,1239.55970892082,-0.257602657165653
16295,519257.727,5338173.292,176,105,71,21.716,0,2010,1,127,305,178,0.851906180385133,133.1,17.7351648351648,51,1239.55970892082,-0.257602657165653
16295,519257.727,5338173.292,93,69,24,32.898,1,2011,2,100,317,154,0.834966780139763,136.1,17.0351648351648,54,1239.55970892082,-0.257602657165653
16295,519257.727,5338173.292,149,94,55,37.848,0,2012,1,115,302,176,0.872924425716777,88.9,18.4296703296703,61,1239.55970892082,-0.257602657165653
16295,519257.727,5338173.292,184,93,91,25.798,1,2013,2,129,294,186,0.856471541119404,-156.9,18.6175824175824,57,1239.55970892082,-0.257602657165653
16295,519257.727,5338173.292,156,44,112,36.814,3,2014,2,105,332,176,0.832681718031559,191.6,17.4516483516484,71,1239.55970892082,-0.257602657165653
16295,519257.727,5338173.292,170,126,44,36.427,0,2015,1,113,325,169,0.853375742233224,-154.6,20.4153846153846,56,1239.55970892082,-0.257602657165653
16295,519257.727,5338173.292,175,93,82,24.254,0,2016,2,130,332,186,0.873921882999101,50.9,18.5681318681319,56,1239.55970892082,-0.257602657165653
16295,519257.727,5338173.292,151,94,57,27.443,0,2017,1,121,308,170,0.83620042054701,-2.3,19.1582417582418,49,1239.55970892082,-0.257602657165653
16295,519257.727,5338173.292,173,64,109,39.924,0,2018,2,105,295,169,0.852877723092057,-151.3,19.9417582417582,64,1239.55970892082,-0.257602657165653
16295,519257.727,5338173.292,156,93,63,25.763,3,2019,1,125,318,177,0.831058310080967,-73.4,20.0571428571429,52,1239.55970892082,-0.257602657165653
16295,519257.727,5338173.292,0,0,0,21.659,0,2020,0,120,310,185,0.807620817903478,-13.6,18.3758241758242,65,1239.55970892082,-0.257602657165653
16296,519257.727,5337941.635,0,0,0,50.688,0,2001,2,103,291,170,0.838550860524962,116.8,17.4,67,1202.5920936494,-1.38131605048273
16296,519257.727,5337941.635,93,69,24,24.173,0,2002,2,126,297,178,0.833624647831731,52.7,17.567032967033,52,1202.5920936494,-1.38131605048273
16296,519257.727,5337941.635,170,93,77,28.806,0,2003,1,120,297,169,0.839929375294444,-198,22.3252747252747,49,1202.5920936494,-1.38131605048273
16296,519257.727,5337941.635,168,93,75,25.676,0,2004,2,125,317,184,0.840811235683301,209.7,17.0835164835165,59,1202.5920936494,-1.38131605048273
16296,519257.727,5337941.635,160,93,67,36.316,0,2005,1,118,305,170,0.867031005820706,44.2,17.3054945054945,52,1202.5920936494,-1.38131605048273
16296,519257.727,5337941.635,193,68,125,25.077,1,2006,2,129,332,178,0.826018278554495,92.3,18.2626373626374,49,1202.5920936494,-1.38131605048273
16296,519257.727,5337941.635,0,0,0,45.71,0,2007,0,97,297,161,0.823888131822609,332.6,16.5076923076923,64,1202.5920936494,-1.38131605048273
16296,519257.727,5337941.635,169,62,107,29.979,0,2008,3,116,299,185,0.836400019977796,50.1,16.9747252747253,69,1202.5920936494,-1.38131605048273
16296,519257.727,5337941.635,175,59,116,46.255,0,2009,2,99,282,169,0.858278372868463,55,17.8153846153846,70,1202.5920936494,-1.38131605048273
16296,519257.727,5337941.635,175,100,75,22.475,0,2010,1,126,305,185,0.842283670149166,133.1,17.7351648351648,59,1202.5920936494,-1.38131605048273
16296,519257.727,5337941.635,86,70,16,31.308,1,2011,1,102,314,161,0.84655595807078,136.1,17.0351648351648,59,1202.5920936494,-1.38131605048273
16296,519257.727,5337941.635,151,93,58,34.503,0,2012,1,118,301,176,0.87363920099611,88.9,18.4296703296703,58,1202.5920936494,-1.38131605048273
16296,519257.727,5337941.635,190,153,37,22.774,1,2013,1,132,289,185,0.850844601671531,-156.9,18.6175824175824,53,1202.5920936494,-1.38131605048273
16296,519257.727,5337941.635,157,45,112,34.896,1,2014,2,108,327,177,0.839447987266566,191.6,17.4516483516484,69,1202.5920936494,-1.38131605048273
16296,519257.727,5337941.635,162,93,69,51.653,1,2015,1,97,313,161,0.821408366522916,-154.6,20.4153846153846,64,1202.5920936494,-1.38131605048273
16296,519257.727,5337941.635,176,109,67,26.194,0,2016,2,128,317,201,0.85505977952649,50.9,18.5681318681319,73,1202.5920936494,-1.38131605048273
16296,519257.727,5337941.635,155,93,62,29.833,1,2017,1,118,307,169,0.829860692161823,-2.3,19.1582417582418,51,1202.5920936494,-1.38131605048273
16296,519257.727,5337941.635,174,64,110,35.087,0,2018,2,110,293,177,0.816321621999665,-151.3,19.9417582417582,67,1202.5920936494,-1.38131605048273
16296,519257.727,5337941.635,158,93,65,23.027,0,2019,1,128,317,176,0.811610811753957,-73.4,20.0571428571429,48,1202.5920936494,-1.38131605048273
16296,519257.727,5337941.635,0,0,0,22.185,0,2020,0,119,302,185,0.823740644174777,-13.6,18.3758241758242,66,1202.5920936494,-1.38131605048273
16297,519257.727,5337709.979,86,82,4,41.484,3,2001,2,111,291,178,0.830846660723362,116.8,17.4,67,1238.03023445942,0.2770077547978
16297,519257.727,5337709.979,130,66,64,22.161,0,2002,3,128,295,185,0.86609647529224,52.7,17.567032967033,57,1238.03023445942,0.2770077547978
16297,519257.727,5337709.979,167,121,46,27.888,0,2003,1,121,307,169,0.842421358905582,-198,22.3252747252747,48,1238.03023445942,0.2770077547978
16297,519257.727,5337709.979,160,93,67,20.014,0,2004,1,131,313,178,0.830207906366238,209.7,17.0835164835165,47,1238.03023445942,0.2770077547978
16297,519257.727,5337709.979,163,86,77,30.232,0,2005,2,124,305,178,0.87103915060756,44.2,17.3054945054945,54,1238.03023445942,0.2770077547978
16297,519257.727,5337709.979,191,68,123,15.23,1,2006,2,139,319,185,0.831224958043099,92.3,18.2626373626374,46,1238.03023445942,0.2770077547978
16297,519257.727,5337709.979,93,93,0,40.363,0,2007,1,103,285,170,0.83526396631862,332.6,16.5076923076923,67,1238.03023445942,0.2770077547978
16297,519257.727,5337709.979,119,53,66,15.641,0,2008,3,131,294,184,0.843000148981797,50.1,16.9747252747253,53,1238.03023445942,0.2770077547978
16297,519257.727,5337709.979,184,56,128,26.517,0,2009,3,119,288,161,0.853222293903791,55,17.8153846153846,42,1238.03023445942,0.2770077547978
16297,519257.727,5337709.979,171,72,99,18.484,0,2010,2,131,286,201,0.857445166731072,133.1,17.7351648351648,70,1238.03023445942,0.2770077547978
16297,519257.727,5337709.979,146,93,53,27.418,0,2011,2,107,305,208,0.823568818116157,136.1,17.0351648351648,101,1238.03023445942,0.2770077547978
16297,519257.727,5337709.979,164,108,56,27.325,0,2012,1,125,301,170,0.876868191607882,88.9,18.4296703296703,45,1238.03023445942,0.2770077547978
16297,519257.727,5337709.979,183,63,120,18.745,1,2013,3,136,294,194,0.859218169489654,-156.9,18.6175824175824,58,1238.03023445942,0.2770077547978
16297,519257.727,5337709.979,163,43,120,30.572,0,2014,2,115,316,176,0.823021661735694,191.6,17.4516483516484,61,1238.03023445942,0.2770077547978
16297,519257.727,5337709.979,166,93,73,32.41,0,2015,1,118,316,177,0.861859385900439,-154.6,20.4153846153846,59,1238.03023445942,0.2770077547978
16297,519257.727,5337709.979,169,117,52,17.425,0,2016,1,137,322,186,0.851579201803083,50.9,18.5681318681319,49,1238.03023445942,0.2770077547978
16297,519257.727,5337709.979,151,116,35,26.643,0,2017,1,122,296,186,0.856890415505589,-2.3,19.1582417582418,64,1238.03023445942,0.2770077547978
16297,519257.727,5337709.979,168,56,112,37.913,0,2018,2,107,311,161,0.863237896868017,-151.3,19.9417582417582,54,1238.03023445942,0.2770077547978
16297,519257.727,5337709.979,152,93,59,20.006,0,2019,1,131,309,178,0.846802035575441,-73.4,20.0571428571429,47,1238.03023445942,0.2770077547978
16297,519257.727,5337709.979,0,0,0,24.854,0,2020,0,114,302,217,0.843999270703455,-13.6,18.3758241758242,103,1238.03023445942,0.2770077547978
16298,519257.727,5337478.323,86,82,4,33.71,0,2001,3,118,291,193,0.856821711463631,116.8,17.4,75,1280.74176614005,1.37113617529704
16298,519257.727,5337478.323,128,66,62,16.37,0,2002,3,134,296,193,0.862320755482285,52.7,17.567032967033,59,1280.74176614005,1.37113617529704
16298,519257.727,5337478.323,159,93,66,37.087,0,2003,1,110,287,177,0.841767822630547,-198,22.3252747252747,67,1280.74176614005,1.37113617529704
16298,519257.727,5337478.323,160,110,50,17.848,0,2004,2,133,318,201,0.852478871806595,209.7,17.0835164835165,68,1280.74176614005,1.37113617529704
16298,519257.727,5337478.323,164,86,78,29.22,0,2005,3,125,305,184,0.866632616520981,44.2,17.3054945054945,59,1280.74176614005,1.37113617529704
16298,519257.727,5337478.323,191,68,123,15.23,1,2006,2,139,323,193,0.825945351581344,92.3,18.2626373626374,54,1280.74176614005,1.37113617529704
16298,519257.727,5337478.323,0,0,0,42.066,0,2007,0,101,286,194,0.836371638279405,332.6,16.5076923076923,93,1280.74176614005,1.37113617529704
16298,519257.727,5337478.323,128,53,75,13.466,0,2008,3,134,309,185,0.832774204026308,50.1,16.9747252747253,51,1280.74176614005,1.37113617529704
16298,519257.727,5337478.323,185,63,122,21.587,0,2009,3,125,288,168,0.837666331279365,55,17.8153846153846,43,1280.74176614005,1.37113617529704
16298,519257.727,5337478.323,172,73,99,16.748,0,2010,2,133,285,208,0.865979043701468,133.1,17.7351648351648,75,1280.74176614005,1.37113617529704
16298,519257.727,5337478.323,144,99,45,26.677,0,2011,2,108,299,200,0.834096503524508,136.1,17.0351648351648,92,1280.74176614005,1.37113617529704
16298,519257.727,5337478.323,164,111,53,26.328,0,2012,1,126,302,176,0.870455219915083,88.9,18.4296703296703,50,1280.74176614005,1.37113617529704
16298,519257.727,5337478.323,178,65,113,16.683,1,2013,3,138,296,194,0.855749096355799,-156.9,18.6175824175824,56,1280.74176614005,1.37113617529704
16298,519257.727,5337478.323,166,43,123,28.765,0,2014,2,118,325,184,0.824894656234146,191.6,17.4516483516484,66,1280.74176614005,1.37113617529704
16298,519257.727,5337478.323,164,93,71,32.41,0,2015,2,118,324,185,0.864359009614383,-154.6,20.4153846153846,67,1280.74176614005,1.37113617529704
16298,519257.727,5337478.323,168,110,58,19.418,0,2016,1,135,321,186,0.878356669964481,50.9,18.5681318681319,51,1280.74176614005,1.37113617529704
16298,519257.727,5337478.323,151,113,38,25.846,0,2017,1,123,290,178,0.845977739232218,-2.3,19.1582417582418,55,1280.74176614005,1.37113617529704
16298,519257.727,5337478.323,169,52,117,34.205,0,2018,2,111,315,170,0.856889090171021,-151.3,19.9417582417582,59,1280.74176614005,1.37113617529704
16298,519257.727,5337478.323,152,93,59,17.884,0,2019,2,133,307,185,0.84853594119179,-73.4,20.0571428571429,52,1280.74176614005,1.37113617529704
16298,519257.727,5337478.323,0,0,0,24.299,0,2020,0,115,295,192,0.8325255330011,-13.6,18.3758241758242,77,1280.74176614005,1.37113617529704
16299,519257.727,5337246.666,86,85,1,29.381,0,2001,2,122,289,193,0.85262976858283,116.8,17.4,71,1288.07121070767,-0.743995221802131
16299,519257.727,5337246.666,86,52,34,20.235,0,2002,1,130,298,185,0.874768376857337,52.7,17.567032967033,55,1288.07121070767,-0.743995221802131
16299,519257.727,5337246.666,167,127,40,24.203,0,2003,1,125,295,178,0.852091954915542,-198,22.3252747252747,53,1288.07121070767,-0.743995221802131
16299,519257.727,5337246.666,156,94,62,26.516,0,2004,2,124,327,209,0.867699994052442,209.7,17.0835164835165,85,1288.07121070767,-0.743995221802131
16299,519257.727,5337246.666,162,93,69,28.191,0,2005,1,126,305,176,0.816335859854196,44.2,17.3054945054945,50,1288.07121070767,-0.743995221802131
16299,519257.727,5337246.666,174,56,118,26.901,1,2006,3,127,334,194,0.816296858214851,92.3,18.2626373626374,67,1288.07121070767,-0.743995221802131
16299,519257.727,5337246.666,105,93,12,42.066,0,2007,2,101,300,186,0.839560669197722,332.6,16.5076923076923,85,1288.07121070767,-0.743995221802131
16299,519257.727,5337246.666,0,0,0,18.901,0,2008,0,127,304,185,0.847432950568262,50.1,16.9747252747253,58,1288.07121070767,-0.743995221802131
16299,519257.727,5337246.666,180,65,115,26.517,0,2009,2,119,286,154,0.806345198245092,55,17.8153846153846,35,1288.07121070767,-0.743995221802131
16299,519257.727,5337246.666,168,69,99,19.346,0,2010,3,130,299,185,0.85120384220361,133.1,17.7351648351648,55,1288.07121070767,-0.743995221802131
16299,519257.727,5337246.666,126,93,33,27.418,0,2011,1,107,310,169,0.834329872804976,136.1,17.0351648351648,62,1288.07121070767,-0.743995221802131
16299,519257.727,5337246.666,151,93,58,29.388,0,2012,1,123,301,177,0.859922449843033,88.9,18.4296703296703,54,1288.07121070767,-0.743995221802131
16299,519257.727,5337246.666,178,59,119,20.729,1,2013,3,134,299,201,0.851053186053415,-156.9,18.6175824175824,67,1288.07121070767,-0.743995221802131
16299,519257.727,5337246.666,151,58,93,31.174,0,2014,2,114,313,177,0.835459337182497,191.6,17.4516483516484,63,1288.07121070767,-0.743995221802131
16299,519257.727,5337246.666,164,93,71,32.41,0,2015,2,118,330,185,0.857359590617716,-154.6,20.4153846153846,67,1288.07121070767,-0.743995221802131
16299,519257.727,5337246.666,172,134,38,20.433,0,2016,1,134,330,194,0.86444779294647,50.9,18.5681318681319,60,1288.07121070767,-0.743995221802131
16299,519257.727,5337246.666,141,94,47,29.833,1,2017,1,118,306,177,0.853190509731526,-2.3,19.1582417582418,59,1288.07121070767,-0.743995221802131
16299,519257.727,5337246.666,169,63,106,36.94,0,2018,2,108,304,177,0.86299003181823,-151.3,19.9417582417582,69,1288.07121070767,-0.743995221802131
16299,519257.727,5337246.666,167,108,59,24.842,2,2019,1,126,305,185,0.839314218648761,-73.4,20.0571428571429,59,1288.07121070767,-0.743995221802131
16299,519257.727,5337246.666,0,0,0,23.757,0,2020,0,116,302,202,0.832306959606172,-13.6,18.3758241758242,86,1288.07121070767,-0.743995221802131
16300,519257.727,5337015.01,86,86,0,17.609,0,2001,1,134,287,194,0.854741751672971,116.8,17.4,60,1250.65162029438,-0.464345080789642
16300,519257.727,5337015.01,86,50,36,23.157,0,2002,1,127,299,185,0.873401104006196,52.7,17.567032967033,58,1250.65162029438,-0.464345080789642
16300,519257.727,5337015.01,161,93,68,27.888,0,2003,1,121,305,177,0.839912426902184,-198,22.3252747252747,56,1250.65162029438,-0.464345080789642
16300,519257.727,5337015.01,157,99,58,27.35,0,2004,2,123,323,201,0.870287210827571,209.7,17.0835164835165,78,1250.65162029438,-0.464345080789642
16300,519257.727,5337015.01,160,94,66,32.157,0,2005,1,122,306,170,0.841163896637935,44.2,17.3054945054945,48,1250.65162029438,-0.464345080789642
16300,519257.727,5337015.01,177,56,121,26.035,1,2006,2,128,334,186,0.823802539097993,92.3,18.2626373626374,58,1250.65162029438,-0.464345080789642
16300,519257.727,5337015.01,102,93,9,47.653,0,2007,1,95,300,176,0.846334268783878,332.6,16.5076923076923,81,1250.65162029438,-0.464345080789642
16300,519257.727,5337015.01,0,0,0,20.699,0,2008,0,125,298,178,0.871234547045668,50.1,16.9747252747253,53,1250.65162029438,-0.464345080789642
16300,519257.727,5337015.01,173,63,110,39.614,0,2009,2,105,290,153,0.827122152569358,55,17.8153846153846,48,1250.65162029438,-0.464345080789642
16300,519257.727,5337015.01,172,73,99,22.475,0,2010,2,126,300,177,0.850898649344859,133.1,17.7351648351648,51,1250.65162029438,-0.464345080789642
16300,519257.727,5337015.01,126,93,33,28.941,0,2011,1,105,310,161,0.855293113125996,136.1,17.0351648351648,56,1250.65162029438,-0.464345080789642
16300,519257.727,5337015.01,149,93,56,36.732,0,2012,1,116,302,176,0.867483571740653,88.9,18.4296703296703,60,1250.65162029438,-0.464345080789642
16300,519257.727,5337015.01,178,62,116,19.732,1,2013,3,135,295,193,0.856357876335722,-156.9,18.6175824175824,58,1250.65162029438,-0.464345080789642
16300,519257.727,5337015.01,151,56,95,31.787,0,2014,2,113,314,177,0.837267943111896,191.6,17.4516483516484,64,1250.65162029438,-0.464345080789642
16300,519257.727,5337015.01,170,131,39,31.517,0,2015,1,119,329,178,0.858921687496592,-154.6,20.4153846153846,59,1250.65162029438,-0.464345080789642
16300,519257.727,5337015.01,172,137,35,31.607,0,2016,1,123,327,194,0.868990855280383,50.9,18.5681318681319,71,1250.65162029438,-0.464345080789642
16300,519257.727,5337015.01,141,94,47,25.846,0,2017,2,123,305,184,0.862482246204307,-2.3,19.1582417582418,61,1250.65162029438,-0.464345080789642
16300,519257.727,5337015.01,175,62,113,34.205,0,2018,2,111,301,170,0.87164247305409,-151.3,19.9417582417582,59,1250.65162029438,-0.464345080789642
16300,519257.727,5337015.01,167,93,74,17.884,0,2019,2,133,307,185,0.850746399904902,-73.4,20.0571428571429,52,1250.65162029438,-0.464345080789642
16300,519257.727,5337015.01,0,0,0,23.757,0,2020,0,116,303,202,0.829174733701997,-13.6,18.3758241758242,86,1250.65162029438,-0.464345080789642
16301,519257.727,5336783.354,0,0,0,17.609,0,2001,2,134,298,201,0.85928075471636,116.8,17.4,67,1240.99549118232,-0.362504638540677
16301,519257.727,5336783.354,93,93,0,23.157,0,2002,2,127,299,200,0.861045668442098,52.7,17.567032967033,73,1240.99549118232,-0.362504638540677
16301,519257.727,5336783.354,161,93,68,25.099,0,2003,2,124,290,184,0.838651009029684,-198,22.3252747252747,60,1240.99549118232,-0.362504638540677
16301,519257.727,5336783.354,150,93,57,23.915,0,2004,2,127,296,186,0.872396969458867,209.7,17.0835164835165,59,1240.99549118232,-0.362504638540677
16301,519257.727,5336783.354,153,96,57,33.142,0,2005,1,121,313,177,0.865530896345941,44.2,17.3054945054945,56,1240.99549118232,-0.362504638540677
16301,519257.727,5336783.354,188,93,95,24.051,1,2006,2,130,330,217,0.911274098489327,92.3,18.2626373626374,87,1240.99549118232,-0.362504638540677
16301,519257.727,5336783.354,124,93,31,46.67,0,2007,2,96,299,209,0.84332009633116,332.6,16.5076923076923,113,1240.99549118232,-0.362504638540677
16301,519257.727,5336783.354,86,74,12,23.59,0,2008,1,122,295,218,0.878563937776491,50.1,16.9747252747253,96,1240.99549118232,-0.362504638540677
16301,519257.727,5336783.354,171,61,110,31.72,0,2009,2,113,289,154,0.818141444392534,55,17.8153846153846,41,1240.99549118232,-0.362504638540677
16301,519257.727,5336783.354,162,70,92,22.475,0,2010,3,126,284,186,0.863438815981431,133.1,17.7351648351648,60,1240.99549118232,-0.362504638540677
16301,519257.727,5336783.354,0,0,0,29.721,0,2011,0,104,309,170,0.841408742771899,136.1,17.0351648351648,66,1240.99549118232,-0.362504638540677
16301,519257.727,5336783.354,153,93,60,31.399,0,2012,1,121,297,177,0.872923192621382,88.9,18.4296703296703,56,1240.99549118232,-0.362504638540677
16301,519257.727,5336783.354,173,93,80,20.729,1,2013,2,134,291,209,0.852880434641895,-156.9,18.6175824175824,75,1240.99549118232,-0.362504638540677
16301,519257.727,5336783.354,153,55,98,29.382,0,2014,2,117,317,169,0.802384391936374,191.6,17.4516483516484,52,1240.99549118232,-0.362504638540677
16301,519257.727,5336783.354,152,93,59,22.759,0,2015,2,127,307,184,0.854473603943699,-154.6,20.4153846153846,57,1240.99549118232,-0.362504638540677
16301,519257.727,5336783.354,168,93,75,23.323,0,2016,3,131,327,200,0.866142039326021,50.9,18.5681318681319,69,1240.99549118232,-0.362504638540677
16301,519257.727,5336783.354,131,94,37,32.826,3,2017,2,114,302,184,0.852676102749763,-2.3,19.1582417582418,70,1240.99549118232,-0.362504638540677
16301,519257.727,5336783.354,173,68,105,34.205,0,2018,2,111,307,176,0.87751450799313,-151.3,19.9417582417582,65,1240.99549118232,-0.362504638540677
16301,519257.727,5336783.354,97,96,1,15.856,0,2019,2,135,315,186,0.860974630641258,-73.4,20.0571428571429,51,1240.99549118232,-0.362504638540677
16301,519257.727,5336783.354,0,0,0,24.299,0,2020,0,115,304,201,0.828522939212339,-13.6,18.3758241758242,86,1240.99549118232,-0.362504638540677
16513,519489.383,5338404.948,86,85,1,40.345,2,2001,2,112,287,185,0.876408202916198,116.8,17.4,73,1273.20195527549,0.907565920734893
16513,519489.383,5338404.948,162,72,90,22.161,0,2002,2,128,292,186,0.860755757964854,52.7,17.567032967033,58,1273.20195527549,0.907565920734893
16513,519489.383,5338404.948,158,93,65,33.746,0,2003,1,114,295,176,0.858831628851084,-198,22.3252747252747,62,1273.20195527549,0.907565920734893
16513,519489.383,5338404.948,170,113,57,11.049,0,2004,2,140,314,209,0.834930186384009,209.7,17.0835164835165,69,1273.20195527549,0.907565920734893
16513,519489.383,5338404.948,163,93,70,32.157,0,2005,1,122,299,176,0.872298715444033,44.2,17.3054945054945,54,1273.20195527549,0.907565920734893
16513,519489.383,5338404.948,195,64,131,16.262,1,2006,2,138,329,178,0.81570453568909,92.3,18.2626373626374,40,1273.20195527549,0.907565920734893
16513,519489.383,5338404.948,0,0,0,36.473,0,2007,0,108,289,169,0.872897592838452,332.6,16.5076923076923,61,1273.20195527549,0.907565920734893
16513,519489.383,5338404.948,153,93,60,1.543,0,2008,2,152,294,216,0.862396478363935,50.1,16.9747252747253,64,1273.20195527549,0.907565920734893
16513,519489.383,5338404.948,186,69,117,25.678,0,2009,3,120,290,176,0.893609727982007,55,17.8153846153846,56,1273.20195527549,0.907565920734893
16513,519489.383,5338404.948,170,62,108,20.929,0,2010,2,128,287,178,0.849421611676152,133.1,17.7351648351648,50,1273.20195527549,0.907565920734893
16513,519489.383,5338404.948,141,93,48,28.941,0,2011,1,105,312,162,0.826119437391399,136.1,17.0351648351648,57,1273.20195527549,0.907565920734893
16513,519489.383,5338404.948,180,98,82,21.301,0,2012,1,131,304,178,0.888806132378572,88.9,18.4296703296703,47,1273.20195527549,0.907565920734893
16513,519489.383,5338404.948,182,77,105,19.732,1,2013,3,135,288,192,0.868192352954853,-156.9,18.6175824175824,57,1273.20195527549,0.907565920734893
16513,519489.383,5338404.948,76,45,31,30.572,0,2014,1,115,328,194,0.867142965661274,191.6,17.4516483516484,79,1273.20195527549,0.907565920734893
16513,519489.383,5338404.948,161,86,75,45.375,0,2015,3,103,302,192,0.84717494375559,-154.6,20.4153846153846,89,1273.20195527549,0.907565920734893
16513,519489.383,5338404.948,174,93,81,19.418,0,2016,2,135,317,194,0.861589941665024,50.9,18.5681318681319,59,1273.20195527549,0.907565920734893
16513,519489.383,5338404.948,109,99,10,24.229,0,2017,1,125,291,178,0.860399315273217,-2.3,19.1582417582418,53,1273.20195527549,0.907565920734893
16513,519489.383,5338404.948,175,58,117,31.681,0,2018,2,114,291,176,0.855395137420196,-151.3,19.9417582417582,62,1273.20195527549,0.907565920734893
16513,519489.383,5338404.948,156,93,63,20.006,0,2019,1,131,301,176,0.833898073333433,-73.4,20.0571428571429,45,1273.20195527549,0.907565920734893
16513,519489.383,5338404.948,0,0,0,23.227,0,2020,0,117,306,200,0.786731000069331,-13.6,18.3758241758242,83,1273.20195527549,0.907565920734893
16517,519489.383,5337478.323,115,86,29,32.639,0,2001,4,119,291,193,0.869612213783468,116.8,17.4,74,1224.64832984061,-1.53183615751272
16517,519489.383,5337478.323,86,65,21,18.313,0,2002,1,132,289,185,0.873723954591899,52.7,17.567032967033,53,1224.64832984061,-1.53183615751272
16517,519489.383,5337478.323,168,52,116,23.326,0,2003,3,126,314,201,0.842682922867698,-198,22.3252747252747,75,1224.64832984061,-1.53183615751272
16517,519489.383,5337478.323,161,93,68,11.934,0,2004,2,139,305,209,0.862099157350417,209.7,17.0835164835165,70,1224.64832984061,-1.53183615751272
16517,519489.383,5337478.323,166,93,73,26.07,0,2005,2,128,302,185,0.872680562207118,44.2,17.3054945054945,57,1224.64832984061,-1.53183615751272
16517,519489.383,5337478.323,190,111,79,11.047,1,2006,1,143,314,193,0.842760672048074,92.3,18.2626373626374,50,1224.64832984061,-1.53183615751272
16517,519489.383,5337478.323,0,0,0,87.194,0,2007,0,59,283,201,0.842789025103276,332.6,16.5076923076923,142,1224.64832984061,-1.53183615751272
16517,519489.383,5337478.323,125,56,69,12.778,0,2008,3,135,292,186,0.881485152585745,50.1,16.9747252747253,51,1224.64832984061,-1.53183615751272
16517,519489.383,5337478.323,180,57,123,38.617,0,2009,3,106,294,241,0.834385115282744,55,17.8153846153846,135,1224.64832984061,-1.53183615751272
16517,519489.383,5337478.323,168,98,70,14.002,0,2010,2,136,288,193,0.863515816557809,133.1,17.7351648351648,57,1224.64832984061,-1.53183615751272
16517,519489.383,5337478.323,133,118,15,25.242,0,2011,1,110,304,170,0.852858221907215,136.1,17.0351648351648,60,1224.64832984061,-1.53183615751272
16517,519489.383,5337478.323,158,93,65,25.322,0,2012,2,127,303,184,0.870472271696162,88.9,18.4296703296703,57,1224.64832984061,-1.53183615751272
16517,519489.383,5337478.323,181,99,82,23.774,1,2013,2,131,290,217,0.857687179806829,-156.9,18.6175824175824,86,1224.64832984061,-1.53183615751272
16517,519489.383,5337478.323,161,50,111,21.382,0,2014,2,128,318,178,0.827418244852489,191.6,17.4516483516484,50,1224.64832984061,-1.53183615751272
16517,519489.383,5337478.323,162,93,69,38.112,0,2015,2,111,312,186,0.872689056343648,-154.6,20.4153846153846,75,1224.64832984061,-1.53183615751272
16517,519489.383,5337478.323,183,93,90,21.442,0,2016,2,133,317,185,0.888736961178621,50.9,18.5681318681319,52,1224.64832984061,-1.53183615751272
16517,519489.383,5337478.323,147,95,52,22.582,0,2017,2,127,299,184,0.856665076285374,-2.3,19.1582417582418,57,1224.64832984061,-1.53183615751272
16517,519489.383,5337478.323,177,83,94,34.205,0,2018,2,111,312,161,0.893950985062806,-151.3,19.9417582417582,50,1224.64832984061,-1.53183615751272
16517,519489.383,5337478.323,173,93,80,11.183,0,2019,2,140,301,200,0.839406683841624,-73.4,20.0571428571429,60,1224.64832984061,-1.53183615751272
16517,519489.383,5337478.323,0,0,0,16.584,0,2020,0,128,295,193,0.830207098992416,-13.6,18.3758241758242,65,1224.64832984061,-1.53183615751272
16518,519489.383,5337246.666,86,82,4,15.81,0,2001,2,136,292,200,0.856316716395954,116.8,17.4,64,1267.52245950491,1.5197580626775
16518,519489.383,5337246.666,86,65,21,17.347,0,2002,1,133,296,185,0.874218114632889,52.7,17.567032967033,52,1267.52245950491,1.5197580626775
16518,519489.383,5337246.666,175,99,76,21.63,0,2003,1,128,312,177,0.851871469895959,-198,22.3252747252747,49,1267.52245950491,1.5197580626775
16518,519489.383,5337246.666,169,99,70,11.049,0,2004,2,140,314,217,0.893189069825286,209.7,17.0835164835165,77,1267.52245950491,1.5197580626775
16518,519489.383,5337246.666,164,102,62,26.07,0,2005,1,128,303,184,0.864176846996094,44.2,17.3054945054945,56,1267.52245950491,1.5197580626775
16518,519489.383,5337246.666,201,55,146,13.128,1,2006,2,141,321,201,0.81979376055896,92.3,18.2626373626374,60,1267.52245950491,1.5197580626775
16518,519489.383,5337246.666,86,84,2,35.753,0,2007,1,109,281,192,0.842411951484316,332.6,16.5076923076923,83,1267.52245950491,1.5197580626775
16518,519489.383,5337246.666,171,52,119,24.594,0,2008,2,121,298,184,0.850191241351094,50.1,16.9747252747253,63,1267.52245950491,1.5197580626775
16518,519489.383,5337246.666,187,61,126,28.202,0,2009,2,117,290,177,0.877779421104787,55,17.8153846153846,60,1267.52245950491,1.5197580626775
16518,519489.383,5337246.666,181,70,111,17.622,0,2010,2,132,284,178,0.835266313583442,133.1,17.7351648351648,46,1267.52245950491,1.5197580626775
16518,519489.383,5337246.666,143,100,43,26.677,0,2011,1,108,310,168,0.819794169980539,136.1,17.0351648351648,60,1267.52245950491,1.5197580626775
16518,519489.383,5337246.666,162,80,82,21.301,0,2012,3,131,296,184,0.881517552695974,88.9,18.4296703296703,53,1267.52245950491,1.5197580626775
16518,519489.383,5337246.666,188,70,118,22.774,1,2013,3,132,292,202,0.838383252989253,-156.9,18.6175824175824,70,1267.52245950491,1.5197580626775
16518,519489.383,5337246.666,163,50,113,10.896,0,2014,3,140,314,186,0.826056697560235,191.6,17.4516483516484,46,1267.52245950491,1.5197580626775
16518,519489.383,5337246.666,168,116,52,33.252,0,2015,1,117,304,184,0.867772612567304,-154.6,20.4153846153846,67,1267.52245950491,1.5197580626775
16518,519489.383,5337246.666,181,93,88,17.425,0,2016,2,137,321,192,0.867078373384582,50.9,18.5681318681319,55,1267.52245950491,1.5197580626775
16518,519489.383,5337246.666,159,117,42,22.582,0,2017,1,127,296,177,0.84721224227161,-2.3,19.1582417582418,50,1267.52245950491,1.5197580626775
16518,519489.383,5337246.666,172,56,116,30.829,0,2018,2,115,326,178,0.855121452266357,-151.3,19.9417582417582,63,1267.52245950491,1.5197580626775
16518,519489.383,5337246.666,171,100,71,12.101,0,2019,1,139,303,185,0.823565060311209,-73.4,20.0571428571429,46,1267.52245950491,1.5197580626775
16518,519489.383,5337246.666,0,0,0,14.77,0,2020,0,131,301,200,0.81207837018082,-13.6,18.3758241758242,69,1267.52245950491,1.5197580626775
16519,519489.383,5337015.01,86,82,4,21.264,0,2001,3,130,296,208,0.813609491798642,116.8,17.4,78,1275.98037540544,-1.33046814114625
16519,519489.383,5337015.01,86,66,20,19.282,0,2002,1,131,300,185,0.876525863423392,52.7,17.567032967033,54,1275.98037540544,-1.33046814114625
16519,519489.383,5337015.01,170,93,77,29.642,0,2003,1,119,312,169,0.845832164461439,-198,22.3252747252747,50,1275.98037540544,-1.33046814114625
16519,519489.383,5337015.01,165,99,66,18.923,0,2004,2,132,319,217,0.897463616016201,209.7,17.0835164835165,85,1275.98037540544,-1.33046814114625
16519,519489.383,5337015.01,163,102,61,28.191,0,2005,1,126,301,177,0.850824522709589,44.2,17.3054945054945,51,1275.98037540544,-1.33046814114625
16519,519489.383,5337015.01,199,54,145,23.03,1,2006,3,131,323,193,0.819552004224766,92.3,18.2626373626374,62,1275.98037540544,-1.33046814114625
16519,519489.383,5337015.01,93,83,10,42.949,0,2007,2,100,281,177,0.847857433480348,332.6,16.5076923076923,77,1275.98037540544,-1.33046814114625
16519,519489.383,5337015.01,170,54,116,27.724,0,2008,3,118,299,192,0.849234450907845,50.1,16.9747252747253,74,1275.98037540544,-1.33046814114625
16519,519489.383,5337015.01,180,64,116,41.687,0,2009,2,103,293,177,0.873507745212442,55,17.8153846153846,74,1275.98037540544,-1.33046814114625
16519,519489.383,5337015.01,184,71,113,18.484,0,2010,2,131,288,177,0.841754436241488,133.1,17.7351648351648,46,1275.98037540544,-1.33046814114625
16519,519489.383,5337015.01,141,94,47,28.941,0,2011,1,105,313,160,0.845852537626372,136.1,17.0351648351648,55,1275.98037540544,-1.33046814114625
16519,519489.383,5337015.01,161,80,81,24.307,0,2012,2,128,301,178,0.857739051677591,88.9,18.4296703296703,50,1275.98037540544,-1.33046814114625
16519,519489.383,5337015.01,184,69,115,23.774,1,2013,3,131,292,192,0.851300306363835,-156.9,18.6175824175824,61,1275.98037540544,-1.33046814114625
16519,519489.383,5337015.01,157,50,107,28.765,0,2014,3,118,316,185,0.831246719172269,191.6,17.4516483516484,67,1275.98037540544,-1.33046814114625
16519,519489.383,5337015.01,164,93,71,40.807,0,2015,2,108,315,184,0.867155104761071,-154.6,20.4153846153846,76,1275.98037540544,-1.33046814114625
16519,519489.383,5337015.01,182,93,89,16.42,0,2016,2,138,322,193,0.878090248621882,50.9,18.5681318681319,55,1275.98037540544,-1.33046814114625
16519,519489.383,5337015.01,155,94,61,24.229,0,2017,2,125,295,185,0.832864253123404,-2.3,19.1582417582418,60,1275.98037540544,-1.33046814114625
16519,519489.383,5337015.01,171,57,114,35.998,0,2018,2,109,318,177,0.865579826933485,-151.3,19.9417582417582,68,1275.98037540544,-1.33046814114625
16519,519489.383,5337015.01,175,93,82,13.943,0,2019,1,137,303,177,0.827463091256446,-73.4,20.0571428571429,40,1275.98037540544,-1.33046814114625
16519,519489.383,5337015.01,0,0,0,21.073,0,2020,0,121,305,201,0.800653699326599,-13.6,18.3758241758242,80,1275.98037540544,-1.33046814114625
16520,519489.383,5336783.354,86,83,3,23.243,0,2001,1,128,288,201,0.85869398827738,116.8,17.4,73,1279.04669864785,-1.25341534398187
16520,519489.383,5336783.354,85,48,37,20.235,0,2002,1,130,291,185,0.872637434146394,52.7,17.567032967033,55,1279.04669864785,-1.25341534398187
16520,519489.383,5336783.354,170,58,112,29.642,0,2003,2,119,297,170,0.844293042944884,-198,22.3252747252747,51,1279.04669864785,-1.25341534398187
16520,519489.383,5336783.354,154,96,58,18.923,0,2004,2,132,292,217,0.889149031680518,209.7,17.0835164835165,85,1279.04669864785,-1.25341534398187
16520,519489.383,5336783.354,167,95,72,29.22,0,2005,1,125,303,170,0.834014153210314,44.2,17.3054945054945,45,1279.04669864785,-1.25341534398187
16520,519489.383,5336783.354,193,57,136,32.448,1,2006,3,121,330,218,0.847144952358609,92.3,18.2626373626374,97,1279.04669864785,-1.25341534398187
16520,519489.383,5336783.354,0,0,0,41.204,0,2007,0,102,286,217,0.832149701231485,332.6,16.5076923076923,115,1279.04669864785,-1.25341534398187
16520,519489.383,5336783.354,86,54,32,14.895,0,2008,1,132,294,209,0.865975720699883,50.1,16.9747252747253,77,1279.04669864785,-1.25341534398187
16520,519489.383,5336783.354,174,63,111,37.626,0,2009,2,107,286,177,0.874401259373802,55,17.8153846153846,70,1279.04669864785,-1.25341534398187
16520,519489.383,5336783.354,168,64,104,20.929,0,2010,2,128,289,177,0.841405960611591,133.1,17.7351648351648,49,1279.04669864785,-1.25341534398187
16520,519489.383,5336783.354,139,117,22,28.173,0,2011,1,106,309,162,0.862425018462137,136.1,17.0351648351648,56,1279.04669864785,-1.25341534398187
16520,519489.383,5336783.354,162,80,82,24.307,0,2012,2,128,303,177,0.86292646895978,88.9,18.4296703296703,49,1279.04669864785,-1.25341534398187
16520,519489.383,5336783.354,176,93,83,17.728,1,2013,2,137,294,193,0.859475001958039,-156.9,18.6175824175824,56,1279.04669864785,-1.25341534398187
16520,519489.383,5336783.354,153,40,113,29.382,0,2014,3,117,313,184,0.858848193891079,191.6,17.4516483516484,67,1279.04669864785,-1.25341534398187
16520,519489.383,5336783.354,164,93,71,23.884,0,2015,1,126,306,176,0.858564290572513,-154.6,20.4153846153846,50,1279.04669864785,-1.25341534398187
16520,519489.383,5336783.354,188,135,53,12.401,0,2016,1,142,328,201,0.878337916007554,50.9,18.5681318681319,59,1279.04669864785,-1.25341534398187
16520,519489.383,5336783.354,153,94,59,25.048,0,2017,2,124,293,184,0.842312686746637,-2.3,19.1582417582418,60,1279.04669864785,-1.25341534398187
16520,519489.383,5336783.354,174,47,127,27.471,0,2018,2,119,301,170,0.879584948175921,-151.3,19.9417582417582,51,1279.04669864785,-1.25341534398187
16520,519489.383,5336783.354,165,79,86,16.853,0,2019,2,134,301,178,0.845640007972349,-73.4,20.0571428571429,44,1279.04669864785,-1.25341534398187
16520,519489.383,5336783.354,0,0,0,21.073,0,2020,0,121,309,209,0.816147516536785,-13.6,18.3758241758242,88,1279.04669864785,-1.25341534398187
16521,519489.383,5336551.697,86,84,2,28.345,0,2001,2,123,288,201,0.861183348288005,116.8,17.4,78,1266.04422645406,1.53241322642662
16521,519489.383,5336551.697,93,50,43,25.202,0,2002,3,125,289,185,0.8669481511828,52.7,17.567032967033,60,1266.04422645406,1.53241322642662
16521,519489.383,5336551.697,170,57,113,30.46,0,2003,2,118,315,170,0.847099108101676,-198,22.3252747252747,52,1266.04422645406,1.53241322642662
16521,519489.383,5336551.697,158,100,58,28.193,0,2004,2,122,316,201,0.821848893040358,209.7,17.0835164835165,79,1266.04422645406,1.53241322642662
16521,519489.383,5336551.697,163,93,70,31.202,0,2005,2,123,303,184,0.877931508039843,44.2,17.3054945054945,61,1266.04422645406,1.53241322642662
16521,519489.383,5336551.697,193,57,136,35.519,2,2006,3,118,335,218,0.856923417813995,92.3,18.2626373626374,100,1266.04422645406,1.53241322642662
16521,519489.383,5336551.697,93,93,0,55.051,2,2007,2,88,287,210,0.831118098374134,332.6,16.5076923076923,122,1266.04422645406,1.53241322642662
16521,519489.383,5336551.697,86,54,32,20.699,0,2008,1,125,299,178,0.85967995090664,50.1,16.9747252747253,53,1266.04422645406,1.53241322642662
16521,519489.383,5336551.697,181,64,117,24.036,0,2009,2,122,287,177,0.87457775329098,55,17.8153846153846,55,1266.04422645406,1.53241322642662
16521,519489.383,5336551.697,168,65,103,19.346,0,2010,2,130,294,176,0.819588630192629,133.1,17.7351648351648,46,1266.04422645406,1.53241322642662
16521,519489.383,5336551.697,139,117,22,28.173,0,2011,1,106,313,161,0.85904683313997,136.1,17.0351648351648,55,1266.04422645406,1.53241322642662
16521,519489.383,5336551.697,162,80,82,29.388,0,2012,2,123,307,176,0.860625603418498,88.9,18.4296703296703,53,1266.04422645406,1.53241322642662
16521,519489.383,5336551.697,174,93,81,22.774,1,2013,2,132,278,194,0.849606910833577,-156.9,18.6175824175824,62,1266.04422645406,1.53241322642662
16521,519489.383,5336551.697,151,39,112,35.525,1,2014,2,107,315,184,0.848277498323323,191.6,17.4516483516484,77,1266.04422645406,1.53241322642662
16521,519489.383,5336551.697,163,93,70,28.702,0,2015,1,122,311,177,0.870794389271715,-154.6,20.4153846153846,55,1266.04422645406,1.53241322642662
16521,519489.383,5336551.697,187,143,44,18.414,0,2016,1,136,331,208,0.867789734134337,50.9,18.5681318681319,72,1266.04422645406,1.53241322642662
16521,519489.383,5336551.697,153,94,59,28.227,0,2017,1,120,292,177,0.840237871572351,-2.3,19.1582417582418,57,1266.04422645406,1.53241322642662
16521,519489.383,5336551.697,167,47,120,36.94,0,2018,2,108,307,170,0.860394870983956,-151.3,19.9417582417582,62,1266.04422645406,1.53241322642662
16521,519489.383,5336551.697,167,79,88,20.006,0,2019,3,131,301,193,0.818462997622511,-73.4,20.0571428571429,62,1266.04422645406,1.53241322642662
16521,519489.383,5336551.697,0,0,0,22.704,0,2020,0,118,311,200,0.807060902943656,-13.6,18.3758241758242,82,1266.04422645406,1.53241322642662
16522,519489.383,5336320.041,0,0,0,30.444,0,2001,2,121,303,201,0.860249947538074,116.8,17.4,80,1246.73913021336,-0.139285247117928
16522,519489.383,5336320.041,161,78,83,23.157,0,2002,3,127,289,185,0.88110747497587,52.7,17.567032967033,58,1246.73913021336,-0.139285247117928
16522,519489.383,5336320.041,161,57,104,32.92,0,2003,2,115,317,161,0.828398181899987,-198,22.3252747252747,46,1246.73913021336,-0.139285247117928
16522,519489.383,5336320.041,166,93,73,17.848,0,2004,2,133,329,217,0.849253131486601,209.7,17.0835164835165,84,1246.73913021336,-0.139285247117928
16522,519489.383,5336320.041,0,0,0,30.232,0,2005,0,124,309,184,0.878636066462079,44.2,17.3054945054945,60,1246.73913021336,-0.139285247117928
16522,519489.383,5336320.041,188,69,119,15.23,1,2006,2,139,332,177,0.822110401292645,92.3,18.2626373626374,38,1246.73913021336,-0.139285247117928
16522,519489.383,5336320.041,116,93,23,35.048,0,2007,2,110,305,186,0.845215089526534,332.6,16.5076923076923,76,1246.73913021336,-0.139285247117928
16522,519489.383,5336320.041,86,64,22,23.59,0,2008,1,122,298,177,0.876307691604039,50.1,16.9747252747253,55,1246.73913021336,-0.139285247117928
16522,519489.383,5336320.041,178,60,118,26.517,0,2009,2,119,299,177,0.881417336644172,55,17.8153846153846,58,1246.73913021336,-0.139285247117928
16522,519489.383,5336320.041,166,76,90,18.484,0,2010,3,131,291,185,0.861744326625172,133.1,17.7351648351648,54,1246.73913021336,-0.139285247117928
16522,519489.383,5336320.041,134,95,39,27.418,0,2011,1,107,307,162,0.873509399353421,136.1,17.0351648351648,55,1246.73913021336,-0.139285247117928
16522,519489.383,5336320.041,154,79,75,27.325,0,2012,2,125,296,177,0.869188037398414,88.9,18.4296703296703,52,1246.73913021336,-0.139285247117928
16522,519489.383,5336320.041,181,93,88,18.745,1,2013,2,136,278,194,0.862712711886425,-156.9,18.6175824175824,58,1246.73913021336,-0.139285247117928
16522,519489.383,5336320.041,154,60,94,33.028,0,2014,3,111,315,216,0.86867047804487,191.6,17.4516483516484,105,1246.73913021336,-0.139285247117928
16522,519489.383,5336320.041,163,93,70,28.702,0,2015,1,122,316,176,0.899148365389457,-154.6,20.4153846153846,54,1246.73913021336,-0.139285247117928
16522,519489.383,5336320.041,162,93,69,18.414,0,2016,2,136,337,208,0.881808132424008,50.9,18.5681318681319,72,1246.73913021336,-0.139285247117928
16522,519489.383,5336320.041,156,108,48,25.846,0,2017,1,123,291,178,0.856995371877439,-2.3,19.1582417582418,55,1246.73913021336,-0.139285247117928
16522,519489.383,5336320.041,170,64,106,28.296,0,2018,2,118,313,177,0.870979692045827,-151.3,19.9417582417582,59,1246.73913021336,-0.139285247117928
16522,519489.383,5336320.041,172,93,79,20.006,0,2019,2,131,307,185,0.857005978023067,-73.4,20.0571428571429,54,1246.73913021336,-0.139285247117928
16522,519489.383,5336320.041,94,93,1,24.299,1,2020,2,115,306,225,0.818431871800478,-13.6,18.3758241758242,110,1246.73913021336,-0.139285247117928
16523,519489.383,5336088.384,0,0,0,36.992,0,2001,2,115,303,202,0.869899082357817,116.8,17.4,87,1238.78501804389,-0.396037560500971
16523,519489.383,5336088.384,161,79,82,23.157,0,2002,2,127,290,184,0.885270606495898,52.7,17.567032967033,57,1238.78501804389,-0.396037560500971
16523,519489.383,5336088.384,161,57,104,30.46,0,2003,2,118,317,170,0.846167154956711,-198,22.3252747252747,52,1238.78501804389,-0.396037560500971
16523,519489.383,5336088.384,165,93,72,20.014,0,2004,2,131,329,224,0.851289151495304,209.7,17.0835164835165,93,1238.78501804389,-0.396037560500971
16523,519489.383,5336088.384,0,0,0,29.22,0,2005,0,125,306,178,0.873062787575673,44.2,17.3054945054945,53,1238.78501804389,-0.396037560500971
16523,519489.383,5336088.384,188,69,119,16.262,1,2006,2,138,329,177,0.824132107366265,92.3,18.2626373626374,39,1238.78501804389,-0.396037560500971
16523,519489.383,5336088.384,117,93,24,51.795,1,2007,2,91,304,208,0.845192724501463,332.6,16.5076923076923,117,1238.78501804389,-0.396037560500971
16523,519489.383,5336088.384,86,64,22,25.618,0,2008,1,120,296,177,0.886509619206095,50.1,16.9747252747253,57,1238.78501804389,-0.396037560500971
16523,519489.383,5336088.384,173,58,115,41.687,0,2009,2,103,300,170,0.875558439380787,55,17.8153846153846,67,1238.78501804389,-0.396037560500971
16523,519489.383,5336088.384,167,76,91,18.484,0,2010,3,131,288,185,0.865677557977617,133.1,17.7351648351648,54,1238.78501804389,-0.396037560500971
16523,519489.383,5336088.384,134,95,39,27.418,0,2011,1,107,310,162,0.880949479629564,136.1,17.0351648351648,55,1238.78501804389,-0.396037560500971
16523,519489.383,5336088.384,154,81,73,27.325,0,2012,2,125,297,178,0.86670165017887,88.9,18.4296703296703,53,1238.78501804389,-0.396037560500971
16523,519489.383,5336088.384,180,93,87,21.747,1,2013,2,133,279,194,0.869866532116938,-156.9,18.6175824175824,61,1238.78501804389,-0.396037560500971
16523,519489.383,5336088.384,152,57,95,33.646,0,2014,3,110,314,210,0.865806190833026,191.6,17.4516483516484,100,1238.78501804389,-0.396037560500971
16523,519489.383,5336088.384,161,93,68,34.04,0,2015,2,116,315,194,0.842216369968511,-154.6,20.4153846153846,78,1238.78501804389,-0.396037560500971
16523,519489.383,5336088.384,159,93,66,24.254,0,2016,2,130,335,202,0.877072268465342,50.9,18.5681318681319,72,1238.78501804389,-0.396037560500971
16523,519489.383,5336088.384,154,94,60,26.643,0,2017,1,122,290,177,0.863570719524992,-2.3,19.1582417582418,55,1238.78501804389,-0.396037560500971
16523,519489.383,5336088.384,172,64,108,30.829,0,2018,2,115,314,170,0.875334962415732,-151.3,19.9417582417582,55,1238.78501804389,-0.396037560500971
16523,519489.383,5336088.384,172,93,79,20.006,0,2019,2,131,293,185,0.851702579265323,-73.4,20.0571428571429,54,1238.78501804389,-0.396037560500971
16523,519489.383,5336088.384,93,93,0,26.608,1,2020,2,111,306,226,0.823719005055294,-13.6,18.3758241758242,115,1238.78501804389,-0.396037560500971
16524,519489.383,5335856.728,86,84,2,32.639,0,2001,2,119,278,193,0.869309172690965,116.8,17.4,74,1227.16372327847,0.965957231610722
16524,519489.383,5335856.728,147,52,95,26.209,0,2002,3,124,291,232,0.892619627776057,52.7,17.567032967033,108,1227.16372327847,0.965957231610722
16524,519489.383,5335856.728,165,58,107,31.289,0,2003,2,117,301,161,0.829067435574933,-198,22.3252747252747,44,1227.16372327847,0.965957231610722
16524,519489.383,5335856.728,166,95,71,23.915,0,2004,2,127,319,193,0.862281041531125,209.7,17.0835164835165,66,1227.16372327847,0.965957231610722
16524,519489.383,5335856.728,152,112,40,32.157,0,2005,1,122,310,177,0.870239683448527,44.2,17.3054945054945,55,1227.16372327847,0.965957231610722
16524,519489.383,5335856.728,184,66,118,26.035,1,2006,3,128,328,193,0.824165216208887,92.3,18.2626373626374,65,1227.16372327847,0.965957231610722
16524,519489.383,5335856.728,120,93,27,42.949,0,2007,2,100,293,210,0.839080475097937,332.6,16.5076923076923,110,1227.16372327847,0.965957231610722
16524,519489.383,5335856.728,171,59,112,40.366,2,2008,2,107,297,177,0.888915264263601,50.1,16.9747252747253,70,1227.16372327847,0.965957231610722
16524,519489.383,5335856.728,172,59,113,45.038,0,2009,2,100,300,153,0.85423786573449,55,17.8153846153846,53,1227.16372327847,0.965957231610722
16524,519489.383,5335856.728,174,74,100,21.716,0,2010,2,127,292,177,0.856956601819437,133.1,17.7351648351648,50,1227.16372327847,0.965957231610722
16524,519489.383,5335856.728,150,97,53,29.721,0,2011,1,104,309,161,0.880876906793579,136.1,17.0351648351648,57,1227.16372327847,0.965957231610722
16524,519489.383,5335856.728,165,93,72,27.325,0,2012,1,125,306,170,0.843706390889845,88.9,18.4296703296703,45,1227.16372327847,0.965957231610722
16524,519489.383,5335856.728,181,81,100,21.747,1,2013,2,133,278,194,0.86708860424228,-156.9,18.6175824175824,61,1227.16372327847,0.965957231610722
16524,519489.383,5335856.728,156,37,119,29.981,0,2014,2,116,317,177,0.850369468650123,191.6,17.4516483516484,61,1227.16372327847,0.965957231610722
16524,519489.383,5335856.728,173,78,95,33.252,0,2015,2,117,316,169,0.852969209763692,-154.6,20.4153846153846,52,1227.16372327847,0.965957231610722
16524,519489.383,5335856.728,169,93,76,26.194,0,2016,2,128,330,192,0.860182468310562,50.9,18.5681318681319,64,1227.16372327847,0.965957231610722
16524,519489.383,5335856.728,141,94,47,28.227,0,2017,1,120,288,177,0.851204872551855,-2.3,19.1582417582418,57,1227.16372327847,0.965957231610722
16524,519489.383,5335856.728,172,50,122,30.829,0,2018,2,115,308,177,0.859151618596396,-151.3,19.9417582417582,62,1227.16372327847,0.965957231610722
16524,519489.383,5335856.728,167,79,88,23.027,0,2019,2,128,307,177,0.839109993619366,-73.4,20.0571428571429,49,1227.16372327847,0.965957231610722
16524,519489.383,5335856.728,0,0,0,28.469,0,2020,0,108,305,218,0.818205317223525,-13.6,18.3758241758242,110,1227.16372327847,0.965957231610722
16525,519489.383,5335625.072,86,84,2,36.992,0,2001,2,115,292,186,0.863256131206335,116.8,17.4,71,1212.63940643897,-0.689143607997561
16525,519489.383,5335625.072,144,75,69,28.961,0,2002,2,121,291,178,0.842161741976534,52.7,17.567032967033,57,1212.63940643897,-0.689143607997561
16525,519489.383,5335625.072,165,57,108,32.108,0,2003,2,116,319,154,0.814140822642757,-198,22.3252747252747,38,1212.63940643897,-0.689143607997561
16525,519489.383,5335625.072,166,93,73,23.018,0,2004,2,128,326,193,0.858491795564918,209.7,17.0835164835165,65,1212.63940643897,-0.689143607997561
16525,519489.383,5335625.072,145,125,20,36.316,0,2005,1,118,310,177,0.863282680774227,44.2,17.3054945054945,59,1212.63940643897,-0.689143607997561
16525,519489.383,5335625.072,183,66,117,28.664,1,2006,3,125,327,186,0.818405296816531,92.3,18.2626373626374,61,1212.63940643897,-0.689143607997561
16525,519489.383,5335625.072,120,93,27,43.851,0,2007,2,99,291,200,0.83330495852881,332.6,16.5076923076923,101,1212.63940643897,-0.689143607997561
16525,519489.383,5335625.072,176,58,118,21.639,0,2008,2,124,295,170,0.857888324458448,50.1,16.9747252747253,46,1212.63940643897,-0.689143607997561
16525,519489.383,5335625.072,182,59,123,26.517,0,2009,3,119,299,169,0.860497226324933,55,17.8153846153846,50,1212.63940643897,-0.689143607997561
16525,519489.383,5335625.072,174,74,100,18.484,0,2010,2,131,295,177,0.844640369977693,133.1,17.7351648351648,46,1212.63940643897,-0.689143607997561
16525,519489.383,5335625.072,150,97,53,29.721,0,2011,1,104,312,161,0.842709403191653,136.1,17.0351648351648,57,1212.63940643897,-0.689143607997561
16525,519489.383,5335625.072,165,93,72,32.403,0,2012,1,120,308,169,0.851885270302922,88.9,18.4296703296703,49,1212.63940643897,-0.689143607997561
16525,519489.383,5335625.072,179,83,96,21.747,1,2013,3,133,287,185,0.839337496475194,-156.9,18.6175824175824,52,1212.63940643897,-0.689143607997561
16525,519489.383,5335625.072,155,40,115,33.646,0,2014,2,110,318,176,0.848893498094516,191.6,17.4516483516484,66,1212.63940643897,-0.689143607997561
16525,519489.383,5335625.072,167,78,89,37.257,0,2015,2,112,325,177,0.855783865339554,-154.6,20.4153846153846,65,1212.63940643897,-0.689143607997561
16525,519489.383,5335625.072,172,94,78,31.607,0,2016,2,123,330,201,0.851481984333528,50.9,18.5681318681319,78,1212.63940643897,-0.689143607997561
16525,519489.383,5335625.072,138,94,44,26.643,0,2017,2,122,293,210,0.851677776939974,-2.3,19.1582417582418,88,1212.63940643897,-0.689143607997561
16525,519489.383,5335625.072,169,54,115,29.987,0,2018,2,116,298,178,0.854427013058112,-151.3,19.9417582417582,62,1212.63940643897,-0.689143607997561
16525,519489.383,5335625.072,171,78,93,23.928,1,2019,3,127,311,178,0.83875238404513,-73.4,20.0571428571429,51,1212.63940643897,-0.689143607997561
16525,519489.383,5335625.072,0,0,0,26.608,0,2020,0,111,301,210,0.823976476749095,-13.6,18.3758241758242,99,1212.63940643897,-0.689143607997561
16526,519489.383,5335393.415,0,0,0,36.992,0,2001,2,115,297,186,0.886189969494212,116.8,17.4,71,1161.43722823556,-1.42099650374349
16526,519489.383,5335393.415,86,51,35,31.477,0,2002,1,118,293,217,0.851308888995325,52.7,17.567032967033,99,1161.43722823556,-1.42099650374349
16526,519489.383,5335393.415,156,60,96,34.588,0,2003,2,113,321,160,0.836808271754747,-198,22.3252747252747,47,1161.43722823556,-1.42099650374349
16526,519489.383,5335393.415,153,93,60,35.22,0,2004,2,114,329,232,0.916003130233338,209.7,17.0835164835165,118,1161.43722823556,-1.42099650374349
16526,519489.383,5335393.415,97,94,3,40.72,0,2005,2,114,311,184,0.87830384358851,44.2,17.3054945054945,70,1161.43722823556,-1.42099650374349
16526,519489.383,5335393.415,192,70,122,24.051,1,2006,2,130,334,176,0.830961709779432,92.3,18.2626373626374,46,1161.43722823556,-1.42099650374349
16526,519489.383,5335393.415,118,93,25,43.851,0,2007,2,99,291,225,0.8631630407417,332.6,16.5076923076923,126,1161.43722823556,-1.42099650374349
16526,519489.383,5335393.415,86,62,24,63.001,8,2008,1,87,296,177,0.884987243242912,50.1,16.9747252747253,90,1161.43722823556,-1.42099650374349
16526,519489.383,5335393.415,173,61,112,42.763,0,2009,2,102,308,177,0.926158383360119,55,17.8153846153846,75,1161.43722823556,-1.42099650374349
16526,519489.383,5335393.415,168,74,94,26.07,0,2010,2,121,303,176,0.857917812928751,133.1,17.7351648351648,55,1161.43722823556,-1.42099650374349
16526,519489.383,5335393.415,147,102,45,32.093,1,2011,2,101,313,202,0.856926983663626,136.1,17.0351648351648,101,1161.43722823556,-1.42099650374349
16526,519489.383,5335393.415,152,80,72,40.938,0,2012,3,112,307,233,0.866767364037493,88.9,18.4296703296703,121,1161.43722823556,-1.42099650374349
16526,519489.383,5335393.415,185,93,92,25.798,1,2013,2,129,297,200,0.857029823414966,-156.9,18.6175824175824,71,1161.43722823556,-1.42099650374349
16526,519489.383,5335393.415,99,53,46,34.27,1,2014,3,109,330,184,0.864088627391979,191.6,17.4516483516484,75,1161.43722823556,-1.42099650374349
16526,519489.383,5335393.415,160,93,67,38.112,0,2015,1,111,329,177,0.866614084459756,-154.6,20.4153846153846,66,1161.43722823556,-1.42099650374349
16526,519489.383,5335393.415,170,95,75,27.214,0,2016,2,127,325,186,0.863767557092159,50.9,18.5681318681319,59,1161.43722823556,-1.42099650374349
16526,519489.383,5335393.415,140,94,46,28.227,0,2017,2,120,289,225,0.907341500454531,-2.3,19.1582417582418,105,1161.43722823556,-1.42099650374349
16526,519489.383,5335393.415,154,47,107,41.999,0,2018,2,103,299,178,0.871220749945733,-151.3,19.9417582417582,75,1161.43722823556,-1.42099650374349
16526,519489.383,5335393.415,155,93,62,26.669,4,2019,2,124,328,200,0.852544128142915,-73.4,20.0571428571429,76,1161.43722823556,-1.42099650374349
16526,519489.383,5335393.415,0,0,0,108.928,0,2020,0,32,308,232,0.821565623057761,-13.6,18.3758241758242,200,1161.43722823556,-1.42099650374349
16728,519721.04,5339331.573,0,0,0,38.09,0,2001,0,114,296,186,0.844836738921275,116.8,17.4,72,1215.02739282984,-1.45270145722094
16728,519721.04,5339331.573,86,67,19,29.793,0,2002,1,120,296,233,0.849249071135414,52.7,17.567032967033,113,1215.02739282984,-1.45270145722094
16728,519721.04,5339331.573,168,86,82,36.254,0,2003,2,111,299,161,0.826013943746781,-198,22.3252747252747,50,1215.02739282984,-1.45270145722094
16728,519721.04,5339331.573,165,61,104,29.039,0,2004,3,121,318,233,0.807032106363946,209.7,17.0835164835165,112,1215.02739282984,-1.45270145722094
16728,519721.04,5339331.573,160,97,63,37.43,0,2005,1,117,312,178,0.844777518391212,44.2,17.3054945054945,61,1215.02739282984,-1.45270145722094
16728,519721.04,5339331.573,191,70,121,26.901,1,2006,2,127,323,170,0.836110197562662,92.3,18.2626373626374,43,1215.02739282984,-1.45270145722094
16728,519721.04,5339331.573,146,93,53,42.949,0,2007,2,100,297,208,0.84440718888356,332.6,16.5076923076923,108,1215.02739282984,-1.45270145722094
16728,519721.04,5339331.573,187,48,139,18.901,0,2008,2,127,300,201,0.854023557964926,50.1,16.9747252747253,74,1215.02739282984,-1.45270145722094
16728,519721.04,5339331.573,165,65,100,48.876,0,2009,2,97,286,178,0.866831883501213,55,17.8153846153846,81,1215.02739282984,-1.45270145722094
16728,519721.04,5339331.573,173,84,89,20.929,0,2010,3,128,294,226,0.830749123819024,133.1,17.7351648351648,98,1215.02739282984,-1.45270145722094
16728,519721.04,5339331.573,129,113,16,33.726,1,2011,2,99,315,233,0.814162679914472,136.1,17.0351648351648,134,1215.02739282984,-1.45270145722094
16728,519721.04,5339331.573,175,110,65,25.322,0,2012,1,127,302,184,0.893083610418373,88.9,18.4296703296703,57,1215.02739282984,-1.45270145722094
16728,519721.04,5339331.573,178,47,131,23.774,1,2013,3,131,304,186,0.847424615057363,-156.9,18.6175824175824,55,1215.02739282984,-1.45270145722094
16728,519721.04,5339331.573,155,56,99,35.525,1,2014,2,107,323,168,0.827369232126616,191.6,17.4516483516484,61,1215.02739282984,-1.45270145722094
16728,519721.04,5339331.573,172,85,87,38.991,0,2015,2,110,327,162,0.824792945992725,-154.6,20.4153846153846,52,1215.02739282984,-1.45270145722094
16728,519721.04,5339331.573,177,140,37,22.382,0,2016,1,132,329,192,0.862251731439902,50.9,18.5681318681319,60,1215.02739282984,-1.45270145722094
16728,519721.04,5339331.573,151,93,58,35.818,5,2017,1,110,298,169,0.839380748447416,-2.3,19.1582417582418,59,1215.02739282984,-1.45270145722094
16728,519721.04,5339331.573,166,50,116,40.956,0,2018,2,104,299,162,0.85528969741258,-151.3,19.9417582417582,58,1215.02739282984,-1.45270145722094
16728,519721.04,5339331.573,150,79,71,30.238,4,2019,2,120,317,169,0.797809801316275,-73.4,20.0571428571429,49,1215.02739282984,-1.45270145722094
16728,519721.04,5339331.573,0,0,0,28.469,0,2020,0,108,309,177,0.786081473910522,-13.6,18.3758241758242,69,1215.02739282984,-1.45270145722094
16745,519721.04,5335393.415,86,86,0,40.345,2,2001,2,112,296,186,0.840076039855251,116.8,17.4,74,1206.97968256947,-1.3072578477613
16745,519721.04,5335393.415,93,50,43,34.788,0,2002,3,114,291,209,0.834075420007086,52.7,17.567032967033,95,1206.97968256947,-1.3072578477613
16745,519721.04,5335393.415,156,58,98,34.588,0,2003,2,113,320,154,0.827751919973411,-198,22.3252747252747,41,1206.97968256947,-1.3072578477613
16745,519721.04,5335393.415,154,99,55,40.944,0,2004,2,108,328,225,0.842080689733125,209.7,17.0835164835165,117,1206.97968256947,-1.3072578477613
16745,519721.04,5335393.415,116,96,20,37.43,0,2005,1,117,316,170,0.856630897773376,44.2,17.3054945054945,53,1206.97968256947,-1.3072578477613
16745,519721.04,5335393.415,183,71,112,31.467,1,2006,2,122,337,178,0.813025447099648,92.3,18.2626373626374,56,1206.97968256947,-1.3072578477613
16745,519721.04,5335393.415,118,93,25,47.653,0,2007,2,95,297,216,0.796208958715312,332.6,16.5076923076923,121,1206.97968256947,-1.3072578477613
16745,519721.04,5335393.415,172,62,110,48.668,3,2008,2,100,305,176,0.869651052770587,50.1,16.9747252747253,76,1206.97968256947,-1.3072578477613
16745,519721.04,5335393.415,181,64,117,27.362,0,2009,2,118,305,169,0.857876577278516,55,17.8153846153846,51,1206.97968256947,-1.3072578477613
16745,519721.04,5335393.415,169,74,95,25.349,0,2010,2,122,297,177,0.848692550207943,133.1,17.7351648351648,55,1206.97968256947,-1.3072578477613
16745,519721.04,5335393.415,152,93,59,32.093,1,2011,2,101,316,169,0.848076226876801,136.1,17.0351648351648,68,1206.97968256947,-1.3072578477613
16745,519721.04,5335393.415,156,80,76,38.92,0,2012,2,114,312,169,0.867934101370849,88.9,18.4296703296703,55,1206.97968256947,-1.3072578477613
16745,519721.04,5335393.415,181,93,88,24.788,1,2013,2,130,302,194,0.846813713359933,-156.9,18.6175824175824,64,1206.97968256947,-1.3072578477613
16745,519721.04,5335393.415,105,54,51,33.646,0,2014,2,110,328,178,0.833634944517041,191.6,17.4516483516484,68,1206.97968256947,-1.3072578477613
16745,519721.04,5335393.415,160,93,67,41.721,0,2015,1,107,331,169,0.836915780600903,-154.6,20.4153846153846,62,1206.97968256947,-1.3072578477613
16745,519721.04,5335393.415,171,105,66,26.194,0,2016,1,128,326,193,0.858440007612425,50.9,18.5681318681319,65,1206.97968256947,-1.3072578477613
16745,519721.04,5335393.415,138,94,44,32.826,3,2017,1,114,296,176,0.840437674790738,-2.3,19.1582417582418,62,1206.97968256947,-1.3072578477613
16745,519721.04,5335393.415,160,49,111,40.956,0,2018,2,104,297,176,0.845065898558654,-151.3,19.9417582417582,72,1206.97968256947,-1.3072578477613
16745,519721.04,5335393.415,156,93,63,23.928,1,2019,2,127,325,185,0.80257843641834,-73.4,20.0571428571429,58,1206.97968256947,-1.3072578477613
16745,519721.04,5335393.415,0,0,0,31.129,0,2020,0,104,310,178,0.810727681826449,-13.6,18.3758241758242,74,1206.97968256947,-1.3072578477613
16746,519721.04,5335161.759,0,0,0,53.14,0,2001,2,101,301,192,0.833728231376168,116.8,17.4,91,1177.6621111872,-1.2016121976356
16746,519721.04,5335161.759,93,51,42,37.314,0,2002,3,111,295,217,0.824899103096963,52.7,17.567032967033,106,1177.6621111872,-1.2016121976356
16746,519721.04,5335161.759,157,59,98,38.746,1,2003,2,108,315,153,0.817643775535786,-198,22.3252747252747,45,1177.6621111872,-1.2016121976356
16746,519721.04,5335161.759,162,93,69,33.378,0,2004,1,116,326,177,0.818052536182889,209.7,17.0835164835165,61,1177.6621111872,-1.2016121976356
16746,519721.04,5335161.759,116,96,20,50.488,0,2005,1,105,318,169,0.841608820851737,44.2,17.3054945054945,64,1177.6621111872,-1.2016121976356
16746,519721.04,5335161.759,181,71,110,49.986,2,2006,3,106,333,248,0.832978472651862,92.3,18.2626373626374,142,1177.6621111872,-1.2016121976356
16746,519721.04,5335161.759,119,94,25,52.881,2,2007,2,90,297,226,0.833426364813588,332.6,16.5076923076923,136,1177.6621111872,-1.2016121976356
16746,519721.04,5335161.759,175,59,116,33.576,0,2008,2,113,304,176,0.884409344529128,50.1,16.9747252747253,63,1177.6621111872,-1.2016121976356
16746,519721.04,5335161.759,182,61,121,29.053,0,2009,2,116,312,162,0.872441858011061,55,17.8153846153846,46,1177.6621111872,-1.2016121976356
16746,519721.04,5335161.759,168,74,94,29.782,0,2010,2,116,300,169,0.835357068020927,133.1,17.7351648351648,53,1177.6621111872,-1.2016121976356
16746,519721.04,5335161.759,150,80,70,39.022,1,2011,5,93,321,249,0.815800451329448,136.1,17.0351648351648,156,1177.6621111872,-1.2016121976356
16746,519721.04,5335161.759,158,81,77,47.977,1,2012,3,104,312,234,0.830690864686077,88.9,18.4296703296703,130,1177.6621111872,-1.2016121976356
16746,519721.04,5335161.759,176,94,82,43.453,1,2013,2,112,300,193,0.805448623869023,-156.9,18.6175824175824,81,1177.6621111872,-1.2016121976356
16746,519721.04,5335161.759,93,50,43,53.611,7,2014,2,83,330,177,0.837901379333376,191.6,17.4516483516484,94,1177.6621111872,-1.2016121976356
16746,519721.04,5335161.759,159,93,66,46.354,0,2015,1,102,334,161,0.836271428138709,-154.6,20.4153846153846,59,1177.6621111872,-1.2016121976356
16746,519721.04,5335161.759,167,104,63,50.412,7,2016,2,106,326,216,0.845558938520206,50.9,18.5681318681319,110,1177.6621111872,-1.2016121976356
16746,519721.04,5335161.759,139,93,46,43.24,7,2017,1,100,291,169,0.811297240924823,-2.3,19.1582417582418,69,1177.6621111872,-1.2016121976356
16746,519721.04,5335161.759,152,44,108,49.525,0,2018,2,96,301,177,0.827745196255909,-151.3,19.9417582417582,81,1177.6621111872,-1.2016121976356
16746,519721.04,5335161.759,152,93,59,37.086,4,2019,1,112,333,169,0.810875318727437,-73.4,20.0571428571429,57,1177.6621111872,-1.2016121976356
16746,519721.04,5335161.759,93,93,0,31.826,3,2020,1,103,312,169,0.814268722577793,-13.6,18.3758241758242,66,1177.6621111872,-1.2016121976356
16747,519721.04,5334930.103,0,0,0,46.16,0,2001,2,107,315,184,0.853023470843492,116.8,17.4,77,1141.49235057072,-1.48440690054631
16747,519721.04,5334930.103,110,73,37,35.619,0,2002,3,113,293,234,0.841751118128226,52.7,17.567032967033,121,1141.49235057072,-1.48440690054631
16747,519721.04,5334930.103,152,59,93,35.425,0,2003,2,112,306,161,0.829708220815462,-198,22.3252747252747,49,1141.49235057072,-1.48440690054631
16747,519721.04,5334930.103,151,100,51,28.193,0,2004,2,122,314,225,0.84405127251215,209.7,17.0835164835165,103,1141.49235057072,-1.48440690054631
16747,519721.04,5334930.103,160,114,46,47.305,0,2005,1,108,317,177,0.841613030421012,44.2,17.3054945054945,69,1141.49235057072,-1.48440690054631
16747,519721.04,5334930.103,170,75,95,45.889,2,2006,3,109,325,264,0.848827387391223,92.3,18.2626373626374,155,1141.49235057072,-1.48440690054631
16747,519721.04,5334930.103,159,93,66,55.051,2,2007,2,88,296,217,0.833904334607447,332.6,16.5076923076923,129,1141.49235057072,-1.48440690054631
16747,519721.04,5334930.103,0,0,0,23.59,0,2008,0,122,302,178,0.821721764162247,50.1,16.9747252747253,56,1141.49235057072,-1.48440690054631
16747,519721.04,5334930.103,170,63,107,41.687,0,2009,2,103,312,169,0.879531248954133,55,17.8153846153846,66,1141.49235057072,-1.48440690054631
16747,519721.04,5334930.103,142,101,41,26.07,0,2010,1,121,309,176,0.828114503525686,133.1,17.7351648351648,55,1141.49235057072,-1.48440690054631
16747,519721.04,5334930.103,120,106,14,38.143,1,2011,1,94,319,152,0.834890000381704,136.1,17.0351648351648,58,1141.49235057072,-1.48440690054631
16747,519721.04,5334930.103,147,93,54,44.549,1,2012,1,108,299,161,0.824146239076736,88.9,18.4296703296703,53,1141.49235057072,-1.48440690054631
16747,519721.04,5334930.103,143,48,95,24.788,1,2013,2,130,296,186,0.816721499679624,-156.9,18.6175824175824,56,1141.49235057072,-1.48440690054631
16747,519721.04,5334930.103,130,81,49,43.111,3,2014,2,96,323,154,0.828480226128552,191.6,17.4516483516484,58,1141.49235057072,-1.48440690054631
16747,519721.04,5334930.103,149,93,56,54.028,3,2015,2,95,331,186,0.830651376823582,-154.6,20.4153846153846,91,1141.49235057072,-1.48440690054631
16747,519721.04,5334930.103,163,118,45,50.412,7,2016,2,106,332,208,0.856146368809472,50.9,18.5681318681319,102,1141.49235057072,-1.48440690054631
16747,519721.04,5334930.103,116,94,22,37.348,7,2017,1,108,299,169,0.823298535781421,-2.3,19.1582417582418,61,1141.49235057072,-1.48440690054631
16747,519721.04,5334930.103,84,62,22,56.463,1,2018,1,90,321,193,0.804417875655705,-151.3,19.9417582417582,103,1141.49235057072,-1.48440690054631
16747,519721.04,5334930.103,137,94,43,37.924,4,2019,1,111,301,177,0.758615923966117,-73.4,20.0571428571429,66,1141.49235057072,-1.48440690054631
16747,519721.04,5334930.103,0,0,0,32.536,0,2020,0,102,306,176,0.807192046491803,-13.6,18.3758241758242,74,1141.49235057072,-1.48440690054631
16755,519721.04,5333076.852,0,0,0,145.075,0,2001,2,22,339,225,0.858854153115879,103.5,18.1120879120879,203,974.450567406521,1.41289856920849
16755,519721.04,5333076.852,0,0,0,60.286,0,2002,0,87,337,176,0.862914092962771,46.4,18.2428571428571,89,974.450567406521,1.41289856920849
16755,519721.04,5333076.852,93,93,0,72.68,14,2003,1,75,338,152,0.822096484604272,-203.8,22.9692307692308,77,974.450567406521,1.41289856920849
16755,519721.04,5333076.852,138,93,45,54.577,4,2004,1,97,333,169,0.852918470269169,196.1,17.7461538461538,72,974.450567406521,1.41289856920849
16755,519721.04,5333076.852,136,94,42,75.527,2,2005,1,84,316,160,0.857165640889746,38.9,17.9032967032967,76,974.450567406521,1.41289856920849
16755,519721.04,5333076.852,168,70,98,44.858,1,2006,2,111,346,161,0.841140118979105,82.6,18.867032967033,50,974.450567406521,1.41289856920849
16755,519721.04,5333076.852,0,0,0,100.537,0,2007,0,47,305,217,0.858044041385435,317.9,17.0824175824176,170,974.450567406521,1.41289856920849
16755,519721.04,5333076.852,0,0,0,49.887,0,2008,0,99,315,225,0.9032200224978,40.8,17.6131868131868,126,974.450567406521,1.41289856920849
16755,519721.04,5333076.852,170,68,102,44.207,0,2009,2,101,329,169,0.891200960724319,41,18.5230769230769,68,974.450567406521,1.41289856920849
16755,519721.04,5333076.852,118,93,25,52.841,4,2010,1,97,311,169,0.852832763125555,122,18.3626373626374,72,974.450567406521,1.41289856920849
16755,519721.04,5333076.852,0,0,0,85.343,0,2011,0,49,326,161,0.857626551543753,127.1,17.5,112,974.450567406521,1.41289856920849
16755,519721.04,5333076.852,139,93,46,52.898,3,2012,1,98,322,161,0.885399074290962,82.8,18.7043956043956,63,974.450567406521,1.41289856920849
16755,519721.04,5333076.852,93,93,0,49.458,0,2013,2,108,309,185,0.850638484054131,-163.1,19.2582417582418,77,974.450567406521,1.41289856920849
16755,519721.04,5333076.852,0,0,0,61.951,0,2014,0,74,321,161,0.851877820396203,176.9,17.856043956044,87,974.450567406521,1.41289856920849
16755,519721.04,5333076.852,0,0,0,66.258,0,2015,0,84,324,161,0.850810231061766,-158.6,20.9142857142857,77,974.450567406521,1.41289856920849
16755,519721.04,5333076.852,149,93,56,59.679,7,2016,2,97,341,194,0.882780300400532,45.5,18.8857142857143,97,974.450567406521,1.41289856920849
16755,519721.04,5333076.852,106,93,13,61.333,8,2017,1,81,309,170,0.851249126436394,-10.8,19.7879120879121,89,974.450567406521,1.41289856920849
16755,519721.04,5333076.852,86,79,7,58.646,2,2018,1,90,344,160,0.869802891396411,-154,20.578021978022,70,974.450567406521,1.41289856920849
16755,519721.04,5333076.852,118,93,25,49.532,8,2019,1,98,302,169,0.826878068016275,-79.8,20.6626373626374,71,974.450567406521,1.41289856920849
16755,519721.04,5333076.852,0,0,0,98.07,0,2020,0,41,320,177,0.835768429025145,-19.2,19.0648351648352,136,974.450567406521,1.41289856920849
16760,519721.04,5331918.57,0,0,0,63.256,0,2001,1,92,325,193,0.881004369203714,103.5,18.1120879120879,101,951.353228007912,-1.35283140063349
16760,519721.04,5331918.57,96,93,3,47.298,2,2002,2,100,332,202,0.855180758233481,46.4,18.2428571428571,102,951.353228007912,-1.35283140063349
16760,519721.04,5331918.57,0,0,0,47.154,0,2003,0,99,328,154,0.831724260560918,-203.8,22.9692307692308,55,951.353228007912,-1.35283140063349
16760,519721.04,5331918.57,137,94,43,45.215,0,2004,2,105,333,232,0.860112287485467,196.1,17.7461538461538,127,951.353228007912,-1.35283140063349
16760,519721.04,5331918.57,0,0,0,62.576,0,2005,0,95,310,169,0.8875583818214,38.9,17.9032967032967,74,951.353228007912,-1.35283140063349
16760,519721.04,5331918.57,162,98,64,36.445,1,2006,1,118,342,176,0.868579832521109,82.6,18.867032967033,58,951.353228007912,-1.35283140063349
16760,519721.04,5331918.57,0,0,0,90.479,0,2007,0,56,305,225,0.879970067934527,317.9,17.0824175824176,169,951.353228007912,-1.35283140063349
16760,519721.04,5331918.57,0,0,0,33.632,0,2008,0,113,307,218,0.889441744943595,40.8,17.6131868131868,105,951.353228007912,-1.35283140063349
16760,519721.04,5331918.57,154,64,90,52.802,0,2009,2,94,317,169,0.89808990888082,41,18.5230769230769,75,951.353228007912,-1.35283140063349
16760,519721.04,5331918.57,144,93,51,38.559,0,2010,2,109,306,209,0.88152736750887,122,18.3626373626374,100,951.353228007912,-1.35283140063349
16760,519721.04,5331918.57,0,0,0,58.359,0,2011,0,75,324,177,0.8661256108398,127.1,17.5,102,951.353228007912,-1.35283140063349
16760,519721.04,5331918.57,96,95,1,51.251,2,2012,1,100,303,169,0.887370758106745,82.8,18.7043956043956,69,951.353228007912,-1.35283140063349
16760,519721.04,5331918.57,138,84,54,43.549,0,2013,3,113,298,192,0.887800218705992,-163.1,19.2582417582418,79,951.353228007912,-1.35283140063349
16760,519721.04,5331918.57,0,0,0,58.323,0,2014,0,78,318,178,0.854440397690966,176.9,17.856043956044,100,951.353228007912,-1.35283140063349
16760,519721.04,5331918.57,0,0,0,48.534,0,2015,0,100,318,161,0.863098442068903,-158.6,20.9142857142857,61,951.353228007912,-1.35283140063349
16760,519721.04,5331918.57,159,94,65,52.424,6,2016,2,104,329,201,0.885135710715942,45.5,18.8857142857143,97,951.353228007912,-1.35283140063349
16760,519721.04,5331918.57,0,0,0,45.573,0,2017,0,97,298,169,0.857957973585483,-10.8,19.7879120879121,72,951.353228007912,-1.35283140063349
16760,519721.04,5331918.57,86,69,17,59.822,3,2018,1,89,335,160,0.876434786232083,-154,20.578021978022,71,951.353228007912,-1.35283140063349
16760,519721.04,5331918.57,138,93,45,45.762,8,2019,1,102,326,177,0.854038372726588,-79.8,20.6626373626374,75,951.353228007912,-1.35283140063349
16760,519721.04,5331918.57,93,93,0,43.295,9,2020,2,89,313,192,0.846457715142761,-19.2,19.0648351648352,103,951.353228007912,-1.35283140063349
16761,519721.04,5331686.914,0,0,0,129.875,0,2001,1,36,326,192,0.877944796884617,103.5,18.1120879120879,156,897.751778825025,-1.51892099583334
16761,519721.04,5331686.914,0,0,0,39.343,0,2002,0,109,296,185,0.839056544654006,46.4,18.2428571428571,76,897.751778825025,-1.51892099583334
16761,519721.04,5331686.914,148,101,47,43.196,1,2003,1,103,327,153,0.831751807069936,-203.8,22.9692307692308,50,897.751778825025,-1.51892099583334
16761,519721.04,5331686.914,139,93,46,38.861,0,2004,2,111,334,234,0.846738468758559,196.1,17.7461538461538,123,897.751778825025,-1.51892099583334
16761,519721.04,5331686.914,0,0,0,68.343,0,2005,0,90,322,240,0.846205027064672,38.9,17.9032967032967,150,897.751778825025,-1.51892099583334
16761,519721.04,5331686.914,174,93,81,33.054,0,2006,2,121,343,225,0.849451732050661,82.6,18.867032967033,104,897.751778825025,-1.51892099583334
16761,519721.04,5331686.914,0,0,0,124.981,0,2007,0,25,305,225,0.856049675207176,317.9,17.0824175824176,200,897.751778825025,-1.51892099583334
16761,519721.04,5331686.914,0,0,0,28.874,0,2008,0,117,310,201,0.876011602612915,40.8,17.6131868131868,84,897.751778825025,-1.51892099583334
16761,519721.04,5331686.914,156,67,89,56.394,0,2009,2,91,326,169,0.891868062114407,41,18.5230769230769,78,897.751778825025,-1.51892099583334
16761,519721.04,5331686.914,156,93,63,36.466,0,2010,2,111,310,218,0.871252555186847,122,18.3626373626374,107,897.751778825025,-1.51892099583334
16761,519721.04,5331686.914,86,67,19,54.3,4,2011,1,79,325,177,0.851214045647191,127.1,17.5,98,897.751778825025,-1.51892099583334
16761,519721.04,5331686.914,0,0,0,53.731,0,2012,0,97,303,169,0.868554653267663,82.8,18.7043956043956,72,897.751778825025,-1.51892099583334
16761,519721.04,5331686.914,149,93,56,42.434,0,2013,2,114,301,186,0.869290031603462,-163.1,19.2582417582418,72,897.751778825025,-1.51892099583334
16761,519721.04,5331686.914,86,74,12,58.323,7,2014,1,78,318,170,0.846865103121966,176.9,17.856043956044,92,897.751778825025,-1.51892099583334
16761,519721.04,5331686.914,0,0,0,56.629,0,2015,0,93,340,169,0.848451340141853,-158.6,20.9142857142857,76,897.751778825025,-1.51892099583334
16761,519721.04,5331686.914,156,98,58,55.463,6,2016,2,101,326,202,0.879070601029327,45.5,18.8857142857143,101,897.751778825025,-1.51892099583334
16761,519721.04,5331686.914,111,93,18,51.827,7,2017,2,90,321,224,0.849235008045643,-10.8,19.7879120879121,134,897.751778825025,-1.51892099583334
16761,519721.04,5331686.914,93,93,0,52.842,1,2018,1,95,337,161,0.870358271551585,-154,20.578021978022,66,897.751778825025,-1.51892099583334
16761,519721.04,5331686.914,0,0,0,42.98,0,2019,0,105,299,176,0.837534460014541,-79.8,20.6626373626374,71,897.751778825025,-1.51892099583334
16761,519721.04,5331686.914,128,94,34,37.159,3,2020,2,96,315,193,0.843767109606251,-19.2,19.0648351648352,97,897.751778825025,-1.51892099583334
16762,519721.04,5331455.257,0,0,0,57.717,0,2001,1,97,336,186,0.853727050240843,103.5,18.1120879120879,89,874.437642356992,-0.487361000158447
16762,519721.04,5331455.257,0,0,0,39.343,0,2002,0,109,331,200,0.851700575982151,46.4,18.2428571428571,91,874.437642356992,-0.487361000158447
16762,519721.04,5331455.257,143,94,49,41.269,1,2003,1,105,327,160,0.81208595412287,-203.8,22.9692307692308,55,874.437642356992,-0.487361000158447
16762,519721.04,5331455.257,137,94,43,37.822,0,2004,2,112,336,216,0.828226746547325,196.1,17.7461538461538,104,874.437642356992,-0.487361000158447
16762,519721.04,5331455.257,0,0,0,70.771,0,2005,0,88,311,178,0.87255507419255,38.9,17.9032967032967,90,874.437642356992,-0.487361000158447
16762,519721.04,5331455.257,174,93,81,31.98,0,2006,2,122,345,226,0.840307482876238,82.6,18.867032967033,104,874.437642356992,-0.487361000158447
16762,519721.04,5331455.257,0,0,0,119.468,0,2007,0,30,307,202,0.851730074665045,317.9,17.0824175824176,172,874.437642356992,-0.487361000158447
16762,519721.04,5331455.257,0,0,0,23.631,0,2008,0,122,310,185,0.871102963041096,40.8,17.6131868131868,63,874.437642356992,-0.487361000158447
16762,519721.04,5331455.257,157,67,90,54.021,0,2009,2,93,330,177,0.891442072848289,41,18.5230769230769,84,874.437642356992,-0.487361000158447
16762,519721.04,5331455.257,156,93,63,36.466,0,2010,2,111,312,217,0.866164038733632,122,18.3626373626374,106,874.437642356992,-0.487361000158447
16762,519721.04,5331455.257,86,67,19,98.13,24,2011,1,37,324,194,0.844761938565322,127.1,17.5,157,874.437642356992,-0.487361000158447
16762,519721.04,5331455.257,0,0,0,55.416,0,2012,0,95,307,169,0.869570116810442,82.8,18.7043956043956,74,874.437642356992,-0.487361000158447
16762,519721.04,5331455.257,149,95,54,49.458,0,2013,2,108,319,192,0.858924517862738,-163.1,19.2582417582418,84,874.437642356992,-0.487361000158447
16762,519721.04,5331455.257,86,80,6,54.823,7,2014,1,82,318,169,0.834444206058767,176.9,17.856043956044,87,874.437642356992,-0.487361000158447
16762,519721.04,5331455.257,0,0,0,54.213,0,2015,0,95,344,184,0.819181211624946,-158.6,20.9142857142857,89,874.437642356992,-0.487361000158447
16762,519721.04,5331455.257,156,94,62,54.446,6,2016,2,102,331,185,0.894932279774686,45.5,18.8857142857143,83,874.437642356992,-0.487361000158447
16762,519721.04,5331455.257,107,93,14,53.784,7,2017,2,88,321,218,0.853298796402461,-10.8,19.7879120879121,130,874.437642356992,-0.487361000158447
16762,519721.04,5331455.257,93,93,0,51.594,1,2018,1,96,337,162,0.856480694161875,-154,20.578021978022,66,874.437642356992,-0.487361000158447
16762,519721.04,5331455.257,94,94,0,41.159,4,2019,1,107,299,168,0.822038575853281,-79.8,20.6626373626374,61,874.437642356992,-0.487361000158447
16762,519721.04,5331455.257,142,96,46,34.734,3,2020,1,99,316,185,0.828153301604149,-19.2,19.0648351648352,86,874.437642356992,-0.487361000158447
16943,519952.696,5340258.199,0,0,0,36.992,0,2001,2,115,322,177,0.830483821487273,116.8,17.4,62,1176.54962770216,0.720763042453716
16943,519952.696,5340258.199,158,83,75,28.1,0,2002,2,122,295,177,0.856438747237793,52.7,17.567032967033,55,1176.54962770216,0.720763042453716
16943,519952.696,5340258.199,170,100,70,29.642,0,2003,1,119,295,170,0.851691275430804,-198,22.3252747252747,51,1176.54962770216,0.720763042453716
16943,519952.696,5340258.199,180,93,87,26.516,0,2004,1,124,315,169,0.829137712567093,209.7,17.0835164835165,45,1176.54962770216,0.720763042453716
16943,519952.696,5340258.199,166,86,80,34.166,0,2005,2,120,314,169,0.829595714336298,44.2,17.3054945054945,49,1176.54962770216,0.720763042453716
16943,519952.696,5340258.199,193,69,124,34.472,2,2006,3,119,315,192,0.848429791081438,92.3,18.2626373626374,73,1176.54962770216,0.720763042453716
16943,519952.696,5340258.199,0,0,0,37.206,0,2007,0,107,296,225,0.845365402080294,332.6,16.5076923076923,118,1176.54962770216,0.720763042453716
16943,519952.696,5340258.199,86,55,31,12.778,0,2008,1,135,295,217,0.893495305891613,50.1,16.9747252747253,82,1176.54962770216,0.720763042453716
16943,519952.696,5340258.199,185,68,117,48.876,0,2009,3,97,291,185,0.883004214612452,55,17.8153846153846,88,1176.54962770216,0.720763042453716
16943,519952.696,5340258.199,177,63,114,22.475,0,2010,2,126,287,193,0.861537538359694,133.1,17.7351648351648,67,1176.54962770216,0.720763042453716
16943,519952.696,5340258.199,150,93,57,28.173,0,2011,1,106,315,162,0.827130378249143,136.1,17.0351648351648,56,1176.54962770216,0.720763042453716
16943,519952.696,5340258.199,172,99,73,34.503,0,2012,2,118,306,201,0.820729117507618,88.9,18.4296703296703,83,1176.54962770216,0.720763042453716
16943,519952.696,5340258.199,183,67,116,30.012,1,2013,3,125,300,201,0.847587368775381,-156.9,18.6175824175824,76,1176.54962770216,0.720763042453716
16943,519952.696,5340258.199,161,48,113,31.174,0,2014,2,114,316,186,0.854376905420197,191.6,17.4516483516484,72,1176.54962770216,0.720763042453716
16943,519952.696,5340258.199,176,86,90,46.354,0,2015,2,102,290,168,0.851009535105329,-154.6,20.4153846153846,66,1176.54962770216,0.720763042453716
16943,519952.696,5340258.199,178,119,59,25.207,0,2016,1,129,338,177,0.901647778228754,50.9,18.5681318681319,48,1176.54962770216,0.720763042453716
16943,519952.696,5340258.199,159,93,66,26.643,0,2017,1,122,287,170,0.868174297298159,-2.3,19.1582417582418,48,1176.54962770216,0.720763042453716
16943,519952.696,5340258.199,166,100,66,40.956,0,2018,1,104,303,177,0.82472201807649,-151.3,19.9417582417582,73,1176.54962770216,0.720763042453716
16943,519952.696,5340258.199,172,80,92,25.763,3,2019,2,125,298,169,0.853301012528928,-73.4,20.0571428571429,44,1176.54962770216,0.720763042453716
16943,519952.696,5340258.199,145,93,52,24.854,1,2020,2,114,296,217,0.816624591077321,-13.6,18.3758241758242,103,1176.54962770216,0.720763042453716
16965,519952.696,5335161.759,0,0,0,41.484,0,2001,2,111,298,225,0.850975031809359,116.8,17.4,114,1186.90437371099,-1.42647262960321
16965,519952.696,5335161.759,160,67,93,31.477,0,2002,3,118,293,232,0.858724669261121,52.7,17.567032967033,114,1186.90437371099,-1.42647262960321
16965,519952.696,5335161.759,156,51,105,51.144,8,2003,2,95,321,153,0.840750018992173,-198,22.3252747252747,58,1186.90437371099,-1.42647262960321
16965,519952.696,5335161.759,156,93,63,29.894,0,2004,1,120,322,170,0.843341457241559,209.7,17.0835164835165,50,1186.90437371099,-1.42647262960321
16965,519952.696,5335161.759,159,93,66,46.188,0,2005,1,109,319,176,0.856509873260449,44.2,17.3054945054945,67,1186.90437371099,-1.42647262960321
16965,519952.696,5335161.759,194,67,127,30.508,1,2006,3,123,327,264,0.819742168247734,92.3,18.2626373626374,141,1186.90437371099,-1.42647262960321
16965,519952.696,5335161.759,127,94,33,58.345,2,2007,1,85,308,145,0.827785119252463,332.6,16.5076923076923,60,1186.90437371099,-1.42647262960321
16965,519952.696,5335161.759,86,60,26,22.603,0,2008,1,123,310,209,0.796340300180844,50.1,16.9747252747253,86,1186.90437371099,-1.42647262960321
16965,519952.696,5335161.759,180,67,113,29.053,0,2009,2,116,310,168,0.853963814963426,55,17.8153846153846,52,1186.90437371099,-1.42647262960321
16965,519952.696,5335161.759,175,95,80,29,0,2010,1,117,298,170,0.845658615756464,133.1,17.7351648351648,53,1186.90437371099,-1.42647262960321
16965,519952.696,5335161.759,139,71,68,37.229,1,2011,3,95,322,248,0.826498553254596,136.1,17.0351648351648,153,1186.90437371099,-1.42647262960321
16965,519952.696,5335161.759,157,83,74,37.848,0,2012,2,115,311,170,0.859210310985756,88.9,18.4296703296703,55,1186.90437371099,-1.42647262960321
16965,519952.696,5335161.759,177,80,97,41.457,1,2013,3,114,296,218,0.821495110923996,-156.9,18.6175824175824,104,1186.90437371099,-1.42647262960321
16965,519952.696,5335161.759,155,45,110,42.374,3,2014,2,97,332,161,0.833885021711925,191.6,17.4516483516484,64,1186.90437371099,-1.42647262960321
16965,519952.696,5335161.759,160,85,75,46.354,0,2015,2,102,334,152,0.812608312102642,-154.6,20.4153846153846,50,1186.90437371099,-1.42647262960321
16965,519952.696,5335161.759,193,94,99,28.272,0,2016,2,126,323,233,0.844876540376924,50.9,18.5681318681319,107,1186.90437371099,-1.42647262960321
16965,519952.696,5335161.759,144,101,43,47.287,7,2017,1,95,311,161,0.827851021710049,-2.3,19.1582417582418,66,1186.90437371099,-1.42647262960321
16965,519952.696,5335161.759,161,61,100,33.351,0,2018,3,112,301,208,0.815280681174168,-151.3,19.9417582417582,96,1186.90437371099,-1.42647262960321
16965,519952.696,5335161.759,160,93,67,31.151,4,2019,2,119,312,241,0.819915174925959,-73.4,20.0571428571429,122,1186.90437371099,-1.42647262960321
16965,519952.696,5335161.759,0,0,0,29.113,0,2020,0,107,312,169,0.819147503557268,-13.6,18.3758241758242,62,1186.90437371099,-1.42647262960321
16966,519952.696,5334930.103,86,84,2,48.404,7,2001,2,105,296,210,0.800500015694149,116.8,17.4,105,1198.77763833244,-0.643728437393933
16966,519952.696,5334930.103,93,66,27,33.966,0,2002,3,115,295,241,0.815626162983054,52.7,17.567032967033,126,1198.77763833244,-0.643728437393933
16966,519952.696,5334930.103,169,57,112,31.289,0,2003,2,117,306,153,0.803362054514239,-198,22.3252747252747,36,1198.77763833244,-0.643728437393933
16966,519952.696,5334930.103,168,93,75,29.894,0,2004,2,120,327,186,0.805119034069405,209.7,17.0835164835165,66,1198.77763833244,-0.643728437393933
16966,519952.696,5334930.103,163,121,42,45.08,0,2005,1,110,306,169,0.81942132563829,44.2,17.3054945054945,59,1198.77763833244,-0.643728437393933
16966,519952.696,5334930.103,194,52,142,34.472,2,2006,3,119,333,240,0.801536303063825,92.3,18.2626373626374,121,1198.77763833244,-0.643728437393933
16966,519952.696,5334930.103,93,93,0,52.881,2,2007,2,90,302,225,0.80206649126547,332.6,16.5076923076923,135,1198.77763833244,-0.643728437393933
16966,519952.696,5334930.103,176,57,119,26.659,0,2008,3,119,309,225,0.800988318955562,50.1,16.9747252747253,106,1198.77763833244,-0.643728437393933
16966,519952.696,5334930.103,183,65,118,24.85,0,2009,2,121,299,169,0.857916857076762,55,17.8153846153846,48,1198.77763833244,-0.643728437393933
16966,519952.696,5334930.103,171,72,99,26.78,0,2010,2,120,308,176,0.814277334211949,133.1,17.7351648351648,56,1198.77763833244,-0.643728437393933
16966,519952.696,5334930.103,145,102,43,35.44,1,2011,2,97,322,248,0.7764167794743,136.1,17.0351648351648,151,1198.77763833244,-0.643728437393933
16966,519952.696,5334930.103,161,93,68,41.854,0,2012,1,111,322,154,0.816916563661315,88.9,18.4296703296703,43,1198.77763833244,-0.643728437393933
16966,519952.696,5334930.103,185,93,92,23.774,1,2013,2,131,304,192,0.793378347542031,-156.9,18.6175824175824,61,1198.77763833244,-0.643728437393933
16966,519952.696,5334930.103,154,46,108,46.128,3,2014,2,92,322,169,0.820940431531074,191.6,17.4516483516484,77,1198.77763833244,-0.643728437393933
16966,519952.696,5334930.103,159,80,79,48.377,0,2015,2,100,334,161,0.820194712547771,-154.6,20.4153846153846,61,1198.77763833244,-0.643728437393933
16966,519952.696,5334930.103,169,136,33,30.486,0,2016,1,124,333,209,0.83823052174854,50.9,18.5681318681319,85,1198.77763833244,-0.643728437393933
16966,519952.696,5334930.103,147,93,54,40.281,7,2017,1,104,304,169,0.820786622902519,-2.3,19.1582417582418,65,1198.77763833244,-0.643728437393933
16966,519952.696,5334930.103,150,47,103,60.009,2,2018,2,87,309,168,0.823162960972758,-151.3,19.9417582417582,81,1198.77763833244,-0.643728437393933
16966,519952.696,5334930.103,161,96,65,34.644,4,2019,1,115,303,162,0.776420351635366,-73.4,20.0571428571429,47,1198.77763833244,-0.643728437393933
16966,519952.696,5334930.103,0,0,0,27.839,0,2020,0,109,313,169,0.81389335910054,-13.6,18.3758241758242,60,1198.77763833244,-0.643728437393933
17162,520184.352,5340258.199,0,0,0,34.788,0,2001,2,117,308,169,0.796624533415049,116.8,17.4,52,1222.45191931417,0.135593197918346
17162,520184.352,5340258.199,157,78,79,28.961,0,2002,2,121,297,177,0.849954288735657,52.7,17.567032967033,56,1222.45191931417,0.135593197918346
17162,520184.352,5340258.199,173,83,90,32.108,0,2003,2,116,289,162,0.840856067228499,-198,22.3252747252747,46,1222.45191931417,0.135593197918346
17162,520184.352,5340258.199,177,126,51,32.485,0,2004,1,117,314,169,0.80572617642749,209.7,17.0835164835165,52,1222.45191931417,0.135593197918346
17162,520184.352,5340258.199,165,86,79,40.72,0,2005,2,114,306,162,0.805740894387187,44.2,17.3054945054945,48,1222.45191931417,0.135593197918346
17162,520184.352,5340258.199,203,62,141,21.061,1,2006,2,133,320,185,0.814457473243267,92.3,18.2626373626374,52,1222.45191931417,0.135593197918346
17162,520184.352,5340258.199,0,0,0,35.048,0,2007,0,110,303,160,0.817796544594721,332.6,16.5076923076923,50,1222.45191931417,0.135593197918346
17162,520184.352,5340258.199,94,56,38,4.513,0,2008,3,158,295,218,0.854134189946646,50.1,16.9747252747253,60,1222.45191931417,0.135593197918346
17162,520184.352,5340258.199,187,64,123,42.763,0,2009,2,102,290,184,0.871834545955328,55,17.8153846153846,82,1222.45191931417,0.135593197918346
17162,520184.352,5340258.199,180,62,118,17.622,0,2010,3,132,284,209,0.86082956603473,133.1,17.7351648351648,77,1222.45191931417,0.135593197918346
17162,520184.352,5340258.199,152,93,59,26.677,0,2011,1,108,311,161,0.823532271585491,136.1,17.0351648351648,53,1222.45191931417,0.135593197918346
17162,520184.352,5340258.199,173,93,80,35.602,0,2012,1,117,295,161,0.809533515364931,88.9,18.4296703296703,44,1222.45191931417,0.135593197918346
17162,520184.352,5340258.199,186,68,118,24.788,1,2013,2,130,295,200,0.81956295953534,-156.9,18.6175824175824,70,1222.45191931417,0.135593197918346
17162,520184.352,5340258.199,163,47,116,31.174,0,2014,2,114,315,170,0.81973593505267,191.6,17.4516483516484,56,1222.45191931417,0.135593197918346
17162,520184.352,5340258.199,179,85,94,39.889,0,2015,2,109,301,169,0.832843961245059,-154.6,20.4153846153846,60,1222.45191931417,0.135593197918346
17162,520184.352,5340258.199,183,162,21,25.207,0,2016,1,129,326,177,0.886467089406501,50.9,18.5681318681319,48,1222.45191931417,0.135593197918346
17162,520184.352,5340258.199,161,118,43,33.563,3,2017,1,113,290,168,0.849120435421486,-2.3,19.1582417582418,55,1222.45191931417,0.135593197918346
17162,520184.352,5340258.199,166,100,66,48.353,0,2018,2,97,296,193,0.778283128202295,-151.3,19.9417582417582,96,1222.45191931417,0.135593197918346
17162,520184.352,5340258.199,173,78,95,25.763,3,2019,2,125,300,169,0.832455633607199,-73.4,20.0571428571429,44,1222.45191931417,0.135593197918346
17162,520184.352,5340258.199,148,93,55,23.757,1,2020,2,116,295,192,0.815702601081873,-13.6,18.3758241758242,76,1222.45191931417,0.135593197918346
17163,520184.352,5340026.543,0,0,0,34.788,0,2001,2,117,299,234,0.839207693781873,116.8,17.4,117,1260.51988327623,0.530809111966129
17163,520184.352,5340026.543,161,69,92,24.173,0,2002,2,126,313,178,0.845361317929746,52.7,17.567032967033,52,1260.51988327623,0.530809111966129
17163,520184.352,5340026.543,173,112,61,39.604,1,2003,1,107,290,169,0.836373337738375,-198,22.3252747252747,62,1260.51988327623,0.530809111966129
17163,520184.352,5340026.543,177,93,84,11.934,0,2004,2,139,295,194,0.805717047318492,209.7,17.0835164835165,55,1260.51988327623,0.530809111966129
17163,520184.352,5340026.543,183,149,34,28.191,0,2005,1,126,308,177,0.845326660135792,44.2,17.3054945054945,51,1260.51988327623,0.530809111966129
17163,520184.352,5340026.543,192,83,109,20.092,1,2006,3,134,313,178,0.81333936727521,92.3,18.2626373626374,44,1260.51988327623,0.530809111966129
17163,520184.352,5340026.543,159,95,64,33.684,0,2007,2,112,288,192,0.83495932009374,332.6,16.5076923076923,80,1260.51988327623,0.530809111966129
17163,520184.352,5340026.543,159,44,115,12.778,0,2008,2,135,292,202,0.824863881850596,50.1,16.9747252747253,67,1260.51988327623,0.530809111966129
17163,520184.352,5340026.543,175,63,112,48.876,0,2009,3,97,288,185,0.890730039305094,55,17.8153846153846,88,1260.51988327623,0.530809111966129
17163,520184.352,5340026.543,182,93,89,11.321,0,2010,2,139,282,194,0.825665990162486,133.1,17.7351648351648,55,1260.51988327623,0.530809111966129
17163,520184.352,5340026.543,151,93,58,25.242,0,2011,1,110,310,162,0.856717215265553,136.1,17.0351648351648,52,1260.51988327623,0.530809111966129
17163,520184.352,5340026.543,171,98,73,33.433,0,2012,1,119,291,177,0.85276102565824,88.9,18.4296703296703,58,1260.51988327623,0.530809111966129
17163,520184.352,5340026.543,196,58,138,17.728,1,2013,3,137,296,201,0.820475338486245,-156.9,18.6175824175824,64,1260.51988327623,0.530809111966129
17163,520184.352,5340026.543,168,143,25,28.133,0,2014,1,119,320,184,0.84117243641326,191.6,17.4516483516484,65,1260.51988327623,0.530809111966129
17163,520184.352,5340026.543,182,148,34,27.527,0,2015,1,123,290,170,0.811062082852585,-154.6,20.4153846153846,47,1260.51988327623,0.530809111966129
17163,520184.352,5340026.543,181,112,69,24.254,0,2016,1,130,305,177,0.890713606909866,50.9,18.5681318681319,47,1260.51988327623,0.530809111966129
17163,520184.352,5340026.543,159,129,30,25.846,0,2017,1,123,284,170,0.841100720787911,-2.3,19.1582417582418,47,1260.51988327623,0.530809111966129
17163,520184.352,5340026.543,171,45,126,45.076,0,2018,2,100,300,177,0.806419380334552,-151.3,19.9417582417582,77,1260.51988327623,0.530809111966129
17163,520184.352,5340026.543,170,101,69,23.928,1,2019,1,127,297,176,0.826025591510582,-73.4,20.0571428571429,49,1260.51988327623,0.530809111966129
17163,520184.352,5340026.543,0,0,0,22.704,0,2020,0,118,293,209,0.781140757441615,-13.6,18.3758241758242,91,1260.51988327623,0.530809111966129
17185,520184.352,5334930.103,86,84,2,46.16,6,2001,1,107,294,170,0.809498519015411,116.8,17.4,63,1204.47718371717,0.531266416947475
17185,520184.352,5334930.103,93,64,29,26.209,0,2002,3,124,292,184,0.822474202182675,52.7,17.567032967033,60,1204.47718371717,0.531266416947475
17185,520184.352,5334930.103,168,57,111,29.642,0,2003,2,119,307,154,0.808864919048455,-198,22.3252747252747,35,1204.47718371717,0.531266416947475
17185,520184.352,5334930.103,171,93,78,15.771,0,2004,2,135,323,192,0.829690753003681,209.7,17.0835164835165,57,1204.47718371717,0.531266416947475
17185,520184.352,5334930.103,167,143,24,36.316,0,2005,1,118,311,216,0.796912560434049,44.2,17.3054945054945,98,1204.47718371717,0.531266416947475
17185,520184.352,5334930.103,197,55,142,28.664,1,2006,2,125,326,225,0.800378463167248,92.3,18.2626373626374,100,1204.47718371717,0.531266416947475
17185,520184.352,5334930.103,0,0,0,58.345,0,2007,0,85,301,153,0.807754510992809,332.6,16.5076923076923,68,1204.47718371717,0.531266416947475
17185,520184.352,5334930.103,180,57,123,18.046,0,2008,3,128,307,209,0.826788376634507,50.1,16.9747252747253,81,1204.47718371717,0.531266416947475
17185,520184.352,5334930.103,173,65,108,37.626,0,2009,3,107,296,241,0.814172891838485,55,17.8153846153846,134,1204.47718371717,0.531266416947475
17185,520184.352,5334930.103,170,72,98,22.475,0,2010,2,126,298,178,0.837742677457567,133.1,17.7351648351648,52,1204.47718371717,0.531266416947475
17185,520184.352,5334930.103,148,101,47,32.898,1,2011,2,100,314,242,0.822384069974213,136.1,17.0351648351648,142,1204.47718371717,0.531266416947475
17185,520184.352,5334930.103,160,93,67,38.92,0,2012,1,114,319,162,0.819173763015876,88.9,18.4296703296703,48,1204.47718371717,0.531266416947475
17185,520184.352,5334930.103,185,93,92,20.729,1,2013,2,134,291,192,0.827325856480603,-156.9,18.6175824175824,58,1204.47718371717,0.531266416947475
17185,520184.352,5334930.103,155,40,115,40.211,3,2014,2,100,319,176,0.834309521821007,191.6,17.4516483516484,76,1204.47718371717,0.531266416947475
17185,520184.352,5334930.103,161,80,81,38.991,0,2015,2,110,330,169,0.824302097841825,-154.6,20.4153846153846,59,1204.47718371717,0.531266416947475
17185,520184.352,5334930.103,166,94,72,18.414,0,2016,2,136,334,216,0.837033180845122,50.9,18.5681318681319,80,1204.47718371717,0.531266416947475
17185,520184.352,5334930.103,151,101,50,32.104,3,2017,1,115,300,169,0.829736699786117,-2.3,19.1582417582418,54,1204.47718371717,0.531266416947475
17185,520184.352,5334930.103,169,46,123,28.296,0,2018,2,118,313,176,0.838313360597042,-151.3,19.9417582417582,58,1204.47718371717,0.531266416947475
17185,520184.352,5334930.103,163,97,66,23.928,1,2019,1,127,302,170,0.815737270707481,-73.4,20.0571428571429,43,1204.47718371717,0.531266416947475
17185,520184.352,5334930.103,150,93,57,29.113,1,2020,1,107,310,170,0.810931810564701,-13.6,18.3758241758242,63,1204.47718371717,0.531266416947475
17186,520184.352,5334698.446,86,85,1,39.209,1,2001,3,113,295,192,0.825653494397469,116.8,17.4,79,1238.11526371137,1.13533383228253
17186,520184.352,5334698.446,93,65,28,24.173,0,2002,3,126,291,185,0.844117493002222,52.7,17.567032967033,59,1238.11526371137,1.13533383228253
17186,520184.352,5334698.446,169,57,112,29.642,0,2003,2,119,321,161,0.810639978220623,-198,22.3252747252747,42,1238.11526371137,1.13533383228253
17186,520184.352,5334698.446,169,93,76,17.848,0,2004,2,133,327,193,0.825687948441844,209.7,17.0835164835165,60,1238.11526371137,1.13533383228253
17186,520184.352,5334698.446,164,122,42,36.316,0,2005,1,118,306,201,0.804147291347948,44.2,17.3054945054945,83,1238.11526371137,1.13533383228253
17186,520184.352,5334698.446,194,54,140,33.449,2,2006,2,120,331,178,0.810912433264675,92.3,18.2626373626374,58,1238.11526371137,1.13533383228253
17186,520184.352,5334698.446,0,0,0,39.541,0,2007,0,104,292,162,0.817280765505739,332.6,16.5076923076923,58,1238.11526371137,1.13533383228253
17186,520184.352,5334698.446,177,53,124,22.603,0,2008,2,123,302,185,0.849961479113221,50.1,16.9747252747253,62,1238.11526371137,1.13533383228253
17186,520184.352,5334698.446,174,65,109,28.202,0,2009,2,117,299,170,0.855541936363827,55,17.8153846153846,53,1238.11526371137,1.13533383228253
17186,520184.352,5334698.446,168,72,96,20.929,0,2010,3,128,300,185,0.881900744159172,133.1,17.7351648351648,57,1238.11526371137,1.13533383228253
17186,520184.352,5334698.446,145,93,52,33.726,1,2011,4,99,314,208,0.818703648948197,136.1,17.0351648351648,109,1238.11526371137,1.13533383228253
17186,520184.352,5334698.446,161,93,68,31.399,0,2012,1,121,318,177,0.837903860929972,88.9,18.4296703296703,56,1238.11526371137,1.13533383228253
17186,520184.352,5334698.446,188,93,95,23.774,1,2013,2,131,298,185,0.838313997127875,-156.9,18.6175824175824,54,1238.11526371137,1.13533383228253
17186,520184.352,5334698.446,156,45,111,36.814,3,2014,2,105,323,177,0.849428123327955,191.6,17.4516483516484,72,1238.11526371137,1.13533383228253
17186,520184.352,5334698.446,161,84,77,38.112,0,2015,2,111,326,170,0.820238232522018,-154.6,20.4153846153846,59,1238.11526371137,1.13533383228253
17186,520184.352,5334698.446,168,111,57,19.418,0,2016,2,135,332,201,0.860266897004935,50.9,18.5681318681319,66,1238.11526371137,1.13533383228253
17186,520184.352,5334698.446,151,102,49,28.227,0,2017,1,120,290,176,0.830455448579376,-2.3,19.1582417582418,56,1238.11526371137,1.13533383228253
17186,520184.352,5334698.446,161,42,119,36.94,0,2018,2,108,309,170,0.847523420364802,-151.3,19.9417582417582,62,1238.11526371137,1.13533383228253
17186,520184.352,5334698.446,166,101,65,23.027,0,2019,1,128,298,176,0.823698018375253,-73.4,20.0571428571429,48,1238.11526371137,1.13533383228253
17186,520184.352,5334698.446,150,97,53,23.757,1,2020,2,116,312,193,0.81001918992949,-13.6,18.3758241758242,77,1238.11526371137,1.13533383228253
17378,520416.009,5340953.168,86,86,0,38.09,0,2001,2,114,295,177,0.88001973426458,116.8,17.4,63,1251.54293232233,1.28659665034833
17378,520416.009,5340953.168,163,63,100,32.329,0,2002,2,117,316,177,0.809341407536263,52.7,17.567032967033,60,1251.54293232233,1.28659665034833
17378,520416.009,5340953.168,175,70,105,34.588,0,2003,2,113,298,161,0.835060457771789,-198,22.3252747252747,48,1251.54293232233,1.28659665034833
17378,520416.009,5340953.168,184,60,124,29.039,0,2004,2,121,289,177,0.876696769578692,209.7,17.0835164835165,56,1251.54293232233,1.28659665034833
17378,520416.009,5340953.168,172,86,86,36.316,0,2005,2,118,307,177,0.859328654818723,44.2,17.3054945054945,59,1251.54293232233,1.28659665034833
17378,520416.009,5340953.168,198,68,130,27.774,1,2006,2,126,325,177,0.820198396580522,92.3,18.2626373626374,51,1251.54293232233,1.28659665034833
17378,520416.009,5340953.168,162,114,48,37.96,0,2007,1,106,300,169,0.847536076777762,332.6,16.5076923076923,63,1251.54293232233,1.28659665034833
17378,520416.009,5340953.168,177,55,122,16.416,0,2008,3,130,292,193,0.800292568682361,50.1,16.9747252747253,63,1251.54293232233,1.28659665034833
17378,520416.009,5340953.168,183,65,118,41.687,0,2009,2,103,289,169,0.876865581398757,55,17.8153846153846,66,1251.54293232233,1.28659665034833
17378,520416.009,5340953.168,185,66,119,24.628,0,2010,2,123,295,176,0.848743803845206,133.1,17.7351648351648,53,1251.54293232233,1.28659665034833
17378,520416.009,5340953.168,151,56,95,29.721,0,2011,2,104,311,152,0.847659063682049,136.1,17.0351648351648,48,1251.54293232233,1.28659665034833
17378,520416.009,5340953.168,170,93,77,32.403,0,2012,1,120,304,176,0.842915918226726,88.9,18.4296703296703,56,1251.54293232233,1.28659665034833
17378,520416.009,5340953.168,204,62,142,18.745,1,2013,4,136,294,186,0.857217279242681,-156.9,18.6175824175824,50,1251.54293232233,1.28659665034833
17378,520416.009,5340953.168,164,42,122,33.028,0,2014,2,111,323,162,0.834481998580362,191.6,17.4516483516484,51,1251.54293232233,1.28659665034833
17378,520416.009,5340953.168,182,128,54,37.257,0,2015,1,112,318,161,0.852197231410079,-154.6,20.4153846153846,49,1251.54293232233,1.28659665034833
17378,520416.009,5340953.168,193,93,100,19.418,0,2016,2,135,323,178,0.848519874720592,50.9,18.5681318681319,43,1251.54293232233,1.28659665034833
17378,520416.009,5340953.168,153,100,53,30.63,2,2017,1,117,293,168,0.842422317369185,-2.3,19.1582417582418,51,1251.54293232233,1.28659665034833
17378,520416.009,5340953.168,169,52,117,35.998,0,2018,2,109,301,161,0.809113156248674,-151.3,19.9417582417582,52,1251.54293232233,1.28659665034833
17378,520416.009,5340953.168,173,102,71,30.238,4,2019,1,120,296,177,0.813476391440611,-73.4,20.0571428571429,57,1251.54293232233,1.28659665034833
17378,520416.009,5340953.168,155,73,82,25.425,1,2020,2,113,299,170,0.781560169073188,-13.6,18.3758241758242,57,1251.54293232233,1.28659665034833
17381,520416.009,5340258.199,93,93,0,29.381,0,2001,4,122,304,200,0.777522537642282,116.8,17.4,78,1265.5486537043,-1.48669891179315
17381,520416.009,5340258.199,164,75,89,24.173,0,2002,3,126,315,185,0.833439055893405,52.7,17.567032967033,59,1265.5486537043,-1.48669891179315
17381,520416.009,5340258.199,179,66,113,28.806,0,2003,2,120,290,168,0.827835169696423,-198,22.3252747252747,48,1265.5486537043,-1.48669891179315
17381,520416.009,5340258.199,184,37,147,20.014,0,2004,3,131,303,225,0.787695015090957,209.7,17.0835164835165,94,1265.5486537043,-1.48669891179315
17381,520416.009,5340258.199,168,93,75,32.157,0,2005,2,122,305,185,0.840252469038387,44.2,17.3054945054945,63,1265.5486537043,-1.48669891179315
17381,520416.009,5340258.199,205,61,144,17.202,1,2006,2,137,319,178,0.806449625463404,92.3,18.2626373626374,41,1265.5486537043,-1.48669891179315
17381,520416.009,5340258.199,159,113,46,40.363,0,2007,1,103,293,161,0.850930011070913,332.6,16.5076923076923,58,1265.5486537043,-1.48669891179315
17381,520416.009,5340258.199,180,51,129,7.531,0,2008,3,162,293,232,0.824615940539067,50.1,16.9747252747253,70,1265.5486537043,-1.48669891179315
17381,520416.009,5340258.199,183,61,122,45.038,0,2009,2,100,282,170,0.858132499273326,55,17.8153846153846,70,1265.5486537043,-1.48669891179315
17381,520416.009,5340258.199,185,73,112,19.346,0,2010,2,130,296,201,0.807675123732464,133.1,17.7351648351648,71,1265.5486537043,-1.48669891179315
17381,520416.009,5340258.199,160,121,39,25.951,0,2011,1,109,311,184,0.783958908746572,136.1,17.0351648351648,75,1265.5486537043,-1.48669891179315
17381,520416.009,5340258.199,182,80,102,30.389,0,2012,2,122,299,176,0.862721802171746,88.9,18.4296703296703,54,1265.5486537043,-1.48669891179315
17381,520416.009,5340258.199,197,64,133,31.134,1,2013,3,124,291,208,0.8345669906799,-156.9,18.6175824175824,84,1265.5486537043,-1.48669891179315
17381,520416.009,5340258.199,177,41,136,28.765,0,2014,2,118,313,185,0.831761385936655,191.6,17.4516483516484,67,1265.5486537043,-1.48669891179315
17381,520416.009,5340258.199,176,129,47,36.427,0,2015,1,113,307,168,0.80187735740658,-154.6,20.4153846153846,55,1265.5486537043,-1.48669891179315
17381,520416.009,5340258.199,195,174,21,17.425,0,2016,1,137,312,192,0.861861599678708,50.9,18.5681318681319,55,1265.5486537043,-1.48669891179315
17381,520416.009,5340258.199,156,115,41,25.048,0,2017,1,124,291,169,0.821489144963547,-2.3,19.1582417582418,45,1265.5486537043,-1.48669891179315
17381,520416.009,5340258.199,167,55,112,37.913,0,2018,3,107,301,193,0.74993775970603,-151.3,19.9417582417582,86,1265.5486537043,-1.48669891179315
17381,520416.009,5340258.199,184,155,29,23.027,0,2019,1,128,296,169,0.799751748815873,-73.4,20.0571428571429,41,1265.5486537043,-1.48669891179315
17381,520416.009,5340258.199,151,79,72,20.455,1,2020,3,122,293,193,0.81580065262086,-13.6,18.3758241758242,71,1265.5486537043,-1.48669891179315
17382,520416.009,5340026.543,0,0,0,34.788,0,2001,3,117,293,177,0.828633134675258,116.8,17.4,60,1298.81807301385,0.827643204292045
17382,520416.009,5340026.543,167,65,102,15.412,0,2002,2,135,295,202,0.821012555705366,52.7,17.567032967033,67,1298.81807301385,0.827643204292045
17382,520416.009,5340026.543,174,50,124,33.746,0,2003,2,114,287,170,0.814869725576605,-198,22.3252747252747,56,1298.81807301385,0.827643204292045
17382,520416.009,5340026.543,172,121,51,11.049,0,2004,1,140,305,193,0.837057737361747,209.7,17.0835164835165,53,1298.81807301385,0.827643204292045
17382,520416.009,5340026.543,176,93,83,26.07,0,2005,2,128,304,185,0.83848735134218,44.2,17.3054945054945,57,1298.81807301385,0.827643204292045
17382,520416.009,5340026.543,200,62,138,15.23,1,2006,2,139,316,186,0.803528852580539,92.3,18.2626373626374,47,1298.81807301385,0.827643204292045
17382,520416.009,5340026.543,162,83,79,31.155,0,2007,2,116,294,168,0.847988630775166,332.6,16.5076923076923,52,1298.81807301385,0.827643204292045
17382,520416.009,5340026.543,167,57,110,8.084,0,2008,2,142,291,194,0.827948728113923,50.1,16.9747252747253,52,1298.81807301385,0.827643204292045
17382,520416.009,5340026.543,188,60,128,24.85,0,2009,2,121,286,218,0.785653641049775,55,17.8153846153846,97,1298.81807301385,0.827643204292045
17382,520416.009,5340026.543,192,71,121,12.207,0,2010,4,138,285,192,0.857930095629393,133.1,17.7351648351648,54,1298.81807301385,0.827643204292045
17382,520416.009,5340026.543,159,58,101,24.549,0,2011,2,111,307,162,0.861203427554313,136.1,17.0351648351648,51,1298.81807301385,0.827643204292045
17382,520416.009,5340026.543,186,79,107,24.307,0,2012,2,128,289,185,0.838432193568333,88.9,18.4296703296703,57,1298.81807301385,0.827643204292045
17382,520416.009,5340026.543,200,52,148,15.659,1,2013,2,139,289,202,0.852978833237357,-156.9,18.6175824175824,63,1298.81807301385,0.827643204292045
17382,520416.009,5340026.543,182,44,138,20.578,0,2014,2,129,309,185,0.826194182597009,191.6,17.4516483516484,56,1298.81807301385,0.827643204292045
17382,520416.009,5340026.543,181,93,88,22.759,0,2015,2,127,295,185,0.801792433605831,-154.6,20.4153846153846,58,1298.81807301385,0.827643204292045
17382,520416.009,5340026.543,185,160,25,14.438,0,2016,1,140,297,192,0.88194026270231,50.9,18.5681318681319,52,1298.81807301385,0.827643204292045
17382,520416.009,5340026.543,158,134,24,23.411,0,2017,1,126,286,178,0.839028736180679,-2.3,19.1582417582418,52,1298.81807301385,0.827643204292045
17382,520416.009,5340026.543,175,55,120,31.681,0,2018,2,114,295,169,0.855243553622127,-151.3,19.9417582417582,55,1298.81807301385,0.827643204292045
17382,520416.009,5340026.543,188,103,85,17.884,0,2019,1,133,296,178,0.820330775163024,-73.4,20.0571428571429,45,1298.81807301385,0.827643204292045
17382,520416.009,5340026.543,156,68,88,17.219,1,2020,2,127,289,193,0.815120006271074,-13.6,18.3758241758242,66,1298.81807301385,0.827643204292045
17383,520416.009,5339794.886,0,0,0,22.242,0,2001,3,129,288,193,0.853419798886093,116.8,17.4,64,1326.42615831113,0.0637616851175913
17383,520416.009,5339794.886,166,65,101,12.695,0,2002,3,138,289,225,0.824906546074634,52.7,17.567032967033,87,1326.42615831113,0.0637616851175913
17383,520416.009,5339794.886,183,48,135,20.814,0,2003,2,129,287,177,0.832971142271501,-198,22.3252747252747,48,1326.42615831113,0.0637616851175913
17383,520416.009,5339794.886,172,121,51,12.85,0,2004,1,138,309,201,0.860405886774547,209.7,17.0835164835165,63,1326.42615831113,0.0637616851175913
17383,520416.009,5339794.886,181,103,78,19.829,0,2005,2,134,299,193,0.860161105333861,44.2,17.3054945054945,59,1326.42615831113,0.0637616851175913
17383,520416.009,5339794.886,192,62,130,25.077,1,2006,2,129,320,184,0.796886968225327,92.3,18.2626373626374,55,1326.42615831113,0.0637616851175913
17383,520416.009,5339794.886,161,83,78,30.562,0,2007,2,117,290,185,0.854997682210824,332.6,16.5076923076923,68,1326.42615831113,0.0637616851175913
17383,520416.009,5339794.886,165,57,108,8.084,0,2008,3,142,290,202,0.858124023647218,50.1,16.9747252747253,60,1326.42615831113,0.0637616851175913
17383,520416.009,5339794.886,189,59,130,22.397,0,2009,4,124,285,186,0.879301054678447,55,17.8153846153846,62,1326.42615831113,0.0637616851175913
17383,520416.009,5339794.886,186,74,112,10.448,0,2010,3,140,280,194,0.869245766036173,133.1,17.7351648351648,54,1326.42615831113,0.0637616851175913
17383,520416.009,5339794.886,159,60,99,21.897,0,2011,3,115,305,184,0.823205194538564,136.1,17.0351648351648,69,1326.42615831113,0.0637616851175913
17383,520416.009,5339794.886,185,79,106,24.307,0,2012,2,128,288,184,0.839677303594875,88.9,18.4296703296703,56,1326.42615831113,0.0637616851175913
17383,520416.009,5339794.886,200,49,151,15.659,1,2013,2,139,287,201,0.852748045175566,-156.9,18.6175824175824,62,1326.42615831113,0.0637616851175913
17383,520416.009,5339794.886,182,44,138,21.382,0,2014,2,128,313,178,0.827657908753578,191.6,17.4516483516484,50,1326.42615831113,0.0637616851175913
17383,520416.009,5339794.886,180,93,87,27.527,0,2015,1,123,295,177,0.851883862578277,-154.6,20.4153846153846,54,1326.42615831113,0.0637616851175913
17383,520416.009,5339794.886,185,161,24,12.401,0,2016,1,142,298,192,0.884663213731402,50.9,18.5681318681319,50,1326.42615831113,0.0637616851175913
17383,520416.009,5339794.886,157,130,27,21.68,0,2017,1,128,281,177,0.841463240998976,-2.3,19.1582417582418,49,1326.42615831113,0.0637616851175913
17383,520416.009,5339794.886,171,52,119,32.524,0,2018,2,113,300,169,0.868563452401202,-151.3,19.9417582417582,56,1326.42615831113,0.0637616851175913
17383,520416.009,5339794.886,187,101,86,18.946,0,2019,1,132,294,178,0.849173947253414,-73.4,20.0571428571429,46,1326.42615831113,0.0637616851175913
17383,520416.009,5339794.886,157,69,88,17.862,1,2020,2,126,293,193,0.816190464213149,-13.6,18.3758241758242,67,1326.42615831113,0.0637616851175913
17384,520416.009,5339563.23,0,0,0,55.554,0,2001,2,99,293,186,0.857598753758229,116.8,17.4,87,1307.82393529534,-1.48708615436282
17384,520416.009,5339563.23,93,78,15,25.202,0,2002,3,125,294,193,0.857784133781345,52.7,17.567032967033,68,1307.82393529534,-1.48708615436282
17384,520416.009,5339563.23,172,93,79,40.485,1,2003,2,106,294,193,0.819547946843089,-198,22.3252747252747,87,1307.82393529534,-1.48708615436282
17384,520416.009,5339563.23,173,57,116,12.85,0,2004,3,138,311,201,0.850937132780061,209.7,17.0835164835165,63,1307.82393529534,-1.48708615436282
17384,520416.009,5339563.23,141,93,48,27.16,0,2005,2,127,302,184,0.882588219639771,44.2,17.3054945054945,57,1307.82393529534,-1.48708615436282
17384,520416.009,5339563.23,188,59,129,15.23,1,2006,2,139,317,184,0.795622135946422,92.3,18.2626373626374,45,1307.82393529534,-1.48708615436282
17384,520416.009,5339563.23,147,94,53,37.96,0,2007,2,106,296,185,0.847825293778293,332.6,16.5076923076923,79,1307.82393529534,-1.48708615436282
17384,520416.009,5339563.23,148,93,55,16.416,0,2008,2,130,297,202,0.855349971263722,50.1,16.9747252747253,72,1307.82393529534,-1.48708615436282
17384,520416.009,5339563.23,185,59,126,24.85,0,2009,2,121,287,185,0.881907569538093,55,17.8153846153846,64,1307.82393529534,-1.48708615436282
17384,520416.009,5339563.23,180,108,72,14.913,0,2010,1,135,285,186,0.869983011330579,133.1,17.7351648351648,51,1307.82393529534,-1.48708615436282
17384,520416.009,5339563.23,143,53,90,24.549,0,2011,2,111,312,162,0.827948642220057,136.1,17.0351648351648,51,1307.82393529534,-1.48708615436282
17384,520416.009,5339563.23,165,124,41,32.403,0,2012,1,120,298,178,0.866831754256242,88.9,18.4296703296703,58,1307.82393529534,-1.48708615436282
17384,520416.009,5339563.23,182,71,111,14.64,1,2013,3,140,293,193,0.863512156055837,-156.9,18.6175824175824,53,1307.82393529534,-1.48708615436282
17384,520416.009,5339563.23,160,46,114,28.133,0,2014,2,119,320,176,0.831211748198464,191.6,17.4516483516484,57,1307.82393529534,-1.48708615436282
17384,520416.009,5339563.23,167,80,87,32.41,0,2015,3,118,293,185,0.871580831458823,-154.6,20.4153846153846,67,1307.82393529534,-1.48708615436282
17384,520416.009,5339563.23,187,93,94,19.418,0,2016,3,135,314,184,0.861264886643004,50.9,18.5681318681319,49,1307.82393529534,-1.48708615436282
17384,520416.009,5339563.23,152,93,59,33.563,3,2017,1,113,284,169,0.839508657130141,-2.3,19.1582417582418,56,1307.82393529534,-1.48708615436282
17384,520416.009,5339563.23,175,47,128,35.087,0,2018,2,110,302,170,0.854319649338939,-151.3,19.9417582417582,60,1307.82393529534,-1.48708615436282
17384,520416.009,5339563.23,164,78,86,21.056,0,2019,3,130,296,208,0.844680629640638,-73.4,20.0571428571429,78,1307.82393529534,-1.48708615436282
17384,520416.009,5339563.23,98,93,5,21.659,1,2020,2,120,298,193,0.755462121201825,-13.6,18.3758241758242,73,1307.82393529534,-1.48708615436282
17404,520416.009,5334930.103,86,83,3,47.294,6,2001,1,106,308,184,0.85541797705738,116.8,17.4,78,1229.10323635795,-1.30940937971484
17404,520416.009,5334930.103,86,65,21,27.175,0,2002,1,123,292,232,0.833592570126654,52.7,17.567032967033,109,1229.10323635795,-1.30940937971484
17404,520416.009,5334930.103,173,59,114,28.806,0,2003,2,120,324,161,0.813072860493244,-198,22.3252747252747,41,1229.10323635795,-1.30940937971484
17404,520416.009,5334930.103,154,39,115,32.485,0,2004,3,117,332,193,0.814790347046513,209.7,17.0835164835165,76,1229.10323635795,-1.30940937971484
17404,520416.009,5334930.103,162,93,69,35.225,0,2005,2,119,310,201,0.812022295993379,44.2,17.3054945054945,82,1229.10323635795,-1.30940937971484
17404,520416.009,5334930.103,189,57,132,26.901,1,2006,3,127,325,186,0.803503758398732,92.3,18.2626373626374,59,1229.10323635795,-1.30940937971484
17404,520416.009,5334930.103,0,0,0,43.851,0,2007,0,99,295,161,0.825529407262903,332.6,16.5076923076923,62,1229.10323635795,-1.30940937971484
17404,520416.009,5334930.103,186,84,102,18.046,0,2008,3,128,298,185,0.845376926108592,50.1,16.9747252747253,57,1229.10323635795,-1.30940937971484
17404,520416.009,5334930.103,176,58,118,41.687,0,2009,3,103,296,240,0.815099624520491,55,17.8153846153846,137,1229.10323635795,-1.30940937971484
17404,520416.009,5334930.103,173,69,104,20.929,0,2010,2,128,291,186,0.840936983020628,133.1,17.7351648351648,58,1229.10323635795,-1.30940937971484
17404,520416.009,5334930.103,86,51,35,28.941,0,2011,1,105,313,209,0.824725198390847,136.1,17.0351648351648,104,1229.10323635795,-1.30940937971484
17404,520416.009,5334930.103,169,81,88,33.433,0,2012,2,119,305,217,0.811723028772089,88.9,18.4296703296703,98,1229.10323635795,-1.30940937971484
17404,520416.009,5334930.103,181,61,120,21.747,1,2013,3,133,290,194,0.851619022698638,-156.9,18.6175824175824,61,1229.10323635795,-1.30940937971484
17404,520416.009,5334930.103,163,41,122,34.27,1,2014,2,109,325,178,0.845711374635011,191.6,17.4516483516484,69,1229.10323635795,-1.30940937971484
17404,520416.009,5334930.103,168,96,72,32.41,0,2015,1,118,331,184,0.835779844144902,-154.6,20.4153846153846,66,1229.10323635795,-1.30940937971484
17404,520416.009,5334930.103,187,108,79,10.453,0,2016,1,144,327,194,0.833333570589665,50.9,18.5681318681319,50,1229.10323635795,-1.30940937971484
17404,520416.009,5334930.103,150,94,56,33.563,3,2017,1,113,295,177,0.83081397621853,-2.3,19.1582417582418,64,1229.10323635795,-1.30940937971484
17404,520416.009,5334930.103,167,61,106,29.133,0,2018,2,117,306,184,0.854916108958981,-151.3,19.9417582417582,67,1229.10323635795,-1.30940937971484
17404,520416.009,5334930.103,171,97,74,31.151,4,2019,1,119,315,177,0.828950074586884,-73.4,20.0571428571429,58,1229.10323635795,-1.30940937971484
17404,520416.009,5334930.103,143,93,50,26.608,1,2020,2,111,310,193,0.804206478844776,-13.6,18.3758241758242,82,1229.10323635795,-1.30940937971484
17406,520416.009,5334466.79,86,83,3,39.272,1,2001,2,113,298,178,0.850668402525756,103.5,18.1120879120879,65,1255.27679874136,0.392187423596598
17406,520416.009,5334466.79,142,68,74,27.076,0,2002,3,123,291,184,0.850980562000347,46.4,18.2428571428571,61,1255.27679874136,0.392187423596598
17406,520416.009,5334466.79,168,57,111,26.541,0,2003,2,122,326,161,0.780219155270505,-203.8,22.9692307692308,39,1255.27679874136,0.392187423596598
17406,520416.009,5334466.79,154,93,61,18.935,0,2004,2,132,329,185,0.836490454635645,196.1,17.7461538461538,53,1255.27679874136,0.392187423596598
17406,520416.009,5334466.79,162,109,53,32.068,0,2005,1,122,308,177,0.849753362627648,38.9,17.9032967032967,55,1255.27679874136,0.392187423596598
17406,520416.009,5334466.79,195,55,140,20.962,0,2006,3,133,330,186,0.832043091275773,82.6,18.867032967033,53,1255.27679874136,0.392187423596598
17406,520416.009,5334466.79,93,93,0,36.897,0,2007,2,107,296,184,0.85017714739531,317.9,17.0824175824176,77,1255.27679874136,0.392187423596598
17406,520416.009,5334466.79,86,49,37,17.249,0,2008,1,129,293,184,0.889656778019472,40.8,17.6131868131868,55,1255.27679874136,0.392187423596598
17406,520416.009,5334466.79,180,58,122,29.472,0,2009,2,115,306,177,0.884618885645054,41,18.5230769230769,62,1255.27679874136,0.392187423596598
17406,520416.009,5334466.79,173,77,96,17.087,0,2010,3,133,301,192,0.855667804118276,122,18.3626373626374,59,1255.27679874136,0.392187423596598
17406,520416.009,5334466.79,137,97,40,29.819,0,2011,2,105,317,186,0.832840693903316,127.1,17.5,81,1255.27679874136,0.392187423596598
17406,520416.009,5334466.79,179,81,98,26.282,0,2012,3,126,313,225,0.826808246053379,82.8,18.7043956043956,99,1255.27679874136,0.392187423596598
17406,520416.009,5334466.79,179,93,86,21.732,0,2013,2,133,299,193,0.861778280961662,-163.1,19.2582417582418,60,1255.27679874136,0.392187423596598
17406,520416.009,5334466.79,157,46,111,31.519,0,2014,2,113,317,177,0.848196871644889,176.9,17.856043956044,64,1255.27679874136,0.392187423596598
17406,520416.009,5334466.79,161,93,68,44.529,0,2015,2,104,332,185,0.847894720479402,-158.6,20.9142857142857,81,1255.27679874136,0.392187423596598
17406,520416.009,5334466.79,174,94,80,33.772,0,2016,2,121,321,208,0.897526416683531,45.5,18.8857142857143,87,1255.27679874136,0.392187423596598
17406,520416.009,5334466.79,154,93,61,27.946,0,2017,1,120,307,178,0.848805190385488,-10.8,19.7879120879121,58,1255.27679874136,0.392187423596598
17406,520416.009,5334466.79,172,60,112,28.724,0,2018,3,118,309,185,0.868974575213363,-154,20.578021978022,67,1255.27679874136,0.392187423596598
17406,520416.009,5334466.79,165,93,72,16.645,0,2019,2,134,315,185,0.850825680336665,-79.8,20.6626373626374,51,1255.27679874136,0.392187423596598
17406,520416.009,5334466.79,93,93,0,24.187,1,2020,2,115,315,192,0.810139344164698,-19.2,19.0648351648352,77,1255.27679874136,0.392187423596598
17407,520416.009,5334235.134,86,83,3,37.114,0,2001,1,115,304,177,0.840712186976667,103.5,18.1120879120879,62,1240.09571489277,0.257255771317273
17407,520416.009,5334235.134,141,72,69,28.89,0,2002,2,121,292,178,0.84558397282579,46.4,18.2428571428571,57,1240.09571489277,0.257255771317273
17407,520416.009,5334235.134,164,58,106,29.244,0,2003,2,119,327,154,0.798788417151584,-203.8,22.9692307692308,35,1240.09571489277,0.257255771317273
17407,520416.009,5334235.134,151,94,57,34.798,0,2004,2,115,332,184,0.8347175531358,196.1,17.7461538461538,69,1240.09571489277,0.257255771317273
17407,520416.009,5334235.134,162,103,59,37.383,0,2005,1,117,306,177,0.86922006695719,38.9,17.9032967032967,60,1240.09571489277,0.257255771317273
17407,520416.009,5334235.134,191,55,136,39.986,1,2006,3,115,334,201,0.839367297050352,82.6,18.867032967033,86,1240.09571489277,0.257255771317273
17407,520416.009,5334235.134,93,93,0,45.373,0,2007,2,97,295,193,0.844502378153433,317.9,17.0824175824176,96,1240.09571489277,0.257255771317273
17407,520416.009,5334235.134,86,49,37,23.631,0,2008,1,122,295,184,0.884408699632497,40.8,17.6131868131868,62,1240.09571489277,0.257255771317273
17407,520416.009,5334235.134,174,58,116,59.975,1,2009,2,88,306,170,0.885815182210927,41,18.5230769230769,82,1240.09571489277,0.257255771317273
17407,520416.009,5334235.134,170,77,93,22.432,0,2010,3,127,295,192,0.848195380268771,122,18.3626373626374,65,1240.09571489277,0.257255771317273
17407,520416.009,5334235.134,133,93,40,35.725,1,2011,1,98,322,178,0.83754516466473,127.1,17.5,80,1240.09571489277,0.257255771317273
17407,520416.009,5334235.134,175,82,93,33.376,0,2012,2,119,320,168,0.822714715036576,82.8,18.7043956043956,49,1240.09571489277,0.257255771317273
17407,520416.009,5334235.134,180,93,87,23.773,0,2013,2,131,298,192,0.83679310456547,-163.1,19.2582417582418,61,1240.09571489277,0.257255771317273
17407,520416.009,5334235.134,153,44,109,33.407,0,2014,2,110,316,170,0.845602128278177,176.9,17.856043956044,60,1240.09571489277,0.257255771317273
17407,520416.009,5334235.134,166,94,72,40.878,0,2015,2,108,332,185,0.831687744681647,-158.6,20.9142857142857,77,1240.09571489277,0.257255771317273
17407,520416.009,5334235.134,181,93,88,23.252,0,2016,2,131,332,202,0.894948297545638,45.5,18.8857142857143,71,1240.09571489277,0.257255771317273
17407,520416.009,5334235.134,153,106,47,33.279,3,2017,1,113,310,178,0.851759616366809,-10.8,19.7879120879121,65,1240.09571489277,0.257255771317273
17407,520416.009,5334235.134,167,61,106,30.481,0,2018,2,116,310,177,0.867271464914697,-154,20.578021978022,61,1240.09571489277,0.257255771317273
17407,520416.009,5334235.134,162,93,69,23.635,1,2019,1,127,330,178,0.856715877769088,-79.8,20.6626373626374,51,1240.09571489277,0.257255771317273
17407,520416.009,5334235.134,93,93,0,30.369,3,2020,2,105,317,185,0.792553109846002,-19.2,19.0648351648352,80,1240.09571489277,0.257255771317273
17408,520416.009,5334003.477,86,83,3,40.363,2,2001,2,112,302,226,0.841081500764396,103.5,18.1120879120879,114,1212.86266568357,1.45114565067492
17408,520416.009,5334003.477,93,77,16,35.766,0,2002,3,113,292,184,0.84242097385657,46.4,18.2428571428571,71,1212.86266568357,1.45114565067492
17408,520416.009,5334003.477,163,93,70,32.562,0,2003,1,115,326,162,0.828722096978182,-203.8,22.9692307692308,47,1212.86266568357,1.45114565067492
17408,520416.009,5334003.477,167,95,72,29.278,0,2004,1,121,333,184,0.844149148861615,196.1,17.7461538461538,63,1212.86266568357,1.45114565067492
17408,520416.009,5334003.477,0,0,0,41.8,0,2005,0,113,310,177,0.883723938160563,38.9,17.9032967032967,64,1212.86266568357,1.45114565067492
17408,520416.009,5334003.477,186,66,120,34.152,1,2006,2,120,334,208,0.854283426578818,82.6,18.867032967033,88,1212.86266568357,1.45114565067492
17408,520416.009,5334003.477,0,0,0,58.819,0,2007,0,84,289,194,0.85423000265136,317.9,17.0824175824176,110,1212.86266568357,1.45114565067492
17408,520416.009,5334003.477,86,54,32,26.701,0,2008,1,119,299,225,0.868276086937275,40.8,17.6131868131868,106,1212.86266568357,1.45114565067492
17408,520416.009,5334003.477,172,65,107,34.271,0,2009,2,110,306,153,0.847689261376338,41,18.5230769230769,43,1212.86266568357,1.45114565067492
17408,520416.009,5334003.477,167,95,72,25.687,0,2010,2,123,300,194,0.85814381136691,122,18.3626373626374,71,1212.86266568357,1.45114565067492
17408,520416.009,5334003.477,125,60,65,39.54,1,2011,2,94,321,161,0.834549530177453,127.1,17.5,67,1212.86266568357,1.45114565067492
17408,520416.009,5334003.477,154,93,61,40.85,0,2012,1,112,314,170,0.895964516097314,82.8,18.7043956043956,58,1212.86266568357,1.45114565067492
17408,520416.009,5334003.477,176,97,79,34.654,0,2013,2,121,293,186,0.84436312912954,-163.1,19.2582417582418,65,1212.86266568357,1.45114565067492
17408,520416.009,5334003.477,156,45,111,40.828,3,2014,3,99,319,169,0.832979014867902,176.9,17.856043956044,70,1212.86266568357,1.45114565067492
17408,520416.009,5334003.477,168,80,88,37.296,0,2015,3,112,339,186,0.862528986273401,-158.6,20.9142857142857,74,1212.86266568357,1.45114565067492
17408,520416.009,5334003.477,178,96,82,36.982,3,2016,2,118,334,202,0.864107346684054,45.5,18.8857142857143,84,1212.86266568357,1.45114565067492
17408,520416.009,5334003.477,146,104,42,29.541,1,2017,1,118,311,177,0.863134047285591,-10.8,19.7879120879121,59,1212.86266568357,1.45114565067492
17408,520416.009,5334003.477,93,74,19,44.447,0,2018,2,102,313,178,0.872956114084367,-154,20.578021978022,76,1212.86266568357,1.45114565067492
17408,520416.009,5334003.477,147,93,54,30.808,4,2019,1,119,333,177,0.86444426805085,-79.8,20.6626373626374,58,1212.86266568357,1.45114565067492
17408,520416.009,5334003.477,0,0,0,125.069,0,2020,0,16,285,185,0.812065437504844,-19.2,19.0648351648352,169,1212.86266568357,1.45114565067492
17409,520416.009,5333771.821,86,84,2,43.705,5,2001,2,109,298,225,0.834888703731184,103.5,18.1120879120879,116,1194.17415364809,1.03274433596487
17409,520416.009,5333771.821,86,75,11,35.766,0,2002,1,113,292,178,0.854328857307829,46.4,18.2428571428571,65,1194.17415364809,1.03274433596487
17409,520416.009,5333771.821,160,93,67,36.828,0,2003,1,110,325,161,0.828002806370338,-203.8,22.9692307692308,51,1194.17415364809,1.03274433596487
17409,520416.009,5333771.821,161,93,68,31.965,0,2004,2,118,330,185,0.857708842512982,196.1,17.7461538461538,67,1194.17415364809,1.03274433596487
17409,520416.009,5333771.821,0,0,0,47.472,0,2005,0,108,309,177,0.897033689061317,38.9,17.9032967032967,69,1194.17415364809,1.03274433596487
17409,520416.009,5333771.821,186,66,120,34.152,1,2006,3,120,336,217,0.868198703747169,82.6,18.867032967033,97,1194.17415364809,1.03274433596487
17409,520416.009,5333771.821,0,0,0,48.311,0,2007,0,94,294,193,0.858695858866189,317.9,17.0824175824176,99,1194.17415364809,1.03274433596487
17409,520416.009,5333771.821,86,57,29,24.635,0,2008,1,121,300,225,0.870299896226652,40.8,17.6131868131868,104,1194.17415364809,1.03274433596487
17409,520416.009,5333771.821,172,65,107,33.246,0,2009,3,111,321,225,0.838056571650085,41,18.5230769230769,114,1194.17415364809,1.03274433596487
17409,520416.009,5333771.821,167,93,74,28.975,0,2010,2,119,302,185,0.8707493598904,122,18.3626373626374,66,1194.17415364809,1.03274433596487
17409,520416.009,5333771.821,127,63,64,39.54,1,2011,3,94,319,168,0.859057459142738,127.1,17.5,74,1194.17415364809,1.03274433596487
17409,520416.009,5333771.821,153,93,60,45.365,1,2012,1,107,314,170,0.883554140804076,82.8,18.7043956043956,63,1194.17415364809,1.03274433596487
17409,520416.009,5333771.821,179,93,86,34.654,0,2013,2,121,295,193,0.856815866923691,-163.1,19.2582417582418,72,1194.17415364809,1.03274433596487
17409,520416.009,5333771.821,162,46,116,38.673,3,2014,3,102,317,170,0.843969556885409,176.9,17.856043956044,68,1194.17415364809,1.03274433596487
17409,520416.009,5333771.821,169,80,89,37.296,0,2015,3,112,333,217,0.886157201013072,-158.6,20.9142857142857,105,1194.17415364809,1.03274433596487
17409,520416.009,5333771.821,176,95,81,40.162,6,2016,2,115,333,201,0.870189182205314,45.5,18.8857142857143,86,1194.17415364809,1.03274433596487
17409,520416.009,5333771.821,145,100,45,42.347,7,2017,2,101,320,225,0.880389699905851,-10.8,19.7879120879121,124,1194.17415364809,1.03274433596487
17409,520416.009,5333771.821,93,78,15,45.588,0,2018,2,101,337,176,0.876780315452791,-154,20.578021978022,75,1194.17415364809,1.03274433596487
17409,520416.009,5333771.821,151,93,58,34.292,4,2019,2,115,327,185,0.877693166906587,-79.8,20.6626373626374,70,1194.17415364809,1.03274433596487
17409,520416.009,5333771.821,135,94,41,44.202,9,2020,2,88,316,217,0.836826688568228,-19.2,19.0648351648352,129,1194.17415364809,1.03274433596487
17597,520647.665,5340953.168,86,86,0,43.824,5,2001,2,109,293,176,0.859123695879176,116.8,17.4,67,1261.62909321465,0.625821954170689
17597,520647.665,5340953.168,162,58,104,31.477,0,2002,2,118,320,162,0.785772390591799,52.7,17.567032967033,44,1261.62909321465,0.625821954170689
17597,520647.665,5340953.168,174,70,104,38.746,1,2003,2,108,295,154,0.813994078484328,-198,22.3252747252747,46,1261.62909321465,0.625821954170689
17597,520647.665,5340953.168,186,55,131,21.105,0,2004,2,130,306,177,0.831871458398643,209.7,17.0835164835165,47,1261.62909321465,0.625821954170689
17597,520647.665,5340953.168,174,85,89,34.166,0,2005,2,120,311,169,0.830282869026651,44.2,17.3054945054945,49,1261.62909321465,0.625821954170689
17597,520647.665,5340953.168,198,68,130,28.664,1,2006,2,125,323,176,0.805432198419607,92.3,18.2626373626374,51,1261.62909321465,0.625821954170689
17597,520647.665,5340953.168,161,114,47,38.738,0,2007,1,105,302,169,0.823423731018702,332.6,16.5076923076923,64,1261.62909321465,0.625821954170689
17597,520647.665,5340953.168,177,55,122,28.83,0,2008,2,117,295,184,0.814074653743707,50.1,16.9747252747253,67,1261.62909321465,0.625821954170689
17597,520647.665,5340953.168,190,66,124,28.202,0,2009,3,117,287,169,0.877081668060301,55,17.8153846153846,52,1261.62909321465,0.625821954170689
17597,520647.665,5340953.168,188,70,118,23.912,0,2010,2,124,300,169,0.789611518367007,133.1,17.7351648351648,45,1261.62909321465,0.625821954170689
17597,520647.665,5340953.168,148,61,87,37.229,1,2011,2,95,313,152,0.835884807947549,136.1,17.0351648351648,57,1261.62909321465,0.625821954170689
17597,520647.665,5340953.168,170,93,77,36.732,0,2012,1,116,305,170,0.836235357315688,88.9,18.4296703296703,54,1261.62909321465,0.625821954170689
17597,520647.665,5340953.168,205,63,142,17.728,1,2013,3,137,297,186,0.839726960219674,-156.9,18.6175824175824,49,1261.62909321465,0.625821954170689
17597,520647.665,5340953.168,170,43,127,31.174,0,2014,3,114,324,169,0.796793853824399,191.6,17.4516483516484,55,1261.62909321465,0.625821954170689
17597,520647.665,5340953.168,176,93,83,50.525,0,2015,1,98,321,161,0.823555142936858,-154.6,20.4153846153846,63,1261.62909321465,0.625821954170689
17597,520647.665,5340953.168,193,163,30,17.425,0,2016,1,137,314,209,0.813984652248559,50.9,18.5681318681319,72,1261.62909321465,0.625821954170689
17597,520647.665,5340953.168,156,129,27,32.826,3,2017,1,114,297,162,0.830690065427914,-2.3,19.1582417582418,48,1261.62909321465,0.625821954170689
17597,520647.665,5340953.168,169,56,113,38.911,0,2018,2,106,300,152,0.800998708106729,-151.3,19.9417582417582,46,1261.62909321465,0.625821954170689
17597,520647.665,5340953.168,182,93,89,25.763,3,2019,2,125,297,169,0.83259927852989,-73.4,20.0571428571429,44,1261.62909321465,0.625821954170689
17597,520647.665,5340953.168,155,73,82,24.854,1,2020,2,114,299,170,0.80219452169631,-13.6,18.3758241758242,56,1261.62909321465,0.625821954170689
17599,520647.665,5340489.855,93,93,0,27.333,0,2001,4,124,309,186,0.84904857065442,116.8,17.4,62,1252.83783602155,-1.50358125513558
17599,520647.665,5340489.855,165,78,87,23.157,0,2002,2,127,308,184,0.854335184160691,52.7,17.567032967033,57,1252.83783602155,-1.50358125513558
17599,520647.665,5340489.855,181,65,116,31.289,0,2003,3,117,294,162,0.841123977267606,-198,22.3252747252747,45,1252.83783602155,-1.50358125513558
17599,520647.665,5340489.855,189,39,150,17.848,0,2004,2,133,301,169,0.837870656145953,209.7,17.0835164835165,36,1252.83783602155,-1.50358125513558
17599,520647.665,5340489.855,169,93,76,28.191,0,2005,1,126,305,178,0.885538230179296,44.2,17.3054945054945,52,1252.83783602155,-1.50358125513558
17599,520647.665,5340489.855,202,63,139,20.092,1,2006,4,134,318,184,0.829498622390394,92.3,18.2626373626374,50,1252.83783602155,-1.50358125513558
17599,520647.665,5340489.855,156,93,63,51.795,1,2007,2,91,298,177,0.870162022797628,332.6,16.5076923076923,86,1252.83783602155,-1.50358125513558
17599,520647.665,5340489.855,181,54,127,1.514,0,2008,3,154,294,193,0.743599016812455,50.1,16.9747252747253,39,1252.83783602155,-1.50358125513558
17599,520647.665,5340489.855,182,63,119,51.68,0,2009,2,95,278,169,0.860784741237249,55,17.8153846153846,74,1252.83783602155,-1.50358125513558
17599,520647.665,5340489.855,183,71,112,23.195,0,2010,2,125,297,217,0.833644678702224,133.1,17.7351648351648,92,1252.83783602155,-1.50358125513558
17599,520647.665,5340489.855,158,111,47,27.418,0,2011,2,107,314,225,0.809397208386259,136.1,17.0351648351648,118,1252.83783602155,-1.50358125513558
17599,520647.665,5340489.855,181,80,101,33.433,0,2012,2,119,305,170,0.884450465941358,88.9,18.4296703296703,51,1252.83783602155,-1.50358125513558
17599,520647.665,5340489.855,207,62,145,15.659,1,2013,4,139,300,209,0.859486763411632,-156.9,18.6175824175824,70,1252.83783602155,-1.50358125513558
17599,520647.665,5340489.855,179,45,134,28.765,0,2014,2,118,318,185,0.841108459807769,191.6,17.4516483516484,67,1252.83783602155,-1.50358125513558
17599,520647.665,5340489.855,175,128,47,40.807,0,2015,1,108,323,162,0.855198278414432,-154.6,20.4153846153846,54,1252.83783602155,-1.50358125513558
17599,520647.665,5340489.855,194,93,101,13.41,0,2016,3,141,309,192,0.867688857225356,50.9,18.5681318681319,51,1252.83783602155,-1.50358125513558
17599,520647.665,5340489.855,155,112,43,23.411,0,2017,1,126,286,169,0.840894789678727,-2.3,19.1582417582418,43,1252.83783602155,-1.50358125513558
17599,520647.665,5340489.855,169,51,118,32.524,0,2018,2,113,296,186,0.784040688662527,-151.3,19.9417582417582,73,1252.83783602155,-1.50358125513558
17599,520647.665,5340489.855,179,93,86,23.027,0,2019,1,128,292,177,0.862919695929374,-73.4,20.0571428571429,49,1252.83783602155,-1.50358125513558
17599,520647.665,5340489.855,154,79,75,23.757,1,2020,3,116,296,192,0.807073325799794,-13.6,18.3758241758242,76,1252.83783602155,-1.50358125513558
17600,520647.665,5340258.199,93,93,0,23.243,0,2001,3,128,306,186,0.805600346091542,116.8,17.4,58,1302.8636879522,1.01116265288604
17600,520647.665,5340258.199,163,75,88,21.191,0,2002,3,129,309,185,0.857710731532657,52.7,17.567032967033,56,1302.8636879522,1.01116265288604
17600,520647.665,5340258.199,174,65,109,39.604,1,2003,2,107,289,168,0.828885137881376,-198,22.3252747252747,61,1302.8636879522,1.01116265288604
17600,520647.665,5340258.199,188,36,152,13.797,0,2004,2,137,303,177,0.83982547712905,209.7,17.0835164835165,40,1302.8636879522,1.01116265288604
17600,520647.665,5340258.199,170,100,70,24.974,0,2005,1,129,314,177,0.814742346397335,44.2,17.3054945054945,48,1302.8636879522,1.01116265288604
17600,520647.665,5340258.199,197,66,131,25.077,1,2006,2,129,317,177,0.808654859617002,92.3,18.2626373626374,48,1302.8636879522,1.01116265288604
17600,520647.665,5340258.199,166,93,73,33.684,0,2007,2,112,297,169,0.870577589197426,332.6,16.5076923076923,57,1302.8636879522,1.01116265288604
17600,520647.665,5340258.199,182,54,128,11.3,0,2008,3,167,288,232,0.793805773943246,50.1,16.9747252747253,65,1302.8636879522,1.01116265288604
17600,520647.665,5340258.199,193,64,129,21.587,0,2009,2,125,277,177,0.88604357839877,55,17.8153846153846,52,1302.8636879522,1.01116265288604
17600,520647.665,5340258.199,186,70,116,16.748,0,2010,2,133,290,202,0.7876226342751,133.1,17.7351648351648,69,1302.8636879522,1.01116265288604
17600,520647.665,5340258.199,153,93,60,29.721,0,2011,1,104,316,162,0.81025900768672,136.1,17.0351648351648,58,1302.8636879522,1.01116265288604
17600,520647.665,5340258.199,180,81,99,30.389,0,2012,2,122,298,177,0.879959212942814,88.9,18.4296703296703,55,1302.8636879522,1.01116265288604
17600,520647.665,5340258.199,201,64,137,22.774,1,2013,2,132,288,216,0.852198522036576,-156.9,18.6175824175824,84,1302.8636879522,1.01116265288604
17600,520647.665,5340258.199,178,38,140,26.087,0,2014,2,122,316,186,0.81880816766219,191.6,17.4516483516484,64,1302.8636879522,1.01116265288604
17600,520647.665,5340258.199,177,131,46,33.252,0,2015,1,117,289,170,0.81784289727888,-154.6,20.4153846153846,53,1302.8636879522,1.01116265288604
17600,520647.665,5340258.199,196,175,21,16.42,0,2016,1,138,305,192,0.86715407606131,50.9,18.5681318681319,54,1302.8636879522,1.01116265288604
17600,520647.665,5340258.199,156,117,39,24.229,0,2017,1,125,285,170,0.834057699522589,-2.3,19.1582417582418,45,1302.8636879522,1.01116265288604
17600,520647.665,5340258.199,177,51,126,26.655,0,2018,2,120,292,193,0.778217069615509,-151.3,19.9417582417582,73,1302.8636879522,1.01116265288604
17600,520647.665,5340258.199,185,155,30,18.946,0,2019,1,132,290,178,0.835562471387908,-73.4,20.0571428571429,46,1302.8636879522,1.01116265288604
17600,520647.665,5340258.199,153,79,74,19.829,1,2020,3,123,292,192,0.816137265486433,-13.6,18.3758241758242,69,1302.8636879522,1.01116265288604
17601,520647.665,5340026.543,0,0,0,25.299,0,2001,3,126,289,178,0.828997002200601,116.8,17.4,52,1325.84345800058,0.980604220188587
17601,520647.665,5340026.543,166,65,101,11.812,0,2002,2,139,293,193,0.810664556374991,52.7,17.567032967033,54,1325.84345800058,0.980604220188587
17601,520647.665,5340026.543,181,50,131,25.099,0,2003,2,124,286,169,0.819253584619489,-198,22.3252747252747,45,1325.84345800058,0.980604220188587
17601,520647.665,5340026.543,170,118,52,9.362,0,2004,1,142,305,201,0.833782796722423,209.7,17.0835164835165,59,1325.84345800058,0.980604220188587
17601,520647.665,5340026.543,176,93,83,21.82,0,2005,2,132,302,185,0.837144325404329,44.2,17.3054945054945,53,1325.84345800058,0.980604220188587
17601,520647.665,5340026.543,200,62,138,18.152,1,2006,2,136,314,184,0.813420247645633,92.3,18.2626373626374,48,1325.84345800058,0.980604220188587
17601,520647.665,5340026.543,160,83,77,30.562,0,2007,2,117,293,170,0.869521066455852,332.6,16.5076923076923,53,1325.84345800058,0.980604220188587
17601,520647.665,5340026.543,166,57,109,8.758,0,2008,3,141,290,201,0.830332372053541,50.1,16.9747252747253,60,1325.84345800058,0.980604220188587
17601,520647.665,5340026.543,189,60,129,19.997,0,2009,2,127,284,218,0.795507689884311,55,17.8153846153846,91,1325.84345800058,0.980604220188587
17601,520647.665,5340026.543,187,72,115,8.706,0,2010,3,142,279,193,0.866798562693767,133.1,17.7351648351648,51,1325.84345800058,0.980604220188587
17601,520647.665,5340026.543,158,59,99,19.977,0,2011,3,118,310,186,0.781829523613526,136.1,17.0351648351648,68,1325.84345800058,0.980604220188587
17601,520647.665,5340026.543,186,79,107,23.303,0,2012,2,129,288,178,0.874119280011781,88.9,18.4296703296703,49,1325.84345800058,0.980604220188587
17601,520647.665,5340026.543,200,50,150,15.659,1,2013,2,139,288,201,0.861552672655327,-156.9,18.6175824175824,62,1325.84345800058,0.980604220188587
17601,520647.665,5340026.543,179,41,138,18.901,0,2014,3,131,309,185,0.839661023907735,191.6,17.4516483516484,54,1325.84345800058,0.980604220188587
17601,520647.665,5340026.543,188,93,95,19.599,0,2015,2,130,288,178,0.821390209073756,-154.6,20.4153846153846,48,1325.84345800058,0.980604220188587
17601,520647.665,5340026.543,184,158,26,16.42,0,2016,1,138,289,193,0.875833367332682,50.9,18.5681318681319,55,1325.84345800058,0.980604220188587
17601,520647.665,5340026.543,158,134,24,18.018,0,2017,1,132,284,184,0.843726442533755,-2.3,19.1582417582418,52,1325.84345800058,0.980604220188587
17601,520647.665,5340026.543,175,55,120,28.296,0,2018,2,118,293,170,0.862205823974791,-151.3,19.9417582417582,52,1325.84345800058,0.980604220188587
17601,520647.665,5340026.543,188,103,85,16.853,0,2019,1,134,291,184,0.812932182528483,-73.4,20.0571428571429,50,1325.84345800058,0.980604220188587
17601,520647.665,5340026.543,155,68,87,14.182,1,2020,2,132,287,194,0.827880950549154,-13.6,18.3758241758242,62,1325.84345800058,0.980604220188587
17602,520647.665,5339794.886,0,0,0,21.264,0,2001,3,130,287,194,0.847789958526215,116.8,17.4,64,1346.42617014237,0.864244770173855
17602,520647.665,5339794.886,166,65,101,11.812,0,2002,2,139,292,209,0.827632074668087,52.7,17.567032967033,70,1346.42617014237,0.864244770173855
17602,520647.665,5339794.886,181,50,131,20.814,0,2003,2,129,282,185,0.835567999218707,-198,22.3252747252747,56,1346.42617014237,0.864244770173855
17602,520647.665,5339794.886,171,120,51,6.012,0,2004,1,146,304,201,0.850981908202283,209.7,17.0835164835165,55,1346.42617014237,0.864244770173855
17602,520647.665,5339794.886,183,93,90,17.724,0,2005,2,136,297,193,0.854006882501994,44.2,17.3054945054945,57,1346.42617014237,0.864244770173855
17602,520647.665,5339794.886,196,61,135,21.061,1,2006,2,133,316,186,0.800762092271793,92.3,18.2626373626374,53,1346.42617014237,0.864244770173855
17602,520647.665,5339794.886,165,83,82,28.061,0,2007,4,121,290,185,0.857424142153435,332.6,16.5076923076923,64,1346.42617014237,0.864244770173855
17602,520647.665,5339794.886,166,54,112,8.758,0,2008,3,141,289,201,0.861516984782315,50.1,16.9747252747253,60,1346.42617014237,0.864244770173855
17602,520647.665,5339794.886,191,60,131,18.436,0,2009,2,129,287,186,0.861645740509223,55,17.8153846153846,57,1346.42617014237,0.864244770173855
17602,520647.665,5339794.886,186,73,113,14.002,0,2010,3,136,278,193,0.859741893919699,133.1,17.7351648351648,57,1346.42617014237,0.864244770173855
17602,520647.665,5339794.886,159,63,96,19.333,0,2011,3,119,304,192,0.808525048109178,136.1,17.0351648351648,73,1346.42617014237,0.864244770173855
17602,520647.665,5339794.886,187,79,108,22.313,0,2012,2,130,288,178,0.873626741539971,88.9,18.4296703296703,48,1346.42617014237,0.864244770173855
17602,520647.665,5339794.886,200,51,149,15.659,1,2013,2,139,288,194,0.852885995431653,-156.9,18.6175824175824,55,1346.42617014237,0.864244770173855
17602,520647.665,5339794.886,179,44,135,22.925,0,2014,3,126,316,184,0.831635560586537,191.6,17.4516483516484,58,1346.42617014237,0.864244770173855
17602,520647.665,5339794.886,184,120,64,22.759,0,2015,1,127,283,177,0.843458163643855,-154.6,20.4153846153846,50,1346.42617014237,0.864244770173855
17602,520647.665,5339794.886,185,161,24,13.41,0,2016,1,141,281,192,0.887427439356608,50.9,18.5681318681319,51,1346.42617014237,0.864244770173855
17602,520647.665,5339794.886,156,111,45,18.018,0,2017,1,132,283,185,0.843731002943539,-2.3,19.1582417582418,53,1346.42617014237,0.864244770173855
17602,520647.665,5339794.886,176,55,121,27.471,0,2018,2,119,289,169,0.877562467460522,-151.3,19.9417582417582,50,1346.42617014237,0.864244770173855
17602,520647.665,5339794.886,189,101,88,12.101,0,2019,1,139,292,185,0.821714891184774,-73.4,20.0571428571429,46,1346.42617014237,0.864244770173855
17602,520647.665,5339794.886,157,69,88,11.301,0,2020,2,136,288,194,0.832657794752554,-13.6,18.3758241758242,58,1346.42617014237,0.864244770173855
17603,520647.665,5339563.23,0,0,0,30.444,0,2001,2,121,290,186,0.860937597687525,116.8,17.4,65,1327.08415629432,0.484156292981579
17603,520647.665,5339563.23,93,77,16,18.313,0,2002,3,132,306,193,0.856135061333581,52.7,17.567032967033,61,1327.08415629432,0.484156292981579
17603,520647.665,5339563.23,183,93,90,24.203,0,2003,3,125,290,186,0.832081918546346,-198,22.3252747252747,61,1327.08415629432,0.484156292981579
17603,520647.665,5339563.23,174,57,117,11.049,0,2004,3,140,307,200,0.865479031981973,209.7,17.0835164835165,60,1327.08415629432,0.484156292981579
17603,520647.665,5339563.23,143,99,44,23.897,0,2005,1,130,304,185,0.883551723080804,44.2,17.3054945054945,55,1327.08415629432,0.484156292981579
17603,520647.665,5339563.23,193,61,132,13.128,1,2006,2,141,326,184,0.803247559137076,92.3,18.2626373626374,43,1327.08415629432,0.484156292981579
17603,520647.665,5339563.23,140,100,40,38.738,0,2007,1,105,297,185,0.855330559014945,332.6,16.5076923076923,80,1327.08415629432,0.484156292981579
17603,520647.665,5339563.23,150,93,57,12.778,0,2008,2,135,294,201,0.864594918964935,50.1,16.9747252747253,66,1327.08415629432,0.484156292981579
17603,520647.665,5339563.23,182,61,121,31.72,0,2009,3,113,284,192,0.881533196171821,55,17.8153846153846,79,1327.08415629432,0.484156292981579
17603,520647.665,5339563.23,176,83,93,14.913,0,2010,3,135,280,192,0.869913381876185,133.1,17.7351648351648,57,1327.08415629432,0.484156292981579
17603,520647.665,5339563.23,137,51,86,24.549,0,2011,2,111,312,168,0.839657690616816,136.1,17.0351648351648,57,1327.08415629432,0.484156292981579
17603,520647.665,5339563.23,167,137,30,21.301,0,2012,1,131,301,178,0.871465364590785,88.9,18.4296703296703,47,1327.08415629432,0.484156292981579
17603,520647.665,5339563.23,183,71,112,13.586,1,2013,3,141,285,192,0.862585163058777,-156.9,18.6175824175824,51,1327.08415629432,0.484156292981579
17603,520647.665,5339563.23,159,45,114,29.382,0,2014,4,117,316,192,0.862311022993348,191.6,17.4516483516484,75,1327.08415629432,0.484156292981579
17603,520647.665,5339563.23,168,80,88,32.41,0,2015,2,118,294,177,0.870228761543745,-154.6,20.4153846153846,59,1327.08415629432,0.484156292981579
17603,520647.665,5339563.23,186,165,21,22.382,0,2016,1,132,307,185,0.883242789685854,50.9,18.5681318681319,53,1327.08415629432,0.484156292981579
17603,520647.665,5339563.23,152,94,58,26.643,0,2017,1,122,288,177,0.827888755698193,-2.3,19.1582417582418,55,1327.08415629432,0.484156292981579
17603,520647.665,5339563.23,173,50,123,31.681,0,2018,2,114,301,169,0.855825957964716,-151.3,19.9417582417582,55,1327.08415629432,0.484156292981579
17603,520647.665,5339563.23,168,79,89,21.056,0,2019,2,130,296,178,0.827154804418548,-73.4,20.0571428571429,48,1327.08415629432,0.484156292981579
17603,520647.665,5339563.23,100,94,6,19.829,1,2020,2,123,302,185,0.774891186562046,-13.6,18.3758241758242,62,1327.08415629432,0.484156292981579
17623,520647.665,5334930.103,86,83,3,47.294,6,2001,1,106,316,185,0.861929542036662,116.8,17.4,79,1187.14465124156,1.39431522294697
17623,520647.665,5334930.103,86,69,17,32.329,0,2002,1,117,294,178,0.83208904302667,52.7,17.567032967033,61,1187.14465124156,1.39431522294697
17623,520647.665,5334930.103,171,60,111,27.888,0,2003,2,121,332,161,0.819983187665928,-198,22.3252747252747,40,1187.14465124156,1.39431522294697
17623,520647.665,5334930.103,154,45,109,31.611,0,2004,3,118,335,194,0.8390386935423,209.7,17.0835164835165,76,1187.14465124156,1.39431522294697
17623,520647.665,5334930.103,162,93,69,36.316,0,2005,2,118,307,194,0.848587364535666,44.2,17.3054945054945,76,1187.14465124156,1.39431522294697
17623,520647.665,5334930.103,194,57,137,24.051,1,2006,3,130,329,184,0.803970871739997,92.3,18.2626373626374,54,1187.14465124156,1.39431522294697
17623,520647.665,5334930.103,0,0,0,60.325,0,2007,0,83,292,192,0.844800380347696,332.6,16.5076923076923,109,1187.14465124156,1.39431522294697
17623,520647.665,5334930.103,185,93,92,16.416,0,2008,2,130,298,192,0.859843378120079,50.1,16.9747252747253,62,1187.14465124156,1.39431522294697
17623,520647.665,5334930.103,176,58,118,36.617,0,2009,3,108,294,209,0.836239534676159,55,17.8153846153846,101,1187.14465124156,1.39431522294697
17623,520647.665,5334930.103,176,68,108,19.346,0,2010,3,130,301,193,0.851533060607242,133.1,17.7351648351648,63,1187.14465124156,1.39431522294697
17623,520647.665,5334930.103,86,54,32,32.898,1,2011,1,100,316,208,0.833916187378956,136.1,17.0351648351648,108,1187.14465124156,1.39431522294697
17623,520647.665,5334930.103,165,82,83,31.399,0,2012,3,121,308,217,0.830325633995183,88.9,18.4296703296703,96,1187.14465124156,1.39431522294697
17623,520647.665,5334930.103,178,62,116,28.919,1,2013,3,126,299,193,0.869918549977121,-156.9,18.6175824175824,67,1187.14465124156,1.39431522294697
17623,520647.665,5334930.103,161,48,113,31.787,0,2014,3,113,315,184,0.846038672339211,191.6,17.4516483516484,71,1187.14465124156,1.39431522294697
17623,520647.665,5334930.103,167,113,54,34.04,0,2015,1,116,339,185,0.854501159299135,-154.6,20.4153846153846,69,1187.14465124156,1.39431522294697
17623,520647.665,5334930.103,184,100,84,9.4,0,2016,2,145,330,209,0.863678336343138,50.9,18.5681318681319,64,1187.14465124156,1.39431522294697
17623,520647.665,5334930.103,151,93,58,30.63,2,2017,1,117,296,177,0.853503653948561,-2.3,19.1582417582418,60,1187.14465124156,1.39431522294697
17623,520647.665,5334930.103,159,61,98,38.911,0,2018,2,106,315,178,0.869469595178089,-151.3,19.9417582417582,72,1187.14465124156,1.39431522294697
17623,520647.665,5334930.103,176,96,80,23.027,0,2019,2,128,314,185,0.853283463217154,-73.4,20.0571428571429,57,1187.14465124156,1.39431522294697
17623,520647.665,5334930.103,141,93,48,29.772,2,2020,2,106,315,193,0.823253308281795,-13.6,18.3758241758242,87,1187.14465124156,1.39431522294697
17624,520647.665,5334698.446,86,83,3,46.16,6,2001,0,107,314,185,0.866309941323109,116.8,17.4,78,1162.84205996427,1.34082022112025
17624,520647.665,5334698.446,86,68,18,28.961,0,2002,1,121,293,193,0.843208458673928,52.7,17.567032967033,72,1162.84205996427,1.34082022112025
17624,520647.665,5334698.446,168,60,108,33.746,0,2003,2,114,290,161,0.831574705378667,-198,22.3252747252747,47,1162.84205996427,1.34082022112025
17624,520647.665,5334698.446,153,30,123,33.378,0,2004,3,116,334,193,0.849319304938284,209.7,17.0835164835165,77,1162.84205996427,1.34082022112025
17624,520647.665,5334698.446,165,108,57,37.43,0,2005,2,117,313,216,0.844750734866184,44.2,17.3054945054945,99,1162.84205996427,1.34082022112025
17624,520647.665,5334698.446,187,59,128,30.508,1,2006,3,123,325,185,0.819574820908673,92.3,18.2626373626374,62,1162.84205996427,1.34082022112025
17624,520647.665,5334698.446,0,0,0,61.309,0,2007,0,82,294,161,0.845846392520601,332.6,16.5076923076923,79,1162.84205996427,1.34082022112025
17624,520647.665,5334698.446,184,93,91,17.218,0,2008,2,129,297,185,0.851081352298297,50.1,16.9747252747253,56,1162.84205996427,1.34082022112025
17624,520647.665,5334698.446,177,58,119,39.614,0,2009,2,105,295,178,0.876128992116471,55,17.8153846153846,73,1162.84205996427,1.34082022112025
17624,520647.665,5334698.446,176,69,107,18.484,0,2010,3,131,296,200,0.862425137663777,133.1,17.7351648351648,69,1162.84205996427,1.34082022112025
17624,520647.665,5334698.446,86,53,33,34.574,1,2011,1,98,318,193,0.83697448204724,136.1,17.0351648351648,95,1162.84205996427,1.34082022112025
17624,520647.665,5334698.446,169,82,87,24.307,0,2012,3,128,308,210,0.834820940841612,88.9,18.4296703296703,82,1162.84205996427,1.34082022112025
17624,520647.665,5334698.446,181,61,120,22.774,1,2013,3,132,299,193,0.874069551797884,-156.9,18.6175824175824,61,1162.84205996427,1.34082022112025
17624,520647.665,5334698.446,165,48,117,34.27,1,2014,2,109,316,176,0.858170491392331,191.6,17.4516483516484,67,1162.84205996427,1.34082022112025
17624,520647.665,5334698.446,158,93,65,49.434,0,2015,2,99,338,185,0.856949323833451,-154.6,20.4153846153846,86,1162.84205996427,1.34082022112025
17624,520647.665,5334698.446,183,94,89,2.221,0,2016,2,154,331,209,0.875744074516051,50.9,18.5681318681319,55,1162.84205996427,1.34082022112025
17624,520647.665,5334698.446,150,94,56,35.818,5,2017,2,110,300,225,0.878257888485133,-2.3,19.1582417582418,115,1162.84205996427,1.34082022112025
17624,520647.665,5334698.446,163,62,101,35.087,0,2018,2,110,307,177,0.882213723885548,-151.3,19.9417582417582,67,1162.84205996427,1.34082022112025
17624,520647.665,5334698.446,174,93,81,23.027,0,2019,2,128,302,184,0.860401827559216,-73.4,20.0571428571429,56,1162.84205996427,1.34082022112025
17624,520647.665,5334698.446,140,94,46,27.218,1,2020,2,110,315,185,0.821722276221046,-13.6,18.3758241758242,75,1162.84205996427,1.34082022112025
17626,520647.665,5334235.134,86,84,2,43.705,5,2001,2,109,298,177,0.832769553555764,103.5,18.1120879120879,68,1221.05985269458,0.123107913015603
17626,520647.665,5334235.134,147,68,79,30.605,0,2002,3,119,290,184,0.864491687260626,46.4,18.2428571428571,65,1221.05985269458,0.123107913015603
17626,520647.665,5334235.134,167,58,109,27.482,0,2003,2,121,327,154,0.790945402281216,-203.8,22.9692307692308,33,1221.05985269458,0.123107913015603
17626,520647.665,5334235.134,156,95,61,27.526,0,2004,1,123,332,184,0.843683373599468,196.1,17.7461538461538,61,1221.05985269458,0.123107913015603
17626,520647.665,5334235.134,162,103,59,37.383,0,2005,2,117,304,193,0.870740489875787,38.9,17.9032967032967,76,1221.05985269458,0.123107913015603
17626,520647.665,5334235.134,196,54,142,19.984,0,2006,3,134,329,193,0.841683625782529,82.6,18.867032967033,59,1221.05985269458,0.123107913015603
17626,520647.665,5334235.134,93,93,0,41.74,0,2007,2,101,293,185,0.859602320652011,317.9,17.0824175824176,84,1221.05985269458,0.123107913015603
17626,520647.665,5334235.134,86,49,37,19.822,0,2008,1,126,295,178,0.889861775474426,40.8,17.6131868131868,52,1221.05985269458,0.123107913015603
17626,520647.665,5334235.134,176,58,118,46.599,0,2009,2,99,305,170,0.877063033374479,41,18.5230769230769,71,1221.05985269458,0.123107913015603
17626,520647.665,5334235.134,173,77,96,19.851,0,2010,3,130,297,186,0.860921695358127,122,18.3626373626374,56,1221.05985269458,0.123107913015603
17626,520647.665,5334235.134,138,95,43,29.021,0,2011,1,106,320,162,0.84689444886275,127.1,17.5,56,1221.05985269458,0.123107913015603
17626,520647.665,5334235.134,177,82,95,30.335,0,2012,2,122,311,162,0.84573084904367,82.8,18.7043956043956,40,1221.05985269458,0.123107913015603
17626,520647.665,5334235.134,182,93,89,25.819,0,2013,2,129,297,186,0.846849361362541,-163.1,19.2582417582418,57,1221.05985269458,0.123107913015603
17626,520647.665,5334235.134,152,44,108,33.407,0,2014,3,110,314,185,0.856827837071464,176.9,17.856043956044,75,1221.05985269458,0.123107913015603
17626,520647.665,5334235.134,165,84,81,33.255,0,2015,2,117,330,178,0.842252081792052,-158.6,20.9142857142857,61,1221.05985269458,0.123107913015603
17626,520647.665,5334235.134,175,101,74,34.845,1,2016,2,120,326,194,0.868403402525942,45.5,18.8857142857143,74,1221.05985269458,0.123107913015603
17626,520647.665,5334235.134,151,94,57,31.805,3,2017,2,115,309,184,0.846535008945886,-10.8,19.7879120879121,69,1221.05985269458,0.123107913015603
17626,520647.665,5334235.134,174,61,113,22.961,0,2018,3,125,308,184,0.864354512325868,-154,20.578021978022,59,1221.05985269458,0.123107913015603
17626,520647.665,5334235.134,165,93,72,20.793,0,2019,1,130,328,177,0.852060160160541,-79.8,20.6626373626374,47,1221.05985269458,0.123107913015603
17626,520647.665,5334235.134,0,0,0,24.745,0,2020,0,114,315,217,0.793509817836948,-19.2,19.0648351648352,103,1221.05985269458,0.123107913015603
17627,520647.665,5334003.477,86,83,3,43.705,5,2001,2,109,301,193,0.820506760944654,103.5,18.1120879120879,84,1228.5561801629,-1.03763548849026
17627,520647.665,5334003.477,93,74,19,34.043,0,2002,3,115,292,184,0.828716490105743,46.4,18.2428571428571,69,1228.5561801629,-1.03763548849026
17627,520647.665,5334003.477,163,93,70,32.562,0,2003,1,115,328,162,0.805667366982992,-203.8,22.9692307692308,47,1228.5561801629,-1.03763548849026
17627,520647.665,5334003.477,170,94,76,25.797,0,2004,2,125,335,184,0.834111152912129,196.1,17.7461538461538,59,1228.5561801629,-1.03763548849026
17627,520647.665,5334003.477,0,0,0,44.038,0,2005,0,111,307,178,0.855631359683037,38.9,17.9032967032967,67,1228.5561801629,-1.03763548849026
17627,520647.665,5334003.477,188,64,124,27.945,0,2006,4,126,332,184,0.827719226999259,82.6,18.867032967033,58,1228.5561801629,-1.03763548849026
17627,520647.665,5334003.477,0,0,0,52.484,0,2007,0,90,297,177,0.849787581311934,317.9,17.0824175824176,87,1228.5561801629,-1.03763548849026
17627,520647.665,5334003.477,86,57,29,22.643,0,2008,1,123,292,209,0.847511481527796,40.8,17.6131868131868,86,1228.5561801629,-1.03763548849026
17627,520647.665,5334003.477,170,64,106,31.302,0,2009,2,113,306,162,0.832718773018287,41,18.5230769230769,49,1228.5561801629,-1.03763548849026
17627,520647.665,5334003.477,167,98,69,24.877,0,2010,1,124,303,178,0.829312212439118,122,18.3626373626374,54,1228.5561801629,-1.03763548849026
17627,520647.665,5334003.477,128,62,66,36.643,1,2011,2,97,323,162,0.834702968642338,127.1,17.5,65,1228.5561801629,-1.03763548849026
17627,520647.665,5334003.477,155,98,57,36.671,0,2012,1,116,314,169,0.882478971716252,82.8,18.7043956043956,53,1228.5561801629,-1.03763548849026
17627,520647.665,5334003.477,178,93,85,31.278,0,2013,2,124,304,185,0.828091665050665,-163.1,19.2582417582418,61,1228.5561801629,-1.03763548849026
17627,520647.665,5334003.477,157,53,104,41.568,3,2014,4,98,321,208,0.836944625115524,176.9,17.856043956044,110,1228.5561801629,-1.03763548849026
17627,520647.665,5334003.477,162,80,82,40.878,0,2015,2,108,335,178,0.833467699362311,-158.6,20.9142857142857,70,1228.5561801629,-1.03763548849026
17627,520647.665,5334003.477,175,93,82,35.915,2,2016,2,119,331,192,0.855356285126528,45.5,18.8857142857143,73,1228.5561801629,-1.03763548849026
17627,520647.665,5334003.477,143,94,49,25.564,0,2017,1,123,320,176,0.821441126482723,-10.8,19.7879120879121,53,1228.5561801629,-1.03763548849026
17627,520647.665,5334003.477,93,77,16,34.908,0,2018,2,111,300,177,0.85940448415725,-154,20.578021978022,66,1228.5561801629,-1.03763548849026
17627,520647.665,5334003.477,155,93,62,24.54,2,2019,1,126,329,177,0.83713925169071,-79.8,20.6626373626374,51,1228.5561801629,-1.03763548849026
17627,520647.665,5334003.477,141,94,47,29.029,1,2020,2,107,314,209,0.796142141028498,-19.2,19.0648351648352,102,1228.5561801629,-1.03763548849026
17811,520879.322,5342111.45,93,85,8,38.09,0,2001,4,114,285,185,0.851989580317953,116.8,17.4,71,1266.33153258873,-1.25954957154248
17811,520879.322,5342111.45,137,48,89,23.157,0,2002,3,127,304,186,0.8897850137487,52.7,17.567032967033,59,1266.33153258873,-1.25954957154248
17811,520879.322,5342111.45,173,128,45,27.888,0,2003,1,121,283,176,0.888412476110412,-198,22.3252747252747,55,1266.33153258873,-1.25954957154248
17811,520879.322,5342111.45,169,27,142,20.014,0,2004,3,131,301,202,0.876816106031543,209.7,17.0835164835165,71,1266.33153258873,-1.25954957154248
17811,520879.322,5342111.45,160,93,67,28.191,0,2005,1,126,295,177,0.89511285104709,44.2,17.3054945054945,51,1266.33153258873,-1.25954957154248
17811,520879.322,5342111.45,184,78,106,49.986,2,2006,2,106,320,170,0.835517274409729,92.3,18.2626373626374,64,1266.33153258873,-1.25954957154248
17811,520879.322,5342111.45,142,116,26,35.048,0,2007,1,110,284,169,0.87555895073091,332.6,16.5076923076923,59,1266.33153258873,-1.25954957154248
17811,520879.322,5342111.45,174,55,119,16.416,0,2008,3,130,284,193,0.871315584257262,50.1,16.9747252747253,63,1266.33153258873,-1.25954957154248
17811,520879.322,5342111.45,182,64,118,29.922,0,2009,2,115,273,193,0.876292422572222,55,17.8153846153846,78,1266.33153258873,-1.25954957154248
17811,520879.322,5342111.45,163,51,112,14.913,0,2010,3,135,281,186,0.896926452612461,133.1,17.7351648351648,51,1266.33153258873,-1.25954957154248
17811,520879.322,5342111.45,148,58,90,25.242,0,2011,2,110,303,168,0.879397687471885,136.1,17.0351648351648,58,1266.33153258873,-1.25954957154248
17811,520879.322,5342111.45,166,80,86,31.399,0,2012,2,121,297,177,0.902006908201198,88.9,18.4296703296703,56,1266.33153258873,-1.25954957154248
17811,520879.322,5342111.45,184,63,121,13.586,1,2013,3,141,289,193,0.880460382940049,-156.9,18.6175824175824,52,1266.33153258873,-1.25954957154248
17811,520879.322,5342111.45,164,40,124,25.301,0,2014,2,123,321,185,0.872298818836124,191.6,17.4516483516484,62,1266.33153258873,-1.25954957154248
17811,520879.322,5342111.45,169,82,87,38.991,0,2015,2,110,292,176,0.897925779076807,-154.6,20.4153846153846,66,1266.33153258873,-1.25954957154248
17811,520879.322,5342111.45,176,103,73,20.433,0,2016,1,134,326,185,0.883431914397129,50.9,18.5681318681319,51,1266.33153258873,-1.25954957154248
17811,520879.322,5342111.45,145,94,51,25.846,0,2017,1,123,295,178,0.883224505646699,-2.3,19.1582417582418,55,1266.33153258873,-1.25954957154248
17811,520879.322,5342111.45,169,57,112,46.134,0,2018,2,99,298,177,0.870323844593242,-151.3,19.9417582417582,78,1266.33153258873,-1.25954957154248
17811,520879.322,5342111.45,161,93,68,21.056,0,2019,1,130,294,176,0.910886337544911,-73.4,20.0571428571429,46,1266.33153258873,-1.25954957154248
17811,520879.322,5342111.45,141,77,64,22.185,1,2020,5,119,292,202,0.81525006261399,-13.6,18.3758241758242,83,1266.33153258873,-1.25954957154248
17812,520879.322,5341879.793,86,86,0,38.09,0,2001,2,114,285,178,0.856838693862928,116.8,17.4,64,1241.72331592183,1.30432907587635
17812,520879.322,5341879.793,93,47,46,28.961,0,2002,3,121,306,184,0.87485669118245,52.7,17.567032967033,63,1241.72331592183,1.30432907587635
17812,520879.322,5341879.793,174,93,81,26.947,0,2003,1,122,292,176,0.877272224662142,-198,22.3252747252747,54,1241.72331592183,1.30432907587635
17812,520879.322,5341879.793,183,55,128,21.105,0,2004,2,130,279,184,0.882009118283269,209.7,17.0835164835165,54,1241.72331592183,1.30432907587635
17812,520879.322,5341879.793,173,93,80,31.202,0,2005,1,123,296,169,0.847522545351433,44.2,17.3054945054945,46,1241.72331592183,1.30432907587635
17812,520879.322,5341879.793,192,55,137,29.573,1,2006,2,124,327,170,0.82226382846785,92.3,18.2626373626374,46,1241.72331592183,1.30432907587635
17812,520879.322,5341879.793,142,93,49,37.96,0,2007,1,106,296,177,0.845344125134957,332.6,16.5076923076923,71,1241.72331592183,1.30432907587635
17812,520879.322,5341879.793,178,58,120,12.778,0,2008,2,135,295,178,0.83331676120991,50.1,16.9747252747253,43,1241.72331592183,1.30432907587635
17812,520879.322,5341879.793,184,63,121,32.652,0,2009,2,112,280,161,0.869673689278464,55,17.8153846153846,49,1241.72331592183,1.30432907587635
17812,520879.322,5341879.793,172,68,104,19.346,0,2010,3,130,297,193,0.884329763813358,133.1,17.7351648351648,63,1241.72331592183,1.30432907587635
17812,520879.322,5341879.793,154,101,53,27.418,0,2011,1,107,305,160,0.857348884676878,136.1,17.0351648351648,53,1241.72331592183,1.30432907587635
17812,520879.322,5341879.793,172,81,91,39.968,0,2012,2,113,304,177,0.872558179000204,88.9,18.4296703296703,64,1241.72331592183,1.30432907587635
17812,520879.322,5341879.793,187,102,85,25.798,1,2013,1,129,299,186,0.865808513264652,-156.9,18.6175824175824,57,1241.72331592183,1.30432907587635
17812,520879.322,5341879.793,149,47,102,34.27,1,2014,2,109,323,176,0.83769684080374,191.6,17.4516483516484,67,1241.72331592183,1.30432907587635
17812,520879.322,5341879.793,176,93,83,34.04,0,2015,2,116,315,169,0.880833486558486,-154.6,20.4153846153846,53,1241.72331592183,1.30432907587635
17812,520879.322,5341879.793,179,93,86,16.42,0,2016,2,138,307,193,0.871529742445566,50.9,18.5681318681319,55,1241.72331592183,1.30432907587635
17812,520879.322,5341879.793,154,106,48,29.025,0,2017,1,119,299,168,0.845903310765338,-2.3,19.1582417582418,49,1241.72331592183,1.30432907587635
17812,520879.322,5341879.793,179,60,119,36.94,0,2018,2,108,298,161,0.875302347769,-151.3,19.9417582417582,53,1241.72331592183,1.30432907587635
17812,520879.322,5341879.793,175,108,67,27.567,4,2019,1,123,313,176,0.843592643303881,-73.4,20.0571428571429,53,1241.72331592183,1.30432907587635
17812,520879.322,5341879.793,93,93,0,23.757,1,2020,2,116,301,200,0.787448815523881,-13.6,18.3758241758242,84,1241.72331592183,1.30432907587635
17815,520879.322,5341184.824,86,84,2,30.444,0,2001,2,121,288,185,0.877354644506959,116.8,17.4,64,1254.57483344193,1.306328185726
17815,520879.322,5341184.824,156,56,100,24.173,0,2002,3,126,314,201,0.831166392792669,52.7,17.567032967033,75,1254.57483344193,1.306328185726
17815,520879.322,5341184.824,172,72,100,33.746,0,2003,2,114,282,169,0.820407578629835,-198,22.3252747252747,55,1254.57483344193,1.306328185726
17815,520879.322,5341184.824,171,42,129,20.014,0,2004,2,131,293,176,0.856166951159198,209.7,17.0835164835165,45,1254.57483344193,1.306328185726
17815,520879.322,5341184.824,176,98,78,31.202,0,2005,1,123,295,178,0.871192962736473,44.2,17.3054945054945,55,1254.57483344193,1.306328185726
17815,520879.322,5341184.824,186,58,128,53.914,2,2006,2,103,316,176,0.821592687989509,92.3,18.2626373626374,73,1254.57483344193,1.306328185726
17815,520879.322,5341184.824,142,97,45,36.473,0,2007,2,108,290,217,0.80942292524196,332.6,16.5076923076923,109,1254.57483344193,1.306328185726
17815,520879.322,5341184.824,179,52,127,14.174,0,2008,3,133,281,217,0.869524514608143,50.1,16.9747252747253,84,1254.57483344193,1.306328185726
17815,520879.322,5341184.824,192,63,129,27.362,0,2009,3,118,279,177,0.887163011436899,55,17.8153846153846,59,1254.57483344193,1.306328185726
17815,520879.322,5341184.824,185,69,116,14.913,0,2010,2,135,288,185,0.871522698042433,133.1,17.7351648351648,50,1254.57483344193,1.306328185726
17815,520879.322,5341184.824,158,126,32,25.242,0,2011,1,110,307,160,0.847695660882719,136.1,17.0351648351648,50,1254.57483344193,1.306328185726
17815,520879.322,5341184.824,181,115,66,29.388,0,2012,1,123,304,170,0.866402410755542,88.9,18.4296703296703,47,1254.57483344193,1.306328185726
17815,520879.322,5341184.824,197,104,93,16.683,1,2013,2,138,289,209,0.837814233421975,-156.9,18.6175824175824,71,1254.57483344193,1.306328185726
17815,520879.322,5341184.824,162,40,122,25.301,0,2014,3,123,327,192,0.815104250379013,191.6,17.4516483516484,69,1254.57483344193,1.306328185726
17815,520879.322,5341184.824,170,86,84,40.807,0,2015,3,108,296,185,0.854355425462048,-154.6,20.4153846153846,77,1254.57483344193,1.306328185726
17815,520879.322,5341184.824,188,94,94,8.206,0,2016,2,159,301,202,0.856088923049844,50.9,18.5681318681319,43,1254.57483344193,1.306328185726
17815,520879.322,5341184.824,152,93,59,25.048,0,2017,1,124,294,177,0.861020973836487,-2.3,19.1582417582418,53,1254.57483344193,1.306328185726
17815,520879.322,5341184.824,176,60,116,34.205,0,2018,2,111,311,161,0.855228765851348,-151.3,19.9417582417582,50,1254.57483344193,1.306328185726
17815,520879.322,5341184.824,173,99,74,18.946,0,2019,1,132,295,177,0.825019711884641,-73.4,20.0571428571429,45,1254.57483344193,1.306328185726
17815,520879.322,5341184.824,153,74,79,22.185,1,2020,3,119,294,233,0.804082867044956,-13.6,18.3758241758242,114,1254.57483344193,1.306328185726
17816,520879.322,5340953.168,101,93,8,42.649,4,2001,3,110,297,170,0.874541085211127,116.8,17.4,60,1284.41859826713,-0.837266084267435
17816,520879.322,5340953.168,156,48,108,29.793,0,2002,2,120,306,177,0.827664865516261,52.7,17.567032967033,57,1284.41859826713,-0.837266084267435
17816,520879.322,5340953.168,174,55,119,33.746,0,2003,2,114,282,161,0.839429796800596,-198,22.3252747252747,47,1284.41859826713,-0.837266084267435
17816,520879.322,5340953.168,184,26,158,20.014,0,2004,2,131,322,176,0.824865311088518,209.7,17.0835164835165,45,1284.41859826713,-0.837266084267435
17816,520879.322,5340953.168,170,93,77,35.225,0,2005,1,119,306,169,0.869702903553843,44.2,17.3054945054945,50,1284.41859826713,-0.837266084267435
17816,520879.322,5340953.168,189,63,126,57.768,5,2006,2,100,328,162,0.826115743118053,92.3,18.2626373626374,62,1284.41859826713,-0.837266084267435
17816,520879.322,5340953.168,151,86,65,41.204,0,2007,3,102,305,200,0.777335716992497,332.6,16.5076923076923,98,1284.41859826713,-0.837266084267435
17816,520879.322,5340953.168,161,56,105,25.618,0,2008,2,120,300,185,0.818666102664727,50.1,16.9747252747253,65,1284.41859826713,-0.837266084267435
17816,520879.322,5340953.168,194,65,129,27.362,0,2009,2,118,283,184,0.924319400407892,55,17.8153846153846,66,1284.41859826713,-0.837266084267435
17816,520879.322,5340953.168,177,69,108,25.349,0,2010,2,122,307,177,0.845596812675875,133.1,17.7351648351648,55,1284.41859826713,-0.837266084267435
17816,520879.322,5340953.168,149,99,50,37.229,1,2011,1,95,315,152,0.843243200693066,136.1,17.0351648351648,57,1284.41859826713,-0.837266084267435
17816,520879.322,5340953.168,178,79,99,31.399,0,2012,2,121,308,169,0.861403793006734,88.9,18.4296703296703,48,1284.41859826713,-0.837266084267435
17816,520879.322,5340953.168,192,93,99,41.457,1,2013,2,114,291,210,0.813888186436454,-156.9,18.6175824175824,96,1284.41859826713,-0.837266084267435
17816,520879.322,5340953.168,172,40,132,29.382,0,2014,3,117,321,168,0.7958513252155,191.6,17.4516483516484,51,1284.41859826713,-0.837266084267435
17816,520879.322,5340953.168,170,93,77,50.525,0,2015,1,98,332,161,0.835107904638107,-154.6,20.4153846153846,63,1284.41859826713,-0.837266084267435
17816,520879.322,5340953.168,190,152,38,19.418,0,2016,1,135,305,193,0.819557582410872,50.9,18.5681318681319,58,1284.41859826713,-0.837266084267435
17816,520879.322,5340953.168,169,107,62,40.281,7,2017,1,104,292,162,0.843657427820577,-2.3,19.1582417582418,58,1284.41859826713,-0.837266084267435
17816,520879.322,5340953.168,173,55,118,46.134,0,2018,2,99,297,153,0.8312639210089,-151.3,19.9417582417582,54,1284.41859826713,-0.837266084267435
17816,520879.322,5340953.168,178,93,85,22.081,0,2019,1,129,294,170,0.828841338935113,-73.4,20.0571428571429,41,1284.41859826713,-0.837266084267435
17816,520879.322,5340953.168,152,94,58,23.227,1,2020,1,117,297,176,0.812022764667819,-13.6,18.3758241758242,59,1284.41859826713,-0.837266084267435
17817,520879.322,5340721.512,94,93,1,46.16,6,2001,3,107,298,170,0.866756007223971,116.8,17.4,63,1259.94747078067,-0.626190052370228
17817,520879.322,5340721.512,156,49,107,33.158,0,2002,2,116,308,177,0.862935674437637,52.7,17.567032967033,61,1259.94747078067,-0.626190052370228
17817,520879.322,5340721.512,173,56,117,31.289,0,2003,2,117,287,161,0.821755502442586,-198,22.3252747252747,44,1259.94747078067,-0.626190052370228
17817,520879.322,5340721.512,185,27,158,26.516,0,2004,2,124,323,170,0.853445224568367,209.7,17.0835164835165,46,1259.94747078067,-0.626190052370228
17817,520879.322,5340721.512,176,93,83,35.225,0,2005,1,119,304,177,0.869279092280025,44.2,17.3054945054945,58,1259.94747078067,-0.626190052370228
17817,520879.322,5340721.512,190,64,126,55.199,3,2006,2,102,321,161,0.833368319996764,92.3,18.2626373626374,59,1259.94747078067,-0.626190052370228
17817,520879.322,5340721.512,150,84,66,42.066,0,2007,2,101,301,169,0.84532635151938,332.6,16.5076923076923,68,1259.94747078067,-0.626190052370228
17817,520879.322,5340721.512,157,54,103,32.386,0,2008,3,114,298,194,0.750303413624177,50.1,16.9747252747253,80,1259.94747078067,-0.626190052370228
17817,520879.322,5340721.512,193,62,131,29.922,0,2009,2,115,281,176,0.855680558504845,55,17.8153846153846,61,1259.94747078067,-0.626190052370228
17817,520879.322,5340721.512,181,69,112,25.349,0,2010,2,122,308,169,0.838669476536125,133.1,17.7351648351648,47,1259.94747078067,-0.626190052370228
17817,520879.322,5340721.512,149,93,56,34.574,1,2011,1,98,316,153,0.838343322936874,136.1,17.0351648351648,55,1259.94747078067,-0.626190052370228
17817,520879.322,5340721.512,178,80,98,31.399,0,2012,2,121,311,170,0.860601458735101,88.9,18.4296703296703,49,1259.94747078067,-0.626190052370228
17817,520879.322,5340721.512,192,93,99,41.457,1,2013,2,114,302,217,0.806104071173954,-156.9,18.6175824175824,103,1259.94747078067,-0.626190052370228
17817,520879.322,5340721.512,164,45,119,37.471,3,2014,2,104,320,161,0.81372800490795,191.6,17.4516483516484,57,1259.94747078067,-0.626190052370228
17817,520879.322,5340721.512,177,120,57,35.617,0,2015,1,114,345,170,0.83246863602085,-154.6,20.4153846153846,56,1259.94747078067,-0.626190052370228
17817,520879.322,5340721.512,185,93,92,24.254,0,2016,2,130,312,194,0.830703035853421,50.9,18.5681318681319,64,1259.94747078067,-0.626190052370228
17817,520879.322,5340721.512,170,93,77,37.348,7,2017,1,108,298,168,0.8440581238803,-2.3,19.1582417582418,60,1259.94747078067,-0.626190052370228
17817,520879.322,5340721.512,171,60,111,48.353,0,2018,2,97,297,154,0.825570212800161,-151.3,19.9417582417582,57,1259.94747078067,-0.626190052370228
17817,520879.322,5340721.512,181,150,31,29.334,4,2019,1,121,295,169,0.833211857241416,-73.4,20.0571428571429,48,1259.94747078067,-0.626190052370228
17817,520879.322,5340721.512,151,93,58,24.299,1,2020,1,115,299,177,0.826525802616138,-13.6,18.3758241758242,62,1259.94747078067,-0.626190052370228
17818,520879.322,5340489.855,166,96,70,33.71,0,2001,3,118,301,177,0.869641010365368,116.8,17.4,59,1275.70679751276,-0.176126087424603
17818,520879.322,5340489.855,162,63,99,23.157,0,2002,2,127,317,178,0.860327033398641,52.7,17.567032967033,51,1275.70679751276,-0.176126087424603
17818,520879.322,5340489.855,175,134,41,30.46,0,2003,1,118,294,161,0.825768907344448,-198,22.3252747252747,43,1275.70679751276,-0.176126087424603
17818,520879.322,5340489.855,186,30,156,16.798,0,2004,2,134,292,185,0.835933299146995,209.7,17.0835164835165,51,1275.70679751276,-0.176126087424603
17818,520879.322,5340489.855,175,97,78,30.232,0,2005,1,124,313,177,0.862080670514929,44.2,17.3054945054945,53,1275.70679751276,-0.176126087424603
17818,520879.322,5340489.855,192,68,124,56.483,4,2006,2,101,323,169,0.839284833004173,92.3,18.2626373626374,68,1275.70679751276,-0.176126087424603
17818,520879.322,5340489.855,165,93,72,35.048,0,2007,2,110,305,169,0.862558582832565,332.6,16.5076923076923,59,1275.70679751276,-0.176126087424603
17818,520879.322,5340489.855,181,60,121,18.901,0,2008,2,127,298,184,0.81567896446461,50.1,16.9747252747253,57,1275.70679751276,-0.176126087424603
17818,520879.322,5340489.855,195,62,133,26.517,0,2009,3,119,291,162,0.872258659372466,55,17.8153846153846,43,1275.70679751276,-0.176126087424603
17818,520879.322,5340489.855,190,70,120,30.576,0,2010,2,115,302,170,0.841504948931115,133.1,17.7351648351648,55,1275.70679751276,-0.176126087424603
17818,520879.322,5340489.855,160,68,92,32.093,1,2011,2,101,316,153,0.840983840815862,136.1,17.0351648351648,52,1275.70679751276,-0.176126087424603
17818,520879.322,5340489.855,175,81,94,34.503,0,2012,2,118,309,169,0.873564765025553,88.9,18.4296703296703,51,1275.70679751276,-0.176126087424603
17818,520879.322,5340489.855,200,65,135,30.012,1,2013,3,125,293,218,0.838589136170766,-156.9,18.6175824175824,93,1275.70679751276,-0.176126087424603
17818,520879.322,5340489.855,169,40,129,31.787,0,2014,3,113,322,161,0.821964961803852,191.6,17.4516483516484,48,1275.70679751276,-0.176126087424603
17818,520879.322,5340489.855,170,93,77,50.525,0,2015,2,98,307,226,0.828714853627955,-154.6,20.4153846153846,128,1275.70679751276,-0.176126087424603
17818,520879.322,5340489.855,188,93,95,32.744,1,2016,1,122,297,177,0.868732909312162,50.9,18.5681318681319,55,1275.70679751276,-0.176126087424603
17818,520879.322,5340489.855,155,109,46,32.826,3,2017,1,114,289,169,0.844570145848372,-2.3,19.1582417582418,55,1275.70679751276,-0.176126087424603
17818,520879.322,5340489.855,180,42,138,32.524,0,2018,2,113,297,161,0.840382374962571,-151.3,19.9417582417582,48,1275.70679751276,-0.176126087424603
17818,520879.322,5340489.855,188,81,107,21.056,0,2019,3,130,295,177,0.828310523545451,-73.4,20.0571428571429,47,1275.70679751276,-0.176126087424603
17818,520879.322,5340489.855,0,0,0,24.299,0,2020,0,115,300,184,0.823631641286485,-13.6,18.3758241758242,69,1275.70679751276,-0.176126087424603
17819,520879.322,5340258.199,162,94,68,26.331,0,2001,5,125,299,184,0.851812974641972,116.8,17.4,59,1312.90587690432,1.36872449295167
17819,520879.322,5340258.199,162,63,99,19.282,0,2002,3,131,314,192,0.82774248130907,52.7,17.567032967033,61,1312.90587690432,1.36872449295167
17819,520879.322,5340258.199,179,151,28,26.018,0,2003,1,123,289,162,0.831441612778638,-198,22.3252747252747,39,1312.90587690432,1.36872449295167
17819,520879.322,5340258.199,189,29,160,6.828,0,2004,2,145,293,201,0.829839989320628,209.7,17.0835164835165,56,1312.90587690432,1.36872449295167
17819,520879.322,5340258.199,176,103,73,22.845,0,2005,1,131,303,185,0.858265111486944,44.2,17.3054945054945,54,1312.90587690432,1.36872449295167
17819,520879.322,5340258.199,202,63,139,24.051,1,2006,2,130,316,185,0.838699284549058,92.3,18.2626373626374,55,1312.90587690432,1.36872449295167
17819,520879.322,5340258.199,161,112,49,31.155,0,2007,1,116,298,169,0.894234623490674,332.6,16.5076923076923,53,1312.90587690432,1.36872449295167
17819,520879.322,5340258.199,185,57,128,10.783,0,2008,2,138,295,192,0.82542037947899,50.1,16.9747252747253,54,1312.90587690432,1.36872449295167
17819,520879.322,5340258.199,196,59,137,24.036,0,2009,3,122,288,170,0.860642092466765,55,17.8153846153846,48,1312.90587690432,1.36872449295167
17819,520879.322,5340258.199,201,69,132,14.002,0,2010,2,136,298,184,0.844642891250135,133.1,17.7351648351648,48,1312.90587690432,1.36872449295167
17819,520879.322,5340258.199,160,67,93,26.677,0,2011,2,108,315,161,0.820247913570565,136.1,17.0351648351648,53,1312.90587690432,1.36872449295167
17819,520879.322,5340258.199,175,81,94,23.303,0,2012,2,129,303,176,0.876018001198786,88.9,18.4296703296703,47,1312.90587690432,1.36872449295167
17819,520879.322,5340258.199,204,64,140,17.728,1,2013,2,137,294,202,0.845321777232326,-156.9,18.6175824175824,65,1312.90587690432,1.36872449295167
17819,520879.322,5340258.199,164,44,120,27.473,0,2014,3,120,316,224,0.847119175598391,191.6,17.4516483516484,104,1312.90587690432,1.36872449295167
17819,520879.322,5340258.199,177,118,59,22.759,0,2015,1,127,288,177,0.824269086838184,-154.6,20.4153846153846,50,1312.90587690432,1.36872449295167
17819,520879.322,5340258.199,191,136,55,28.272,0,2016,1,126,299,185,0.893490729423563,50.9,18.5681318681319,59,1312.90587690432,1.36872449295167
17819,520879.322,5340258.199,156,109,47,29.025,0,2017,1,119,283,169,0.833293785590561,-2.3,19.1582417582418,50,1312.90587690432,1.36872449295167
17819,520879.322,5340258.199,177,40,137,29.133,0,2018,2,117,296,169,0.830130354166037,-151.3,19.9417582417582,52,1312.90587690432,1.36872449295167
17819,520879.322,5340258.199,187,81,106,11.183,0,2019,3,140,290,185,0.808836616258163,-73.4,20.0571428571429,45,1312.90587690432,1.36872449295167
17819,520879.322,5340258.199,0,0,0,17.862,0,2020,0,126,293,185,0.819452110366193,-13.6,18.3758241758242,59,1312.90587690432,1.36872449295167
17820,520879.322,5340026.543,0,0,0,21.264,0,2001,2,130,292,185,0.837946648965312,116.8,17.4,55,1326.54659789079,0.47378537780758
17820,520879.322,5340026.543,163,77,86,10.932,0,2002,3,140,309,192,0.842306043900993,52.7,17.567032967033,52,1326.54659789079,0.47378537780758
17820,520879.322,5340026.543,182,68,114,27.888,0,2003,2,121,276,170,0.837688729216005,-198,22.3252747252747,49,1326.54659789079,0.47378537780758
17820,520879.322,5340026.543,185,129,56,3.675,0,2004,1,149,297,193,0.837828350529783,209.7,17.0835164835165,44,1326.54659789079,0.47378537780758
17820,520879.322,5340026.543,185,150,35,18.805,0,2005,1,135,299,185,0.862342240081354,44.2,17.3054945054945,50,1326.54659789079,0.47378537780758
17820,520879.322,5340026.543,199,62,137,16.262,1,2006,2,138,314,193,0.834484002786558,92.3,18.2626373626374,55,1326.54659789079,0.47378537780758
17820,520879.322,5340026.543,162,93,69,29.972,0,2007,1,118,298,177,0.872725605427729,332.6,16.5076923076923,59,1326.54659789079,0.47378537780758
17820,520879.322,5340026.543,166,58,108,10.115,0,2008,3,139,294,194,0.834876096781659,50.1,16.9747252747253,55,1326.54659789079,0.47378537780758
17820,520879.322,5340026.543,195,63,132,20.788,0,2009,2,126,289,184,0.863793640665542,55,17.8153846153846,58,1326.54659789079,0.47378537780758
17820,520879.322,5340026.543,191,73,118,7.862,0,2010,2,143,281,186,0.845554783091984,133.1,17.7351648351648,43,1326.54659789079,0.47378537780758
17820,520879.322,5340026.543,163,80,83,21.242,0,2011,2,116,308,169,0.836950967636188,136.1,17.0351648351648,53,1326.54659789079,0.47378537780758
17820,520879.322,5340026.543,182,81,101,23.303,0,2012,2,129,294,177,0.87648198509679,88.9,18.4296703296703,48,1326.54659789079,0.47378537780758
17820,520879.322,5340026.543,197,93,104,10.218,1,2013,2,144,286,201,0.846515616195909,-156.9,18.6175824175824,57,1326.54659789079,0.47378537780758
17820,520879.322,5340026.543,176,41,135,20.578,0,2014,3,129,305,186,0.834417322899021,191.6,17.4516483516484,57,1326.54659789079,0.47378537780758
17820,520879.322,5340026.543,176,124,52,21.674,0,2015,1,128,295,184,0.830266437781141,-154.6,20.4153846153846,56,1326.54659789079,0.47378537780758
17820,520879.322,5340026.543,197,164,33,30.486,0,2016,1,124,293,178,0.896663136066791,50.9,18.5681318681319,54,1326.54659789079,0.47378537780758
17820,520879.322,5340026.543,159,139,20,19.822,0,2017,1,130,285,177,0.831383631512604,-2.3,19.1582417582418,47,1326.54659789079,0.47378537780758
17820,520879.322,5340026.543,174,76,98,33.351,0,2018,2,112,298,178,0.835920529022179,-151.3,19.9417582417582,66,1326.54659789079,0.47378537780758
17820,520879.322,5340026.543,191,103,88,13.016,0,2019,1,138,285,184,0.801201271901395,-73.4,20.0571428571429,46,1326.54659789079,0.47378537780758
17820,520879.322,5340026.543,158,110,48,12.042,0,2020,1,135,292,192,0.811942969341207,-13.6,18.3758241758242,57,1326.54659789079,0.47378537780758
17821,520879.322,5339794.886,0,0,0,21.264,0,2001,2,130,288,193,0.8506805341655,116.8,17.4,63,1339.36777920083,-1.07696150887901
17821,520879.322,5339794.886,161,76,85,9.237,0,2002,3,142,306,194,0.842483296898733,52.7,17.567032967033,52,1339.36777920083,-1.07696150887901
17821,520879.322,5339794.886,176,67,109,34.588,0,2003,2,113,277,178,0.806017449569385,-198,22.3252747252747,65,1339.36777920083,-1.07696150887901
17821,520879.322,5339794.886,184,93,91,1.548,0,2004,2,154,303,202,0.834943891801084,209.7,17.0835164835165,48,1339.36777920083,-1.07696150887901
17821,520879.322,5339794.886,185,149,36,19.829,0,2005,1,134,298,193,0.852296440975762,44.2,17.3054945054945,59,1339.36777920083,-1.07696150887901
17821,520879.322,5339794.886,197,62,135,13.128,1,2006,2,141,316,193,0.805564708910817,92.3,18.2626373626374,52,1339.36777920083,-1.07696150887901
17821,520879.322,5339794.886,165,93,72,28.061,0,2007,1,121,298,177,0.875386428311783,332.6,16.5076923076923,56,1339.36777920083,-1.07696150887901
17821,520879.322,5339794.886,166,58,108,5.476,0,2008,2,146,296,194,0.82687126258651,50.1,16.9747252747253,48,1339.36777920083,-1.07696150887901
17821,520879.322,5339794.886,196,63,133,16.878,0,2009,2,131,294,201,0.823016802153104,55,17.8153846153846,70,1339.36777920083,-1.07696150887901
17821,520879.322,5339794.886,190,73,117,7.862,0,2010,2,143,277,193,0.866643019447134,133.1,17.7351648351648,50,1339.36777920083,-1.07696150887901
17821,520879.322,5339794.886,159,93,66,20.606,0,2011,1,117,313,177,0.818023718197336,136.1,17.0351648351648,60,1339.36777920083,-1.07696150887901
17821,520879.322,5339794.886,183,81,102,19.353,0,2012,2,133,298,178,0.861510460531906,88.9,18.4296703296703,45,1339.36777920083,-1.07696150887901
17821,520879.322,5339794.886,199,137,62,11.339,1,2013,1,143,290,193,0.85005077486876,-156.9,18.6175824175824,50,1339.36777920083,-1.07696150887901
17821,520879.322,5339794.886,176,44,132,23.702,0,2014,3,125,311,185,0.855583015431169,191.6,17.4516483516484,60,1339.36777920083,-1.07696150887901
17821,520879.322,5339794.886,173,113,60,41.721,0,2015,1,107,287,176,0.84302735888523,-154.6,20.4153846153846,69,1339.36777920083,-1.07696150887901
17821,520879.322,5339794.886,197,158,39,28.272,0,2016,1,126,297,184,0.902024205565328,50.9,18.5681318681319,58,1339.36777920083,-1.07696150887901
17821,520879.322,5339794.886,156,108,48,21.68,0,2017,1,128,288,178,0.83955752348327,-2.3,19.1582417582418,50,1339.36777920083,-1.07696150887901
17821,520879.322,5339794.886,176,75,101,35.087,0,2018,2,110,295,169,0.872757223795703,-151.3,19.9417582417582,59,1339.36777920083,-1.07696150887901
17821,520879.322,5339794.886,191,93,98,13.943,0,2019,1,137,285,178,0.811167695646066,-73.4,20.0571428571429,41,1339.36777920083,-1.07696150887901
17821,520879.322,5339794.886,156,109,47,16.584,1,2020,1,128,291,193,0.828487354054118,-13.6,18.3758241758242,65,1339.36777920083,-1.07696150887901
17822,520879.322,5339563.23,0,0,0,56.702,0,2001,2,98,273,178,0.867232345497538,116.8,17.4,80,1314.72403035556,-1.44751634875182
17822,520879.322,5339563.23,158,52,106,24.173,0,2002,2,126,310,192,0.83158649084497,52.7,17.567032967033,66,1314.72403035556,-1.44751634875182
17822,520879.322,5339563.23,169,93,76,29.642,0,2003,1,119,283,169,0.848054470284646,-198,22.3252747252747,50,1314.72403035556,-1.44751634875182
17822,520879.322,5339563.23,171,29,142,9.362,0,2004,2,142,319,193,0.863674243026329,209.7,17.0835164835165,51,1314.72403035556,-1.44751634875182
17822,520879.322,5339563.23,175,142,33,27.16,0,2005,1,127,305,185,0.889597431361982,44.2,17.3054945054945,58,1314.72403035556,-1.44751634875182
17822,520879.322,5339563.23,188,65,123,27.774,1,2006,2,126,338,177,0.824133937453282,92.3,18.2626373626374,51,1314.72403035556,-1.44751634875182
17822,520879.322,5339563.23,144,93,51,41.204,0,2007,1,102,297,177,0.862447304844973,332.6,16.5076923076923,75,1314.72403035556,-1.44751634875182
17822,520879.322,5339563.23,153,56,97,16.416,0,2008,2,130,300,186,0.848642518332082,50.1,16.9747252747253,56,1314.72403035556,-1.44751634875182
17822,520879.322,5339563.23,179,67,112,45.038,0,2009,3,100,294,185,0.876659229181295,55,17.8153846153846,85,1314.72403035556,-1.44751634875182
17822,520879.322,5339563.23,187,74,113,16.748,0,2010,4,133,281,185,0.873941088130351,133.1,17.7351648351648,52,1314.72403035556,-1.44751634875182
17822,520879.322,5339563.23,136,99,37,26.677,0,2011,1,108,316,161,0.84120021613081,136.1,17.0351648351648,53,1314.72403035556,-1.44751634875182
17822,520879.322,5339563.23,180,93,87,28.345,0,2012,1,124,298,176,0.866610008277784,88.9,18.4296703296703,52,1314.72403035556,-1.44751634875182
17822,520879.322,5339563.23,181,77,104,16.683,1,2013,3,138,292,185,0.859406134873399,-156.9,18.6175824175824,47,1314.72403035556,-1.44751634875182
17822,520879.322,5339563.23,159,43,116,30.572,0,2014,2,115,307,177,0.854693516287124,191.6,17.4516483516484,62,1314.72403035556,-1.44751634875182
17822,520879.322,5339563.23,174,119,55,34.827,0,2015,1,115,329,176,0.858045767700556,-154.6,20.4153846153846,61,1314.72403035556,-1.44751634875182
17822,520879.322,5339563.23,181,93,88,19.418,0,2016,2,135,320,185,0.903784997522069,50.9,18.5681318681319,50,1314.72403035556,-1.44751634875182
17822,520879.322,5339563.23,146,96,50,29.833,1,2017,1,118,295,170,0.846015714503763,-2.3,19.1582417582418,52,1314.72403035556,-1.44751634875182
17822,520879.322,5339563.23,169,49,120,47.223,0,2018,2,98,298,161,0.881107031358341,-151.3,19.9417582417582,63,1314.72403035556,-1.44751634875182
17822,520879.322,5339563.23,155,93,62,24.842,2,2019,1,126,297,177,0.835072192977285,-73.4,20.0571428571429,51,1314.72403035556,-1.44751634875182
17822,520879.322,5339563.23,0,0,0,24.299,0,2020,0,115,304,185,0.821819883546128,-13.6,18.3758241758242,70,1314.72403035556,-1.44751634875182
17847,520879.322,5333771.821,86,83,3,111.879,24,2001,2,52,299,193,0.849418599591602,103.5,18.1120879120879,141,1191.54157267842,-0.335448633291653
17847,520879.322,5333771.821,86,70,16,33.203,0,2002,1,116,298,185,0.829703389974979,46.4,18.2428571428571,69,1191.54157267842,-0.335448633291653
17847,520879.322,5333771.821,169,93,76,32.562,0,2003,1,115,324,161,0.822071640311141,-203.8,22.9692307692308,46,1191.54157267842,-0.335448633291653
17847,520879.322,5333771.821,167,99,68,29.278,0,2004,1,121,335,176,0.815731314274954,196.1,17.7461538461538,55,1191.54157267842,-0.335448633291653
17847,520879.322,5333771.821,163,93,70,42.902,0,2005,2,112,311,193,0.83668154151978,38.9,17.9032967032967,81,1191.54157267842,-0.335448633291653
17847,520879.322,5333771.821,196,65,131,25.082,0,2006,2,129,336,178,0.842296654879682,82.6,18.867032967033,49,1191.54157267842,-0.335448633291653
17847,520879.322,5333771.821,0,0,0,43.519,0,2007,0,99,297,217,0.816457276290213,317.9,17.0824175824176,118,1191.54157267842,-0.335448633291653
17847,520879.322,5333771.821,86,57,29,21.678,0,2008,1,124,293,200,0.832554331790997,40.8,17.6131868131868,76,1191.54157267842,-0.335448633291653
17847,520879.322,5333771.821,173,65,108,46.599,0,2009,2,99,304,161,0.837355757340305,41,18.5230769230769,62,1191.54157267842,-0.335448633291653
17847,520879.322,5333771.821,173,74,99,27.331,0,2010,2,121,307,169,0.848633734601492,122,18.3626373626374,48,1191.54157267842,-0.335448633291653
17847,520879.322,5333771.821,84,64,20,35.725,1,2011,1,98,316,168,0.837782756213647,127.1,17.5,70,1191.54157267842,-0.335448633291653
17847,520879.322,5333771.821,165,80,85,41.768,0,2012,2,111,313,168,0.860265078700439,82.8,18.7043956043956,57,1191.54157267842,-0.335448633291653
17847,520879.322,5333771.821,182,73,109,31.278,0,2013,2,124,303,192,0.82923570250742,-163.1,19.2582417582418,68,1191.54157267842,-0.335448633291653
17847,520879.322,5333771.821,154,47,107,39.378,3,2014,2,101,316,169,0.849035852818016,176.9,17.856043956044,68,1191.54157267842,-0.335448633291653
17847,520879.322,5333771.821,159,84,75,45.493,0,2015,2,103,337,177,0.844329541342005,-158.6,20.9142857142857,74,1191.54157267842,-0.335448633291653
17847,520879.322,5333771.821,164,98,66,32.703,0,2016,1,122,338,177,0.852123611181101,45.5,18.8857142857143,55,1191.54157267842,-0.335448633291653
17847,520879.322,5333771.821,162,104,58,39.373,7,2017,2,105,312,217,0.830168718848843,-10.8,19.7879120879121,112,1191.54157267842,-0.335448633291653
17847,520879.322,5333771.821,169,64,105,33.134,0,2018,3,113,338,176,0.858261512366563,-154,20.578021978022,63,1191.54157267842,-0.335448633291653
17847,520879.322,5333771.821,173,95,78,26.352,4,2019,1,124,329,177,0.837056605949461,-79.8,20.6626373626374,53,1191.54157267842,-0.335448633291653
17847,520879.322,5333771.821,144,94,50,29.029,1,2020,2,107,308,209,0.794690474048303,-19.2,19.0648351648352,102,1191.54157267842,-0.335448633291653
17848,520879.322,5333540.164,0,0,0,48.234,0,2001,2,105,298,210,0.839325953626871,103.5,18.1120879120879,105,1194.40517307621,-0.354424426176932
17848,520879.322,5333540.164,93,71,22,37.538,0,2002,3,111,291,184,0.858629792752846,46.4,18.2428571428571,73,1194.40517307621,-0.354424426176932
17848,520879.322,5333540.164,170,93,77,32.562,0,2003,1,115,321,162,0.823229495437082,-203.8,22.9692307692308,47,1194.40517307621,-0.354424426176932
17848,520879.322,5333540.164,164,106,58,24.906,0,2004,1,126,331,185,0.861389764682482,196.1,17.7461538461538,59,1194.40517307621,-0.354424426176932
17848,520879.322,5333540.164,0,0,0,38.51,0,2005,0,116,309,184,0.882525986306457,38.9,17.9032967032967,68,1194.40517307621,-0.354424426176932
17848,520879.322,5333540.164,192,65,127,22.965,0,2006,3,131,330,193,0.871169812479616,82.6,18.867032967033,62,1194.40517307621,-0.354424426176932
17848,520879.322,5333540.164,0,0,0,40.043,0,2007,0,103,294,192,0.860675921219664,317.9,17.0824175824176,89,1194.40517307621,-0.354424426176932
17848,520879.322,5333540.164,86,54,32,23.631,0,2008,1,122,286,186,0.837634460478985,40.8,17.6131868131868,64,1194.40517307621,-0.354424426176932
17848,520879.322,5333540.164,173,108,65,35.331,0,2009,1,109,294,169,0.87444903825025,41,18.5230769230769,60,1194.40517307621,-0.354424426176932
17848,520879.322,5333540.164,173,93,80,25.687,0,2010,1,123,302,178,0.862963483968388,122,18.3626373626374,55,1194.40517307621,-0.354424426176932
17848,520879.322,5333540.164,93,82,11,33.958,1,2011,2,100,311,168,0.867110235992657,127.1,17.5,68,1194.40517307621,-0.354424426176932
17848,520879.322,5333540.164,158,80,78,34.445,0,2012,2,118,308,169,0.889246875666587,82.8,18.7043956043956,51,1194.40517307621,-0.354424426176932
17848,520879.322,5333540.164,181,102,79,18.716,0,2013,2,136,298,192,0.883964890012396,-163.1,19.2582417582418,56,1194.40517307621,-0.354424426176932
17848,520879.322,5333540.164,86,57,29,40.097,3,2014,1,100,326,176,0.842289908262046,176.9,17.856043956044,76,1194.40517307621,-0.354424426176932
17848,520879.322,5333540.164,158,82,76,38.159,0,2015,2,111,301,177,0.853769911598844,-158.6,20.9142857142857,66,1194.40517307621,-0.354424426176932
17848,520879.322,5333540.164,172,64,108,25.141,0,2016,2,129,336,185,0.86624037555695,45.5,18.8857142857143,56,1194.40517307621,-0.354424426176932
17848,520879.322,5333540.164,126,94,32,31.805,3,2017,2,115,305,185,0.861238728129194,-10.8,19.7879120879121,70,1194.40517307621,-0.354424426176932
17848,520879.322,5333540.164,86,62,24,41.07,0,2018,1,105,302,177,0.882406755300387,-154,20.578021978022,72,1194.40517307621,-0.354424426176932
17848,520879.322,5333540.164,157,93,64,24.54,2,2019,1,126,330,178,0.859391394814688,-79.8,20.6626373626374,52,1194.40517307621,-0.354424426176932
17848,520879.322,5333540.164,93,93,0,29.692,2,2020,2,106,304,225,0.820911324426796,-19.2,19.0648351648352,119,1194.40517307621,-0.354424426176932
18027,521110.978,5342806.419,86,86,0,35.329,0,2001,2,116,293,193,0.875881628087801,118,17.3307692307692,77,1242.6202121843,-0.274570034784033
18027,521110.978,5342806.419,158,69,89,26.717,0,2002,3,123,308,193,0.857290095803509,53.4,17.5120879120879,70,1242.6202121843,-0.274570034784033
18027,521110.978,5342806.419,157,79,78,27.419,0,2003,2,121,284,177,0.870536920159021,-198.1,22.256043956044,56,1242.6202121843,-0.274570034784033
18027,521110.978,5342806.419,166,27,139,13.645,0,2004,3,137,290,194,0.864779361984896,210.8,17.0318681318681,57,1242.6202121843,-0.274570034784033
18027,521110.978,5342806.419,159,95,64,26.685,0,2005,2,127,291,184,0.854898653248746,45.7,17.2395604395604,57,1242.6202121843,-0.274570034784033
18027,521110.978,5342806.419,196,51,145,24.668,1,2006,3,129,318,192,0.840383298636285,93.4,18.2021978021978,63,1242.6202121843,-0.274570034784033
18027,521110.978,5342806.419,0,0,0,35.253,0,2007,0,109,282,177,0.831850403900131,334.9,16.4472527472527,68,1242.6202121843,-0.274570034784033
18027,521110.978,5342806.419,175,56,119,18.844,0,2008,3,127,293,193,0.869553615272482,51.4,16.9230769230769,66,1242.6202121843,-0.274570034784033
18027,521110.978,5342806.419,194,62,132,21.437,0,2009,2,125,286,177,0.896040599844094,56.1,17.7604395604396,52,1242.6202121843,-0.274570034784033
18027,521110.978,5342806.419,174,70,104,18.273,0,2010,2,131,295,177,0.791974593112536,134.3,17.6802197802198,46,1242.6202121843,-0.274570034784033
18027,521110.978,5342806.419,141,54,87,28.077,0,2011,2,106,311,162,0.867503002708277,136.8,16.9703296703297,56,1242.6202121843,-0.274570034784033
18027,521110.978,5342806.419,171,82,89,30.867,0,2012,2,121,302,176,0.873892640245883,90.5,18.343956043956,55,1242.6202121843,-0.274570034784033
18027,521110.978,5342806.419,179,96,83,11.134,1,2013,2,143,298,193,0.876987844492363,-155.5,18.543956043956,50,1242.6202121843,-0.274570034784033
18027,521110.978,5342806.419,152,53,99,25.661,0,2014,4,122,330,184,0.854649238021957,192.7,17.3769230769231,62,1242.6202121843,-0.274570034784033
18027,521110.978,5342806.419,169,93,76,32.747,0,2015,2,117,325,185,0.876046123662638,-153.6,20.3384615384615,68,1242.6202121843,-0.274570034784033
18027,521110.978,5342806.419,178,93,85,22.943,0,2016,2,131,335,184,0.825757241698623,52.4,18.4901098901099,53,1242.6202121843,-0.274570034784033
18027,521110.978,5342806.419,142,94,48,27.755,0,2017,1,120,290,178,0.876498193961398,-1.7,19.1,58,1242.6202121843,-0.274570034784033
18027,521110.978,5342806.419,178,58,120,32.196,0,2018,2,113,305,178,0.869044687707383,-150.7,19.8846153846154,65,1242.6202121843,-0.274570034784033
18027,521110.978,5342806.419,162,93,69,22.657,0,2019,2,128,301,186,0.865696145026341,-73,20.0010989010989,58,1242.6202121843,-0.274570034784033
18027,521110.978,5342806.419,144,93,51,25.303,1,2020,2,113,303,217,0.822809394728071,-12.8,18.3098901098901,104,1242.6202121843,-0.274570034784033
18028,521110.978,5342574.762,86,86,0,38.09,0,2001,2,114,294,193,0.877643352042568,116.8,17.4,79,1264.11156774425,-1.37044643808066
18028,521110.978,5342574.762,157,69,88,22.161,0,2002,2,128,306,200,0.867613962535155,52.7,17.567032967033,72,1264.11156774425,-1.37044643808066
18028,521110.978,5342574.762,163,78,85,26.947,0,2003,2,122,283,178,0.864044715300427,-198,22.3252747252747,56,1264.11156774425,-1.37044643808066
18028,521110.978,5342574.762,161,26,135,15.771,0,2004,3,135,293,201,0.870130345072257,209.7,17.0835164835165,66,1264.11156774425,-1.37044643808066
18028,521110.978,5342574.762,160,93,67,29.22,0,2005,2,125,295,185,0.856879568720229,44.2,17.3054945054945,60,1264.11156774425,-1.37044643808066
18028,521110.978,5342574.762,187,53,134,43.268,2,2006,3,111,320,193,0.835746211250457,92.3,18.2626373626374,82,1264.11156774425,-1.37044643808066
18028,521110.978,5342574.762,0,0,0,38.738,0,2007,0,105,286,177,0.833318766518321,332.6,16.5076923076923,72,1264.11156774425,-1.37044643808066
18028,521110.978,5342574.762,176,56,120,18.046,0,2008,3,128,293,186,0.86675215341363,50.1,16.9747252747253,58,1264.11156774425,-1.37044643808066
18028,521110.978,5342574.762,185,63,122,37.626,0,2009,2,107,283,201,0.858376718820323,55,17.8153846153846,94,1264.11156774425,-1.37044643808066
18028,521110.978,5342574.762,169,70,99,14.913,0,2010,2,135,286,178,0.84249816857948,133.1,17.7351648351648,43,1264.11156774425,-1.37044643808066
18028,521110.978,5342574.762,137,57,80,28.941,0,2011,2,105,310,169,0.866872938468135,136.1,17.0351648351648,64,1264.11156774425,-1.37044643808066
18028,521110.978,5342574.762,166,82,84,32.403,0,2012,2,120,301,177,0.896102933287484,88.9,18.4296703296703,57,1264.11156774425,-1.37044643808066
18028,521110.978,5342574.762,176,96,80,14.64,1,2013,2,140,295,193,0.872083907948447,-156.9,18.6175824175824,53,1264.11156774425,-1.37044643808066
18028,521110.978,5342574.762,149,51,98,16.246,0,2014,2,134,325,170,0.797775375641287,191.6,17.4516483516484,36,1264.11156774425,-1.37044643808066
18028,521110.978,5342574.762,169,93,76,33.252,0,2015,2,117,324,184,0.873303267874617,-154.6,20.4153846153846,67,1264.11156774425,-1.37044643808066
18028,521110.978,5342574.762,181,93,88,22.382,0,2016,2,132,308,185,0.849163453144272,50.9,18.5681318681319,53,1264.11156774425,-1.37044643808066
18028,521110.978,5342574.762,136,94,42,28.227,0,2017,1,120,293,178,0.877889529576202,-2.3,19.1582417582418,58,1264.11156774425,-1.37044643808066
18028,521110.978,5342574.762,174,62,112,34.205,0,2018,2,111,306,176,0.867313775515787,-151.3,19.9417582417582,65,1264.11156774425,-1.37044643808066
18028,521110.978,5342574.762,163,93,70,20.006,0,2019,2,131,295,185,0.851571853025555,-73.4,20.0571428571429,54,1264.11156774425,-1.37044643808066
18028,521110.978,5342574.762,145,94,51,23.227,1,2020,2,117,303,193,0.839267848022203,-13.6,18.3758241758242,76,1264.11156774425,-1.37044643808066
18029,521110.978,5342343.106,86,85,1,25.299,0,2001,2,126,294,194,0.855066108299422,116.8,17.4,68,1280.89493283365,1.25173456371852
18029,521110.978,5342343.106,137,48,89,20.235,0,2002,3,130,298,200,0.865460930645579,52.7,17.567032967033,70,1280.89493283365,1.25173456371852
18029,521110.978,5342343.106,169,93,76,28.806,0,2003,1,120,280,177,0.874411782531106,-198,22.3252747252747,57,1280.89493283365,1.25173456371852
18029,521110.978,5342343.106,167,26,141,23.915,0,2004,3,127,303,209,0.862404829931955,209.7,17.0835164835165,82,1280.89493283365,1.25173456371852
18029,521110.978,5342343.106,161,93,68,26.07,0,2005,1,128,299,177,0.863615933164677,44.2,17.3054945054945,49,1280.89493283365,1.25173456371852
18029,521110.978,5342343.106,186,76,110,43.268,2,2006,3,111,317,192,0.826133200251295,92.3,18.2626373626374,81,1280.89493283365,1.25173456371852
18029,521110.978,5342343.106,141,116,25,35.048,0,2007,1,110,293,170,0.87326298252681,332.6,16.5076923076923,60,1280.89493283365,1.25173456371852
18029,521110.978,5342343.106,174,60,114,16.416,0,2008,3,130,289,202,0.849312329057895,50.1,16.9747252747253,72,1280.89493283365,1.25173456371852
18029,521110.978,5342343.106,185,62,123,27.362,0,2009,2,118,274,202,0.857451681158081,55,17.8153846153846,84,1280.89493283365,1.25173456371852
18029,521110.978,5342343.106,162,51,111,14.002,0,2010,3,136,286,192,0.866563407947904,133.1,17.7351648351648,56,1280.89493283365,1.25173456371852
18029,521110.978,5342343.106,146,62,84,28.173,0,2011,2,106,319,161,0.85781338857454,136.1,17.0351648351648,55,1280.89493283365,1.25173456371852
18029,521110.978,5342343.106,165,81,84,32.403,0,2012,2,120,300,177,0.899162433197326,88.9,18.4296703296703,57,1280.89493283365,1.25173456371852
18029,521110.978,5342343.106,182,63,119,12.469,1,2013,3,142,287,200,0.868006292669352,-156.9,18.6175824175824,58,1280.89493283365,1.25173456371852
18029,521110.978,5342343.106,164,38,126,22.925,0,2014,2,126,329,177,0.823642749054442,191.6,17.4516483516484,51,1280.89493283365,1.25173456371852
18029,521110.978,5342343.106,176,85,91,30.636,0,2015,2,120,294,170,0.92614607942625,-154.6,20.4153846153846,50,1280.89493283365,1.25173456371852
18029,521110.978,5342343.106,177,119,58,16.42,0,2016,1,138,316,186,0.892189670741471,50.9,18.5681318681319,48,1280.89493283365,1.25173456371852
18029,521110.978,5342343.106,149,97,52,24.229,0,2017,1,125,296,184,0.88237180812927,-2.3,19.1582417582418,59,1280.89493283365,1.25173456371852
18029,521110.978,5342343.106,172,54,118,34.205,0,2018,2,111,303,178,0.862754013023144,-151.3,19.9417582417582,67,1280.89493283365,1.25173456371852
18029,521110.978,5342343.106,166,141,25,18.946,0,2019,1,132,291,185,0.865299340158666,-73.4,20.0571428571429,53,1280.89493283365,1.25173456371852
18029,521110.978,5342343.106,141,77,64,19.829,1,2020,3,123,298,192,0.836539746202294,-13.6,18.3758241758242,69,1280.89493283365,1.25173456371852
18030,521110.978,5342111.45,93,85,8,23.243,0,2001,4,128,287,193,0.851134691350291,116.8,17.4,65,1299.13930294521,-1.3344603300689
18030,521110.978,5342111.45,139,47,92,16.37,0,2002,3,134,299,193,0.861368428279934,52.7,17.567032967033,59,1299.13930294521,-1.3344603300689
18030,521110.978,5342111.45,175,126,49,24.203,0,2003,1,125,274,177,0.874465258811798,-198,22.3252747252747,52,1299.13930294521,-1.3344603300689
18030,521110.978,5342111.45,169,25,144,17.848,0,2004,3,133,299,194,0.875452683485091,209.7,17.0835164835165,61,1299.13930294521,-1.3344603300689
18030,521110.978,5342111.45,165,111,54,21.82,0,2005,1,132,294,177,0.865263759188326,44.2,17.3054945054945,45,1299.13930294521,-1.3344603300689
18030,521110.978,5342111.45,194,76,118,25.077,1,2006,2,129,318,185,0.837495001624307,92.3,18.2626373626374,56,1299.13930294521,-1.3344603300689
18030,521110.978,5342111.45,138,117,21,34.358,0,2007,1,111,290,176,0.877400455783145,332.6,16.5076923076923,65,1299.13930294521,-1.3344603300689
18030,521110.978,5342111.45,176,59,117,10.783,0,2008,3,138,286,209,0.840432632419826,50.1,16.9747252747253,71,1299.13930294521,-1.3344603300689
18030,521110.978,5342111.45,186,64,122,24.85,0,2009,2,121,268,201,0.861042163268927,55,17.8153846153846,80,1299.13930294521,-1.3344603300689
18030,521110.978,5342111.45,162,49,113,10.448,0,2010,2,140,282,192,0.866687770388246,133.1,17.7351648351648,52,1299.13930294521,-1.3344603300689
18030,521110.978,5342111.45,148,61,87,25.951,0,2011,2,109,311,161,0.857322720211177,136.1,17.0351648351648,52,1299.13930294521,-1.3344603300689
18030,521110.978,5342111.45,163,80,83,31.399,0,2012,2,121,295,178,0.888688766783019,88.9,18.4296703296703,57,1299.13930294521,-1.3344603300689
18030,521110.978,5342111.45,186,62,124,10.218,1,2013,3,144,292,193,0.860825394498969,-156.9,18.6175824175824,49,1299.13930294521,-1.3344603300689
18030,521110.978,5342111.45,159,44,115,18.901,0,2014,3,131,329,186,0.856761446398711,191.6,17.4516483516484,55,1299.13930294521,-1.3344603300689
18030,521110.978,5342111.45,174,85,89,27.527,0,2015,2,123,302,176,0.892573335701098,-154.6,20.4153846153846,53,1299.13930294521,-1.3344603300689
18030,521110.978,5342111.45,181,152,29,16.42,0,2016,1,138,313,186,0.88697204661116,50.9,18.5681318681319,48,1299.13930294521,-1.3344603300689
18030,521110.978,5342111.45,148,97,51,25.846,0,2017,1,123,294,178,0.880792326877076,-2.3,19.1582417582418,55,1299.13930294521,-1.3344603300689
18030,521110.978,5342111.45,174,55,119,27.471,0,2018,2,119,297,184,0.83162427310919,-151.3,19.9417582417582,65,1299.13930294521,-1.3344603300689
18030,521110.978,5342111.45,164,106,58,16.853,0,2019,1,134,289,178,0.847617099303057,-73.4,20.0571428571429,44,1299.13930294521,-1.3344603300689
18030,521110.978,5342111.45,142,76,66,14.182,1,2020,4,132,295,186,0.820009105207544,-13.6,18.3758241758242,54,1299.13930294521,-1.3344603300689
18031,521110.978,5341879.793,86,85,1,40.345,2,2001,3,112,285,177,0.852606147299675,116.8,17.4,65,1275.06522063198,1.46528948190243
18031,521110.978,5341879.793,93,47,46,28.961,0,2002,3,121,301,184,0.871817309437306,52.7,17.567032967033,63,1275.06522063198,1.46528948190243
18031,521110.978,5341879.793,176,137,39,26.018,0,2003,1,123,279,176,0.862488350636858,-198,22.3252747252747,53,1275.06522063198,1.46528948190243
18031,521110.978,5341879.793,179,55,124,23.018,0,2004,3,128,286,184,0.875322247558476,209.7,17.0835164835165,56,1275.06522063198,1.46528948190243
18031,521110.978,5341879.793,166,93,73,56.127,1,2005,1,100,296,177,0.865727283055969,44.2,17.3054945054945,77,1275.06522063198,1.46528948190243
18031,521110.978,5341879.793,193,55,138,27.774,1,2006,2,126,324,170,0.829903105814719,92.3,18.2626373626374,44,1275.06522063198,1.46528948190243
18031,521110.978,5341879.793,143,93,50,35.048,0,2007,1,110,289,177,0.841974823896814,332.6,16.5076923076923,67,1275.06522063198,1.46528948190243
18031,521110.978,5341879.793,177,54,123,14.174,0,2008,3,133,288,184,0.81603531975146,50.1,16.9747252747253,51,1275.06522063198,1.46528948190243
18031,521110.978,5341879.793,186,65,121,29.053,0,2009,3,116,270,169,0.87512828276584,55,17.8153846153846,53,1275.06522063198,1.46528948190243
18031,521110.978,5341879.793,170,70,100,16.748,0,2010,2,133,294,185,0.863838843710904,133.1,17.7351648351648,52,1275.06522063198,1.46528948190243
18031,521110.978,5341879.793,155,95,60,27.418,0,2011,1,107,305,160,0.859090164555525,136.1,17.0351648351648,53,1275.06522063198,1.46528948190243
18031,521110.978,5341879.793,174,81,93,33.433,0,2012,2,119,300,176,0.867454517999826,88.9,18.4296703296703,57,1275.06522063198,1.46528948190243
18031,521110.978,5341879.793,186,94,92,27.855,1,2013,2,127,295,185,0.864677127425843,-156.9,18.6175824175824,58,1275.06522063198,1.46528948190243
18031,521110.978,5341879.793,149,46,103,35.525,1,2014,2,107,324,169,0.820274344025016,191.6,17.4516483516484,62,1275.06522063198,1.46528948190243
18031,521110.978,5341879.793,175,126,49,30.636,0,2015,1,120,312,169,0.872773440505676,-154.6,20.4153846153846,49,1275.06522063198,1.46528948190243
18031,521110.978,5341879.793,182,110,72,17.425,0,2016,1,137,309,193,0.865836004223373,50.9,18.5681318681319,56,1275.06522063198,1.46528948190243
18031,521110.978,5341879.793,154,108,46,25.846,0,2017,1,123,302,169,0.828240041232321,-2.3,19.1582417582418,46,1275.06522063198,1.46528948190243
18031,521110.978,5341879.793,181,60,121,31.681,0,2018,3,114,300,161,0.877043383540246,-151.3,19.9417582417582,47,1275.06522063198,1.46528948190243
18031,521110.978,5341879.793,174,104,70,24.842,2,2019,1,126,296,176,0.795135167932579,-73.4,20.0571428571429,50,1275.06522063198,1.46528948190243
18031,521110.978,5341879.793,137,93,44,20.455,1,2020,3,122,301,185,0.806530741276234,-13.6,18.3758241758242,63,1275.06522063198,1.46528948190243
18032,521110.978,5341648.137,86,85,1,41.484,3,2001,3,111,287,177,0.85870537752895,116.8,17.4,66,1256.80959199029,-0.447735220679202
18032,521110.978,5341648.137,93,49,44,28.1,0,2002,2,122,300,177,0.838775423704417,52.7,17.567032967033,55,1256.80959199029,-0.447735220679202
18032,521110.978,5341648.137,174,86,88,26.947,0,2003,2,122,287,170,0.859264602647106,-198,22.3252747252747,48,1256.80959199029,-0.447735220679202
18032,521110.978,5341648.137,181,57,124,22.11,0,2004,2,129,292,186,0.874005257712678,209.7,17.0835164835165,57,1256.80959199029,-0.447735220679202
18032,521110.978,5341648.137,172,93,79,35.225,0,2005,1,119,292,176,0.858776299677817,44.2,17.3054945054945,57,1256.80959199029,-0.447735220679202
18032,521110.978,5341648.137,196,53,143,25.077,1,2006,2,129,328,177,0.807368394135296,92.3,18.2626373626374,48,1256.80959199029,-0.447735220679202
18032,521110.978,5341648.137,142,93,49,36.473,0,2007,1,108,290,177,0.843656515624366,332.6,16.5076923076923,69,1256.80959199029,-0.447735220679202
18032,521110.978,5341648.137,174,56,118,23.59,0,2008,3,122,294,185,0.811198171850363,50.1,16.9747252747253,63,1256.80959199029,-0.447735220679202
18032,521110.978,5341648.137,184,62,122,29.922,0,2009,2,115,276,169,0.883845472267983,55,17.8153846153846,54,1256.80959199029,-0.447735220679202
18032,521110.978,5341648.137,170,69,101,20.929,0,2010,2,128,306,177,0.834821257323976,133.1,17.7351648351648,49,1256.80959199029,-0.447735220679202
18032,521110.978,5341648.137,155,94,61,30.511,1,2011,1,103,313,160,0.830562369986518,136.1,17.0351648351648,57,1256.80959199029,-0.447735220679202
18032,521110.978,5341648.137,176,82,94,40.938,0,2012,2,112,302,169,0.858672385873338,88.9,18.4296703296703,57,1256.80959199029,-0.447735220679202
18032,521110.978,5341648.137,193,93,100,27.855,1,2013,2,127,298,186,0.833643416265771,-156.9,18.6175824175824,59,1256.80959199029,-0.447735220679202
18032,521110.978,5341648.137,149,46,103,36.165,2,2014,2,106,326,177,0.796506623311718,191.6,17.4516483516484,71,1256.80959199029,-0.447735220679202
18032,521110.978,5341648.137,171,93,78,32.41,0,2015,1,118,311,169,0.866937321430749,-154.6,20.4153846153846,51,1256.80959199029,-0.447735220679202
18032,521110.978,5341648.137,183,131,52,17.425,0,2016,1,137,302,193,0.864071837766399,50.9,18.5681318681319,56,1256.80959199029,-0.447735220679202
18032,521110.978,5341648.137,152,101,51,29.833,1,2017,1,118,301,169,0.829080623680567,-2.3,19.1582417582418,51,1256.80959199029,-0.447735220679202
18032,521110.978,5341648.137,179,60,119,35.998,0,2018,2,109,301,162,0.873467768030286,-151.3,19.9417582417582,53,1256.80959199029,-0.447735220679202
18032,521110.978,5341648.137,170,93,77,31.151,4,2019,1,119,297,176,0.817007694789872,-73.4,20.0571428571429,57,1256.80959199029,-0.447735220679202
18032,521110.978,5341648.137,0,0,0,24.299,0,2020,0,115,300,186,0.782243570883876,-13.6,18.3758241758242,71,1256.80959199029,-0.447735220679202
18033,521110.978,5341416.481,86,85,1,32.639,0,2001,3,119,291,185,0.853151812724638,116.8,17.4,66,1254.69023438042,-1.41748755596059
18033,521110.978,5341416.481,156,56,100,27.175,0,2002,3,123,313,193,0.822858085355575,52.7,17.567032967033,70,1254.69023438042,-1.41748755596059
18033,521110.978,5341416.481,174,72,102,24.203,0,2003,2,125,275,176,0.826801234701383,-198,22.3252747252747,51,1254.69023438042,-1.41748755596059
18033,521110.978,5341416.481,172,36,136,13.797,0,2004,3,137,295,185,0.796710346008253,209.7,17.0835164835165,48,1254.69023438042,-1.41748755596059
18033,521110.978,5341416.481,179,93,86,32.157,0,2005,1,122,300,177,0.839909523440826,44.2,17.3054945054945,55,1254.69023438042,-1.41748755596059
18033,521110.978,5341416.481,188,61,127,49.986,2,2006,2,106,316,176,0.798517800606048,92.3,18.2626373626374,70,1254.69023438042,-1.41748755596059
18033,521110.978,5341416.481,134,93,41,35.753,0,2007,1,109,290,176,0.811629289262043,332.6,16.5076923076923,67,1254.69023438042,-1.41748755596059
18033,521110.978,5341416.481,184,49,135,18.046,0,2008,3,128,290,184,0.813862640916661,50.1,16.9747252747253,56,1254.69023438042,-1.41748755596059
18033,521110.978,5341416.481,192,65,127,27.362,0,2009,2,118,274,177,0.868735010949553,55,17.8153846153846,59,1254.69023438042,-1.41748755596059
18033,521110.978,5341416.481,185,67,118,15.83,0,2010,2,134,295,184,0.826898309976522,133.1,17.7351648351648,50,1254.69023438042,-1.41748755596059
18033,521110.978,5341416.481,153,93,60,28.173,0,2011,1,106,311,161,0.816510018012229,136.1,17.0351648351648,55,1254.69023438042,-1.41748755596059
18033,521110.978,5341416.481,178,93,85,33.433,0,2012,1,119,310,170,0.835887833931565,88.9,18.4296703296703,51,1254.69023438042,-1.41748755596059
18033,521110.978,5341416.481,200,147,53,18.745,1,2013,1,136,287,209,0.794486042007262,-156.9,18.6175824175824,73,1254.69023438042,-1.41748755596059
18033,521110.978,5341416.481,163,41,122,27.473,0,2014,2,120,326,185,0.828928432459612,191.6,17.4516483516484,65,1254.69023438042,-1.41748755596059
18033,521110.978,5341416.481,180,86,94,31.517,0,2015,3,119,305,169,0.835654098680993,-154.6,20.4153846153846,50,1254.69023438042,-1.41748755596059
18033,521110.978,5341416.481,183,127,56,5.303,0,2016,1,149,302,201,0.848129763297679,50.9,18.5681318681319,52,1254.69023438042,-1.41748755596059
18033,521110.978,5341416.481,154,111,43,26.643,0,2017,1,122,300,177,0.830519411023501,-2.3,19.1582417582418,55,1254.69023438042,-1.41748755596059
18033,521110.978,5341416.481,172,60,112,38.911,0,2018,2,106,315,178,0.816030200223538,-151.3,19.9417582417582,72,1254.69023438042,-1.41748755596059
18033,521110.978,5341416.481,172,98,74,27.567,4,2019,1,123,295,177,0.815932621949475,-73.4,20.0571428571429,54,1254.69023438042,-1.41748755596059
18033,521110.978,5341416.481,152,72,80,23.757,1,2020,2,116,298,184,0.777624946759224,-13.6,18.3758241758242,68,1254.69023438042,-1.41748755596059
18034,521110.978,5341184.824,86,84,2,30.444,0,2001,3,121,289,185,0.853239787015153,116.8,17.4,64,1279.29817111531,-0.853537739874236
18034,521110.978,5341184.824,156,56,100,19.282,0,2002,3,131,308,192,0.811257080911596,52.7,17.567032967033,61,1279.29817111531,-0.853537739874236
18034,521110.978,5341184.824,173,69,104,26.947,0,2003,2,122,282,169,0.838603932343569,-198,22.3252747252747,47,1279.29817111531,-0.853537739874236
18034,521110.978,5341184.824,172,41,131,12.85,0,2004,2,138,295,185,0.813278725508342,209.7,17.0835164835165,47,1279.29817111531,-0.853537739874236
18034,521110.978,5341184.824,176,100,76,32.157,0,2005,1,122,305,177,0.863032318664555,44.2,17.3054945054945,55,1279.29817111531,-0.853537739874236
18034,521110.978,5341184.824,187,63,124,53.914,2,2006,2,103,316,177,0.794837568707434,92.3,18.2626373626374,74,1279.29817111531,-0.853537739874236
18034,521110.978,5341184.824,137,93,44,31.155,0,2007,1,116,292,178,0.79374637147687,332.6,16.5076923076923,62,1279.29817111531,-0.853537739874236
18034,521110.978,5341184.824,179,48,131,17.218,0,2008,3,129,282,186,0.823914932264398,50.1,16.9747252747253,57,1279.29817111531,-0.853537739874236
18034,521110.978,5341184.824,191,64,127,29.053,0,2009,2,116,272,177,0.881011174653531,55,17.8153846153846,61,1279.29817111531,-0.853537739874236
18034,521110.978,5341184.824,187,68,119,10.448,0,2010,2,140,287,186,0.849467075652742,133.1,17.7351648351648,46,1279.29817111531,-0.853537739874236
18034,521110.978,5341184.824,159,120,39,25.951,0,2011,1,109,312,160,0.836357017884865,136.1,17.0351648351648,51,1279.29817111531,-0.853537739874236
18034,521110.978,5341184.824,181,105,76,27.325,0,2012,1,125,303,176,0.85001409471034,88.9,18.4296703296703,51,1279.29817111531,-0.853537739874236
18034,521110.978,5341184.824,201,136,65,9.09,0,2013,1,145,286,202,0.803128144815332,-156.9,18.6175824175824,57,1279.29817111531,-0.853537739874236
18034,521110.978,5341184.824,163,40,123,26.809,0,2014,2,121,324,178,0.810400863313687,191.6,17.4516483516484,57,1279.29817111531,-0.853537739874236
18034,521110.978,5341184.824,174,85,89,29.753,0,2015,2,121,299,176,0.827346340009355,-154.6,20.4153846153846,55,1279.29817111531,-0.853537739874236
18034,521110.978,5341184.824,185,131,54,9.356,0,2016,1,160,303,202,0.847951752021965,50.9,18.5681318681319,42,1279.29817111531,-0.853537739874236
18034,521110.978,5341184.824,155,112,43,23.411,0,2017,1,126,296,178,0.835485029291795,-2.3,19.1582417582418,52,1279.29817111531,-0.853537739874236
18034,521110.978,5341184.824,177,59,118,33.351,0,2018,2,112,317,170,0.813294796819152,-151.3,19.9417582417582,58,1279.29817111531,-0.853537739874236
18034,521110.978,5341184.824,179,152,27,18.946,0,2019,1,132,296,177,0.813114574273118,-73.4,20.0571428571429,45,1279.29817111531,-0.853537739874236
18034,521110.978,5341184.824,155,73,82,17.219,1,2020,2,127,298,185,0.791173093502837,-13.6,18.3758241758242,58,1279.29817111531,-0.853537739874236
18035,521110.978,5340953.168,0,0,0,43.824,0,2001,3,109,301,176,0.872619360630251,116.8,17.4,67,1297.69303489208,-1.37481096415183
18035,521110.978,5340953.168,156,49,107,33.966,0,2002,2,115,309,177,0.858206886702278,52.7,17.567032967033,62,1297.69303489208,-1.37481096415183
18035,521110.978,5340953.168,176,56,120,32.108,0,2003,2,116,283,168,0.853999860738944,-198,22.3252747252747,52,1297.69303489208,-1.37481096415183
18035,521110.978,5340953.168,182,26,156,23.915,0,2004,2,127,318,177,0.850176240795337,209.7,17.0835164835165,50,1297.69303489208,-1.37481096415183
18035,521110.978,5340953.168,173,93,80,31.202,0,2005,1,123,307,177,0.882948284112825,44.2,17.3054945054945,54,1297.69303489208,-1.37481096415183
18035,521110.978,5340953.168,190,66,124,55.199,3,2006,2,102,319,169,0.828586855013714,92.3,18.2626373626374,67,1297.69303489208,-1.37481096415183
18035,521110.978,5340953.168,150,84,66,39.541,0,2007,3,104,305,233,0.790352049072212,332.6,16.5076923076923,129,1297.69303489208,-1.37481096415183
18035,521110.978,5340953.168,158,56,102,25.618,0,2008,3,120,300,184,0.831126551249336,50.1,16.9747252747253,64,1297.69303489208,-1.37481096415183
18035,521110.978,5340953.168,194,65,129,27.362,0,2009,2,118,278,185,0.91113733683165,55,17.8153846153846,67,1297.69303489208,-1.37481096415183
18035,521110.978,5340953.168,178,67,111,20.149,0,2010,2,129,296,177,0.843331407174996,133.1,17.7351648351648,48,1297.69303489208,-1.37481096415183
18035,521110.978,5340953.168,154,99,55,26.677,0,2011,1,108,318,160,0.849195796244535,136.1,17.0351648351648,52,1297.69303489208,-1.37481096415183
18035,521110.978,5340953.168,176,80,96,36.732,0,2012,2,116,305,169,0.863225042344185,88.9,18.4296703296703,53,1297.69303489208,-1.37481096415183
18035,521110.978,5340953.168,197,93,104,23.774,1,2013,2,131,289,216,0.805862470664037,-156.9,18.6175824175824,85,1297.69303489208,-1.37481096415183
18035,521110.978,5340953.168,173,39,134,28.765,0,2014,3,118,324,169,0.810203256990755,191.6,17.4516483516484,51,1297.69303489208,-1.37481096415183
18035,521110.978,5340953.168,174,120,54,41.721,0,2015,1,107,301,161,0.814985356863478,-154.6,20.4153846153846,54,1297.69303489208,-1.37481096415183
18035,521110.978,5340953.168,191,150,41,19.418,0,2016,1,135,311,185,0.815435982713193,50.9,18.5681318681319,50,1297.69303489208,-1.37481096415183
18035,521110.978,5340953.168,170,108,62,38.857,7,2017,1,106,292,169,0.843185364388336,-2.3,19.1582417582418,63,1297.69303489208,-1.37481096415183
18035,521110.978,5340953.168,176,55,121,34.205,0,2018,2,111,302,160,0.823617070296312,-151.3,19.9417582417582,49,1297.69303489208,-1.37481096415183
18035,521110.978,5340953.168,184,154,30,21.056,0,2019,1,130,294,170,0.815327458613181,-73.4,20.0571428571429,40,1297.69303489208,-1.37481096415183
18035,521110.978,5340953.168,152,93,59,23.227,1,2020,1,117,299,177,0.809198091519122,-13.6,18.3758241758242,60,1297.69303489208,-1.37481096415183
18036,521110.978,5340721.512,93,93,0,48.404,7,2001,3,105,299,169,0.864916663398503,116.8,17.4,64,1285.25827182556,-1.4199403338023
18036,521110.978,5340721.512,156,49,107,34.788,0,2002,2,114,308,176,0.850040903182494,52.7,17.567032967033,62,1285.25827182556,-1.4199403338023
18036,521110.978,5340721.512,176,56,120,32.92,0,2003,2,115,285,161,0.83032199891817,-198,22.3252747252747,46,1285.25827182556,-1.4199403338023
18036,521110.978,5340721.512,182,27,155,23.018,0,2004,2,128,319,176,0.860571962530099,209.7,17.0835164835165,48,1285.25827182556,-1.4199403338023
18036,521110.978,5340721.512,174,93,81,30.232,0,2005,1,124,310,176,0.891231991342275,44.2,17.3054945054945,52,1285.25827182556,-1.4199403338023
18036,521110.978,5340721.512,191,66,125,47.243,2,2006,2,108,322,169,0.831910513796598,92.3,18.2626373626374,61,1285.25827182556,-1.4199403338023
18036,521110.978,5340721.512,149,84,65,45.71,0,2007,2,97,307,169,0.848297874454975,332.6,16.5076923076923,72,1285.25827182556,-1.4199403338023
18036,521110.978,5340721.512,157,57,100,28.83,0,2008,3,117,295,192,0.841975571362307,50.1,16.9747252747253,75,1285.25827182556,-1.4199403338023
18036,521110.978,5340721.512,193,62,131,29.922,0,2009,2,115,280,161,0.840287966064425,55,17.8153846153846,46,1285.25827182556,-1.4199403338023
18036,521110.978,5340721.512,179,69,110,19.346,0,2010,2,130,306,178,0.857346522901107,133.1,17.7351648351648,48,1285.25827182556,-1.4199403338023
18036,521110.978,5340721.512,149,93,56,35.44,1,2011,1,97,317,154,0.849087370201591,136.1,17.0351648351648,57,1285.25827182556,-1.4199403338023
18036,521110.978,5340721.512,172,80,92,48.817,1,2012,2,103,308,169,0.854178235408877,88.9,18.4296703296703,66,1285.25827182556,-1.4199403338023
18036,521110.978,5340721.512,199,93,106,17.728,1,2013,2,137,292,216,0.813113340541897,-156.9,18.6175824175824,79,1285.25827182556,-1.4199403338023
18036,521110.978,5340721.512,165,40,125,36.814,3,2014,2,105,323,161,0.824651032492396,191.6,17.4516483516484,56,1285.25827182556,-1.4199403338023
18036,521110.978,5340721.512,174,93,81,36.427,0,2015,1,113,336,168,0.821227064200755,-154.6,20.4153846153846,55,1285.25827182556,-1.4199403338023
18036,521110.978,5340721.512,187,93,94,19.418,0,2016,2,135,306,186,0.845321310770852,50.9,18.5681318681319,51,1285.25827182556,-1.4199403338023
18036,521110.978,5340721.512,171,129,42,40.281,7,2017,1,104,298,168,0.841766372254094,-2.3,19.1582417582418,64,1285.25827182556,-1.4199403338023
18036,521110.978,5340721.512,172,60,112,44.029,0,2018,2,101,300,153,0.819549871522516,-151.3,19.9417582417582,52,1285.25827182556,-1.4199403338023
18036,521110.978,5340721.512,182,150,32,26.669,4,2019,1,124,294,170,0.820625006456003,-73.4,20.0571428571429,46,1285.25827182556,-1.4199403338023
18036,521110.978,5340721.512,151,94,57,26.01,1,2020,1,112,300,176,0.823670699825279,-13.6,18.3758241758242,64,1285.25827182556,-1.4199403338023
18037,521110.978,5340489.855,163,95,68,29.381,0,2001,4,122,297,178,0.879904437325852,116.8,17.4,56,1288.34266811502,-0.482821176652287
18037,521110.978,5340489.855,161,63,98,22.161,0,2002,2,128,304,185,0.873581202730485,52.7,17.567032967033,57,1288.34266811502,-0.482821176652287
18037,521110.978,5340489.855,165,93,72,44.225,1,2003,1,102,298,169,0.836811420890552,-198,22.3252747252747,67,1288.34266811502,-0.482821176652287
18037,521110.978,5340489.855,187,32,155,13.797,0,2004,3,137,294,192,0.858118507446417,209.7,17.0835164835165,55,1288.34266811502,-0.482821176652287
18037,521110.978,5340489.855,178,93,85,22.845,0,2005,1,131,306,178,0.873748294438943,44.2,17.3054945054945,47,1288.34266811502,-0.482821176652287
18037,521110.978,5340489.855,193,65,128,48.615,2,2006,2,107,324,178,0.828766281313572,92.3,18.2626373626374,71,1288.34266811502,-0.482821176652287
18037,521110.978,5340489.855,161,111,50,34.358,0,2007,1,111,298,169,0.8656967811081,332.6,16.5076923076923,58,1288.34266811502,-0.482821176652287
18037,521110.978,5340489.855,181,56,125,18.046,0,2008,2,128,293,184,0.817664210465815,50.1,16.9747252747253,56,1288.34266811502,-0.482821176652287
18037,521110.978,5340489.855,186,62,124,45.038,0,2009,2,100,293,169,0.86328980976284,55,17.8153846153846,69,1288.34266811502,-0.482821176652287
18037,521110.978,5340489.855,192,70,122,20.929,0,2010,3,128,302,185,0.853649474015651,133.1,17.7351648351648,57,1288.34266811502,-0.482821176652287
18037,521110.978,5340489.855,161,68,93,30.511,1,2011,2,103,314,154,0.835531724247555,136.1,17.0351648351648,51,1288.34266811502,-0.482821176652287
18037,521110.978,5340489.855,170,81,89,35.602,0,2012,2,117,306,170,0.862807602164519,88.9,18.4296703296703,53,1288.34266811502,-0.482821176652287
18037,521110.978,5340489.855,204,63,141,13.586,1,2013,2,141,300,201,0.860488995757721,-156.9,18.6175824175824,60,1288.34266811502,-0.482821176652287
18037,521110.978,5340489.855,163,45,118,31.787,0,2014,3,113,322,216,0.833628603776873,191.6,17.4516483516484,103,1288.34266811502,-0.482821176652287
18037,521110.978,5340489.855,173,111,62,43.493,0,2015,1,105,306,161,0.831763716898808,-154.6,20.4153846153846,56,1288.34266811502,-0.482821176652287
18037,521110.978,5340489.855,189,111,78,31.607,0,2016,1,123,301,177,0.888842542870572,50.9,18.5681318681319,54,1288.34266811502,-0.482821176652287
18037,521110.978,5340489.855,154,93,61,27.443,0,2017,1,121,290,170,0.844743436456395,-2.3,19.1582417582418,49,1288.34266811502,-0.482821176652287
18037,521110.978,5340489.855,180,43,137,32.524,0,2018,2,113,297,161,0.829505491633918,-151.3,19.9417582417582,48,1288.34266811502,-0.482821176652287
18037,521110.978,5340489.855,187,81,106,13.016,0,2019,2,138,298,178,0.82487803095785,-73.4,20.0571428571429,40,1288.34266811502,-0.482821176652287
18037,521110.978,5340489.855,0,0,0,22.704,0,2020,0,118,303,184,0.823847927803476,-13.6,18.3758241758242,66,1288.34266811502,-0.482821176652287
18038,521110.978,5340258.199,163,95,68,29.381,0,2001,4,122,297,184,0.877667227193061,116.8,17.4,62,1298.00219282802,1.31638425107226
18038,521110.978,5340258.199,161,63,98,15.412,0,2002,3,135,298,186,0.876952284776128,52.7,17.567032967033,51,1298.00219282802,1.31638425107226
18038,521110.978,5340258.199,165,93,72,42.316,1,2003,1,104,296,176,0.857552603047365,-198,22.3252747252747,72,1298.00219282802,1.31638425107226
18038,521110.978,5340258.199,188,32,156,7.664,0,2004,2,144,294,193,0.842394714518831,209.7,17.0835164835165,49,1298.00219282802,1.31638425107226
18038,521110.978,5340258.199,177,93,84,21.82,0,2005,2,132,304,185,0.87100728764305,44.2,17.3054945054945,53,1298.00219282802,1.31638425107226
18038,521110.978,5340258.199,206,65,141,11.047,1,2006,2,143,318,186,0.831186332206708,92.3,18.2626373626374,43,1298.00219282802,1.31638425107226
18038,521110.978,5340258.199,155,114,41,39.541,0,2007,1,104,293,169,0.889303536014996,332.6,16.5076923076923,65,1298.00219282802,1.31638425107226
18038,521110.978,5340258.199,184,55,129,9.443,0,2008,3,140,289,193,0.859619077676138,50.1,16.9747252747253,53,1298.00219282802,1.31638425107226
18038,521110.978,5340258.199,187,64,123,41.687,0,2009,3,103,291,185,0.84176308793034,55,17.8153846153846,82,1298.00219282802,1.31638425107226
18038,521110.978,5340258.199,201,70,131,12.207,0,2010,4,138,295,185,0.863333312704103,133.1,17.7351648351648,47,1298.00219282802,1.31638425107226
18038,521110.978,5340258.199,162,68,94,25.951,0,2011,2,109,312,161,0.844274283948783,136.1,17.0351648351648,52,1298.00219282802,1.31638425107226
18038,521110.978,5340258.199,172,81,91,35.602,0,2012,2,117,304,170,0.885045224270115,88.9,18.4296703296703,53,1298.00219282802,1.31638425107226
18038,521110.978,5340258.199,202,64,138,14.64,1,2013,3,140,292,200,0.863368538719569,-156.9,18.6175824175824,60,1298.00219282802,1.31638425107226
18038,521110.978,5340258.199,163,44,119,26.087,0,2014,3,122,324,194,0.861228049428929,191.6,17.4516483516484,72,1298.00219282802,1.31638425107226
18038,521110.978,5340258.199,176,93,83,25.057,0,2015,1,125,292,176,0.84932432731831,-154.6,20.4153846153846,51,1298.00219282802,1.31638425107226
18038,521110.978,5340258.199,189,120,69,30.486,0,2016,1,124,297,185,0.901780055514678,50.9,18.5681318681319,61,1298.00219282802,1.31638425107226
18038,521110.978,5340258.199,156,104,52,25.048,0,2017,1,124,285,177,0.846165873921368,-2.3,19.1582417582418,53,1298.00219282802,1.31638425107226
18038,521110.978,5340258.199,176,42,134,30.829,0,2018,2,115,295,169,0.840812429921019,-151.3,19.9417582417582,54,1298.00219282802,1.31638425107226
18038,521110.978,5340258.199,190,81,109,7.543,0,2019,2,144,295,185,0.818439280752711,-73.4,20.0571428571429,41,1298.00219282802,1.31638425107226
18038,521110.978,5340258.199,0,0,0,16.584,0,2020,0,128,303,186,0.813030111626902,-13.6,18.3758241758242,58,1298.00219282802,1.31638425107226
18039,521110.978,5340026.543,0,0,0,20.308,0,2001,2,131,262,193,0.862286249892998,116.8,17.4,62,1282.31749106511,0.963617955073593
18039,521110.978,5340026.543,163,77,86,10.073,0,2002,3,141,306,208,0.854748543015093,52.7,17.567032967033,67,1282.31749106511,0.963617955073593
18039,521110.978,5340026.543,178,68,110,35.425,0,2003,2,112,291,177,0.868278210717385,-198,22.3252747252747,65,1282.31749106511,0.963617955073593
18039,521110.978,5340026.543,185,93,92,1.471,0,2004,2,152,297,201,0.886530473059324,209.7,17.0835164835165,49,1282.31749106511,0.963617955073593
18039,521110.978,5340026.543,182,99,83,14.393,0,2005,1,139,304,186,0.861722052345899,44.2,17.3054945054945,47,1282.31749106511,0.963617955073593
18039,521110.978,5340026.543,196,66,130,6.858,1,2006,2,147,316,186,0.827639477930698,92.3,18.2626373626374,39,1282.31749106511,0.963617955073593
18039,521110.978,5340026.543,162,93,69,29.972,0,2007,1,118,291,177,0.876769902041253,332.6,16.5076923076923,59,1282.31749106511,0.963617955073593
18039,521110.978,5340026.543,172,54,118,4.142,0,2008,3,148,295,201,0.863481002458577,50.1,16.9747252747253,53,1282.31749106511,0.963617955073593
18039,521110.978,5340026.543,192,64,128,16.878,0,2009,2,131,291,193,0.860809010415965,55,17.8153846153846,62,1282.31749106511,0.963617955073593
18039,521110.978,5340026.543,186,73,113,7.045,0,2010,3,144,289,192,0.857948022305391,133.1,17.7351648351648,48,1282.31749106511,0.963617955073593
18039,521110.978,5340026.543,162,93,69,19.977,0,2011,1,118,307,176,0.84288716319597,136.1,17.0351648351648,58,1282.31749106511,0.963617955073593
18039,521110.978,5340026.543,190,81,109,16.465,0,2012,3,136,299,178,0.884005868956495,88.9,18.4296703296703,42,1282.31749106511,0.963617955073593
18039,521110.978,5340026.543,199,93,106,2.474,0,2013,2,151,293,201,0.864385542610512,-156.9,18.6175824175824,50,1282.31749106511,0.963617955073593
18039,521110.978,5340026.543,177,45,132,19.736,0,2014,3,130,304,185,0.867072259679322,191.6,17.4516483516484,55,1282.31749106511,0.963617955073593
18039,521110.978,5340026.543,173,93,80,28.702,0,2015,2,122,296,186,0.85806326138023,-154.6,20.4153846153846,64,1282.31749106511,0.963617955073593
18039,521110.978,5340026.543,199,160,39,22.382,0,2016,1,132,298,192,0.889400311353389,50.9,18.5681318681319,60,1282.31749106511,0.963617955073593
18039,521110.978,5340026.543,160,144,16,17.108,0,2017,1,133,284,178,0.845600963304815,-2.3,19.1582417582418,45,1282.31749106511,0.963617955073593
18039,521110.978,5340026.543,181,74,107,18.537,0,2018,2,131,297,185,0.869813281677172,-151.3,19.9417582417582,54,1282.31749106511,0.963617955073593
18039,521110.978,5340026.543,191,93,98,9.341,0,2019,2,142,289,185,0.819039250300512,-73.4,20.0571428571429,43,1282.31749106511,0.963617955073593
18039,521110.978,5340026.543,158,110,48,8.478,0,2020,1,140,301,193,0.814253845613825,-13.6,18.3758241758242,53,1282.31749106511,0.963617955073593
18040,521110.978,5339794.886,0,0,0,18.481,0,2001,3,133,261,193,0.87130523268147,116.8,17.4,60,1300.21152010071,0.852092995949397
18040,521110.978,5339794.886,165,77,88,4.943,0,2002,3,147,308,200,0.869190110019274,52.7,17.567032967033,53,1300.21152010071,0.852092995949397
18040,521110.978,5339794.886,177,68,109,34.588,0,2003,2,113,284,184,0.803467770187722,-198,22.3252747252747,71,1300.21152010071,0.852092995949397
18040,521110.978,5339794.886,184,93,91,6.945,0,2004,2,160,303,210,0.857772419196489,209.7,17.0835164835165,50,1300.21152010071,0.852092995949397
18040,521110.978,5339794.886,183,93,90,19.829,0,2005,2,134,299,193,0.861658628852031,44.2,17.3054945054945,59,1300.21152010071,0.852092995949397
18040,521110.978,5339794.886,193,62,131,12.087,1,2006,3,142,319,194,0.814928848920854,92.3,18.2626373626374,52,1300.21152010071,0.852092995949397
18040,521110.978,5339794.886,170,93,77,25.614,0,2007,1,125,297,177,0.879820785290609,332.6,16.5076923076923,52,1300.21152010071,0.852092995949397
18040,521110.978,5339794.886,162,58,104,2.86,0,2008,3,150,297,202,0.855571312648321,50.1,16.9747252747253,52,1300.21152010071,0.852092995949397
18040,521110.978,5339794.886,197,63,134,12.08,0,2009,2,137,295,200,0.833487035770636,55,17.8153846153846,63,1300.21152010071,0.852092995949397
18040,521110.978,5339794.886,187,74,113,7.862,0,2010,2,143,285,193,0.860816013893449,133.1,17.7351648351648,50,1300.21152010071,0.852092995949397
18040,521110.978,5339794.886,162,93,69,19.977,0,2011,1,118,312,177,0.825754612644322,136.1,17.0351648351648,59,1300.21152010071,0.852092995949397
18040,521110.978,5339794.886,186,81,105,16.465,0,2012,2,136,304,178,0.861660091236157,88.9,18.4296703296703,42,1300.21152010071,0.852092995949397
18040,521110.978,5339794.886,204,93,111,3.664,0,2013,2,154,293,201,0.840184630824651,-156.9,18.6175824175824,47,1300.21152010071,0.852092995949397
18040,521110.978,5339794.886,179,45,134,16.246,0,2014,2,134,309,185,0.845935800146459,191.6,17.4516483516484,51,1300.21152010071,0.852092995949397
18040,521110.978,5339794.886,175,93,82,16.733,0,2015,2,133,293,185,0.841877539896268,-154.6,20.4153846153846,52,1300.21152010071,0.852092995949397
18040,521110.978,5339794.886,197,156,41,27.214,0,2016,1,127,304,185,0.886863667185917,50.9,18.5681318681319,58,1300.21152010071,0.852092995949397
18040,521110.978,5339794.886,158,123,35,22.582,0,2017,1,127,293,177,0.838215682352964,-2.3,19.1582417582418,50,1300.21152010071,0.852092995949397
18040,521110.978,5339794.886,177,105,72,26.655,0,2018,1,120,301,186,0.814440822183423,-151.3,19.9417582417582,66,1300.21152010071,0.852092995949397
18040,521110.978,5339794.886,190,93,97,13.016,0,2019,2,138,290,185,0.799061599034845,-73.4,20.0571428571429,47,1300.21152010071,0.852092995949397
18040,521110.978,5339794.886,159,108,51,14.77,1,2020,1,131,296,193,0.809399134313456,-13.6,18.3758241758242,62,1300.21152010071,0.852092995949397
18041,521110.978,5339563.23,0,0,0,46.16,0,2001,3,107,274,193,0.848981977058901,116.8,17.4,86,1312.51106919512,0.609235361661781
18041,521110.978,5339563.23,157,52,105,25.202,0,2002,3,125,315,233,0.798630165989317,52.7,17.567032967033,108,1312.51106919512,0.609235361661781
18041,521110.978,5339563.23,171,135,36,31.289,0,2003,1,117,288,168,0.833935685180228,-198,22.3252747252747,51,1312.51106919512,0.609235361661781
18041,521110.978,5339563.23,172,30,142,12.85,0,2004,3,138,325,200,0.855481086063763,209.7,17.0835164835165,62,1312.51106919512,0.609235361661781
18041,521110.978,5339563.23,170,93,77,24.974,0,2005,2,129,307,185,0.884106244827915,44.2,17.3054945054945,56,1312.51106919512,0.609235361661781
18041,521110.978,5339563.23,192,65,127,23.03,1,2006,2,131,328,178,0.814138801267052,92.3,18.2626373626374,47,1312.51106919512,0.609235361661781
18041,521110.978,5339563.23,143,94,49,35.753,0,2007,1,109,297,177,0.867618165781021,332.6,16.5076923076923,68,1312.51106919512,0.609235361661781
18041,521110.978,5339563.23,153,54,99,18.901,0,2008,2,127,300,186,0.849730685063489,50.1,16.9747252747253,59,1312.51106919512,0.609235361661781
18041,521110.978,5339563.23,178,64,114,53.082,0,2009,2,94,299,170,0.874061577676541,55,17.8153846153846,76,1312.51106919512,0.609235361661781
18041,521110.978,5339563.23,184,75,109,17.622,0,2010,2,132,295,185,0.870801608925276,133.1,17.7351648351648,53,1312.51106919512,0.609235361661781
18041,521110.978,5339563.23,137,93,44,23.871,0,2011,1,112,319,162,0.831863822170833,136.1,17.0351648351648,50,1312.51106919512,0.609235361661781
18041,521110.978,5339563.23,178,99,79,34.503,0,2012,1,118,304,177,0.861803103461734,88.9,18.4296703296703,59,1312.51106919512,0.609235361661781
18041,521110.978,5339563.23,180,77,103,16.683,1,2013,3,138,290,185,0.825966683812558,-156.9,18.6175824175824,47,1312.51106919512,0.609235361661781
18041,521110.978,5339563.23,152,39,113,38.138,3,2014,2,103,307,177,0.849345130008084,191.6,17.4516483516484,74,1312.51106919512,0.609235361661781
18041,521110.978,5339563.23,165,93,72,45.375,0,2015,1,103,334,176,0.853652079150074,-154.6,20.4153846153846,73,1312.51106919512,0.609235361661781
18041,521110.978,5339563.23,180,93,87,21.442,0,2016,2,133,326,185,0.899391108452166,50.9,18.5681318681319,52,1312.51106919512,0.609235361661781
18041,521110.978,5339563.23,146,93,53,31.385,3,2017,1,116,290,169,0.828713766108319,-2.3,19.1582417582418,53,1312.51106919512,0.609235361661781
18041,521110.978,5339563.23,172,44,128,36.94,0,2018,2,108,306,177,0.838073854096515,-151.3,19.9417582417582,69,1312.51106919512,0.609235361661781
18041,521110.978,5339563.23,162,132,30,16.853,0,2019,1,134,301,177,0.824536023348779,-73.4,20.0571428571429,43,1312.51106919512,0.609235361661781
18041,521110.978,5339563.23,0,0,0,23.227,0,2020,0,117,308,193,0.811140782324365,-13.6,18.3758241758242,76,1312.51106919512,0.609235361661781
18042,521110.978,5339331.573,0,0,0,58.964,0,2001,2,96,276,185,0.874743546929871,116.8,17.4,89,1243.16563275404,0.11163270954521
18042,521110.978,5339331.573,158,52,106,28.961,0,2002,3,121,314,186,0.869502761156658,52.7,17.567032967033,65,1243.16563275404,0.11163270954521
18042,521110.978,5339331.573,168,101,67,29.642,0,2003,1,119,301,177,0.866348776976707,-198,22.3252747252747,58,1243.16563275404,0.11163270954521
18042,521110.978,5339331.573,171,34,137,22.11,0,2004,3,129,323,184,0.861064067057019,209.7,17.0835164835165,55,1243.16563275404,0.11163270954521
18042,521110.978,5339331.573,172,96,76,32.157,0,2005,2,122,304,185,0.901010530584281,44.2,17.3054945054945,63,1243.16563275404,0.11163270954521
18042,521110.978,5339331.573,185,64,121,30.508,1,2006,2,123,338,177,0.836815577025944,92.3,18.2626373626374,54,1243.16563275404,0.11163270954521
18042,521110.978,5339331.573,143,93,50,43.851,0,2007,1,99,296,170,0.860516014525379,332.6,16.5076923076923,71,1243.16563275404,0.11163270954521
18042,521110.978,5339331.573,151,56,95,18.046,0,2008,3,128,302,186,0.857793827273627,50.1,16.9747252747253,58,1243.16563275404,0.11163270954521
18042,521110.978,5339331.573,183,67,116,35.598,0,2009,2,109,304,169,0.883364904626215,55,17.8153846153846,60,1243.16563275404,0.11163270954521
18042,521110.978,5339331.573,184,75,109,22.475,0,2010,3,126,284,185,0.887677426849646,133.1,17.7351648351648,59,1243.16563275404,0.11163270954521
18042,521110.978,5339331.573,133,93,40,31.308,1,2011,1,102,317,160,0.844797442873225,136.1,17.0351648351648,58,1243.16563275404,0.11163270954521
18042,521110.978,5339331.573,176,93,83,38.92,0,2012,1,114,303,176,0.868782594033957,88.9,18.4296703296703,62,1243.16563275404,0.11163270954521
18042,521110.978,5339331.573,185,78,107,20.729,1,2013,3,134,298,193,0.866737535709151,-156.9,18.6175824175824,59,1243.16563275404,0.11163270954521
18042,521110.978,5339331.573,153,44,109,33.646,0,2014,3,110,315,184,0.854370094144346,191.6,17.4516483516484,74,1243.16563275404,0.11163270954521
18042,521110.978,5339331.573,167,93,74,40.807,0,2015,1,108,334,177,0.877386581611013,-154.6,20.4153846153846,69,1243.16563275404,0.11163270954521
18042,521110.978,5339331.573,181,94,87,16.42,0,2016,2,138,329,209,0.84311321112259,50.9,18.5681318681319,71,1243.16563275404,0.11163270954521
18042,521110.978,5339331.573,142,94,48,34.306,3,2017,1,112,289,170,0.865481982593039,-2.3,19.1582417582418,58,1243.16563275404,0.11163270954521
18042,521110.978,5339331.573,177,45,132,34.205,0,2018,2,111,317,169,0.888471442667047,-151.3,19.9417582417582,58,1243.16563275404,0.11163270954521
18042,521110.978,5339331.573,161,93,68,29.334,4,2019,1,121,298,177,0.866734047224781,-73.4,20.0571428571429,56,1243.16563275404,0.11163270954521
18042,521110.978,5339331.573,0,0,0,24.854,0,2020,0,114,306,232,0.797659361921552,-13.6,18.3758241758242,118,1243.16563275404,0.11163270954521
18068,521110.978,5333308.508,0,0,0,81.235,0,2001,2,78,296,218,0.870368031442979,103.5,18.1120879120879,140,1224.31629617771,0.431321919043421
18068,521110.978,5333308.508,93,71,22,25.084,0,2002,2,125,287,178,0.87947250373948,46.4,18.2428571428571,53,1224.31629617771,0.431321919043421
18068,521110.978,5333308.508,164,93,71,48.165,5,2003,2,98,323,209,0.835171936583518,-203.8,22.9692307692308,111,1224.31629617771,0.431321919043421
18068,521110.978,5333308.508,167,93,74,23.99,0,2004,1,127,330,178,0.873884279730641,196.1,17.7461538461538,51,1224.31629617771,0.431321919043421
18068,521110.978,5333308.508,0,0,0,38.51,0,2005,0,116,310,185,0.884928540795048,38.9,17.9032967032967,69,1224.31629617771,0.431321919043421
18068,521110.978,5333308.508,185,66,119,28.905,0,2006,2,125,330,177,0.859535090223883,82.6,18.867032967033,52,1224.31629617771,0.431321919043421
18068,521110.978,5333308.508,0,0,0,38.424,0,2007,0,105,289,185,0.871765755054827,317.9,17.0824175824176,80,1224.31629617771,0.431321919043421
18068,521110.978,5333308.508,86,52,34,27.767,0,2008,1,118,293,169,0.889005458450026,40.8,17.6131868131868,51,1224.31629617771,0.431321919043421
18068,521110.978,5333308.508,173,98,75,36.411,0,2009,1,108,293,169,0.883271235174337,41,18.5230769230769,61,1224.31629617771,0.431321919043421
18068,521110.978,5333308.508,173,93,80,26.507,0,2010,1,122,305,177,0.895810347998751,122,18.3626373626374,55,1224.31629617771,0.431321919043421
18068,521110.978,5333308.508,0,0,0,33.958,0,2011,0,100,311,200,0.845870753049188,127.1,17.5,100,1224.31629617771,0.431321919043421
18068,521110.978,5333308.508,158,80,78,29.335,0,2012,2,123,308,169,0.870878728505009,82.8,18.7043956043956,46,1224.31629617771,0.431321919043421
18068,521110.978,5333308.508,185,94,91,12.438,0,2013,2,142,303,208,0.885598147431189,-163.1,19.2582417582418,66,1224.31629617771,0.431321919043421
18068,521110.978,5333308.508,86,60,26,32.779,0,2014,1,111,324,169,0.840475715047827,176.9,17.856043956044,58,1224.31629617771,0.431321919043421
18068,521110.978,5333308.508,162,82,80,36.458,0,2015,2,113,299,170,0.860910379255356,-158.6,20.9142857142857,57,1224.31629617771,0.431321919043421
18068,521110.978,5333308.508,173,64,109,14.372,0,2016,2,140,335,185,0.863150660488612,45.5,18.8857142857143,45,1224.31629617771,0.431321919043421
18068,521110.978,5333308.508,126,93,33,32.535,3,2017,1,114,306,178,0.880558118053875,-10.8,19.7879120879121,64,1224.31629617771,0.431321919043421
18068,521110.978,5333308.508,86,63,23,33.134,0,2018,1,113,302,184,0.888607657186508,-154,20.578021978022,71,1224.31629617771,0.431321919043421
18068,521110.978,5333308.508,158,93,65,21.806,0,2019,2,129,329,184,0.880884593656313,-79.8,20.6626373626374,55,1224.31629617771,0.431321919043421
18068,521110.978,5333308.508,93,93,0,31.059,3,2020,2,104,313,226,0.838307492980962,-19.2,19.0648351648352,122,1224.31629617771,0.431321919043421
18129,521110.978,5319177.47,0,0,0,37.145,0,2001,0,114,337,185,0.874021518585488,-27.4,20.4835164835165,71,802.711020357555,0.765351185023868
18129,521110.978,5319177.47,0,0,0,71.774,0,2002,0,76,313,177,0.859112234359502,-6.4,20.3582417582418,101,802.711020357555,0.765351185023868
18129,521110.978,5319177.47,0,0,0,48.243,0,2003,0,92,329,152,0.797674254469218,-214,25.1549450549451,60,802.711020357555,0.765351185023868
18129,521110.978,5319177.47,115,93,22,54.502,0,2004,2,93,322,194,0.828699781935864,89.5,19.9813186813187,101,802.711020357555,0.765351185023868
18129,521110.978,5319177.47,86,82,4,62.249,1,2005,1,91,309,169,0.861949218078572,-56.9,20.0681318681319,78,802.711020357555,0.765351185023868
18129,521110.978,5319177.47,106,93,13,40.376,0,2006,1,110,337,162,0.835875486596338,14.9,21.0197802197802,52,802.711020357555,0.765351185023868
18129,521110.978,5319177.47,0,0,0,97.386,0,2007,0,48,340,217,0.881306440841647,211.1,19.1692307692308,169,802.711020357555,0.765351185023868
18129,521110.978,5319177.47,0,0,0,50.984,0,2008,0,98,304,224,0.869255092097757,-2.3,19.6692307692308,126,802.711020357555,0.765351185023868
18129,521110.978,5319177.47,135,56,79,46.213,0,2009,3,94,319,216,0.845617849731279,-3.7,20.6208791208791,122,802.711020357555,0.765351185023868
18129,521110.978,5319177.47,107,94,13,43.103,0,2010,1,100,299,178,0.862555778470977,49.3,20.289010989011,78,802.711020357555,0.765351185023868
18129,521110.978,5319177.47,95,86,9,91.074,20,2011,2,33,320,162,0.850633682524446,90,19.4703296703297,129,802.711020357555,0.765351185023868
18129,521110.978,5319177.47,0,0,0,56.835,0,2012,0,91,319,169,0.882209951835288,-6.9,20.7978021978022,78,802.711020357555,0.765351185023868
18129,521110.978,5319177.47,148,93,55,47.375,0,2013,1,106,334,178,0.865285105103397,-200.4,21.4142857142857,72,802.711020357555,0.765351185023868
18129,521110.978,5319177.47,0,0,0,72.382,0,2014,0,60,346,178,0.857780047503651,49.7,19.8813186813187,118,802.711020357555,0.765351185023868
18129,521110.978,5319177.47,0,0,0,56.7,0,2015,0,92,340,162,0.866280882891083,-218.5,23.0923076923077,70,802.711020357555,0.765351185023868
18129,521110.978,5319177.47,141,93,48,60.647,1,2016,2,94,337,186,0.909182736305893,-40.7,21.0384615384615,92,802.711020357555,0.765351185023868
18129,521110.978,5319177.47,97,93,4,76.621,4,2017,1,65,312,169,0.855813414056681,-78.7,22.1241758241758,104,802.711020357555,0.765351185023868
18129,521110.978,5319177.47,116,76,40,56.826,1,2018,3,88,348,193,0.857592153037661,-139.1,22.778021978022,105,802.711020357555,0.765351185023868
18129,521110.978,5319177.47,121,93,28,60.002,4,2019,1,86,338,170,0.862027818605229,-119,22.8142857142857,84,802.711020357555,0.765351185023868
18129,521110.978,5319177.47,0,0,0,75.019,0,2020,0,59,311,186,0.854699227894806,-119.1,21.1978021978022,127,802.711020357555,0.765351185023868
18247,521342.634,5342574.762,0,0,0,22.242,0,2001,2,129,288,193,0.869216651565168,116.8,17.4,64,1273.91081940063,-1.04957987757021
18247,521342.634,5342574.762,155,61,94,20.235,0,2002,3,130,289,193,0.859179467898059,52.7,17.567032967033,63,1273.91081940063,-1.04957987757021
18247,521342.634,5342574.762,172,56,116,26.947,0,2003,3,122,291,185,0.822921334287991,-198,22.3252747252747,63,1273.91081940063,-1.04957987757021
18247,521342.634,5342574.762,162,59,103,11.934,0,2004,3,139,307,210,0.856885066075174,209.7,17.0835164835165,71,1273.91081940063,-1.04957987757021
18247,521342.634,5342574.762,163,93,70,24.974,0,2005,2,129,303,185,0.821782727772692,44.2,17.3054945054945,56,1273.91081940063,-1.04957987757021
18247,521342.634,5342574.762,195,56,139,22.033,1,2006,2,132,321,178,0.822699026358024,92.3,18.2626373626374,46,1273.91081940063,-1.04957987757021
18247,521342.634,5342574.762,0,0,0,33.684,0,2007,0,112,286,216,0.816595924995561,332.6,16.5076923076923,104,1273.91081940063,-1.04957987757021
18247,521342.634,5342574.762,173,54,119,14.174,0,2008,3,133,288,201,0.874715966737928,50.1,16.9747252747253,68,1273.91081940063,-1.04957987757021
18247,521342.634,5342574.762,185,65,120,22.397,0,2009,2,124,280,178,0.900562166711232,55,17.8153846153846,54,1273.91081940063,-1.04957987757021
18247,521342.634,5342574.762,175,59,116,15.83,0,2010,2,134,287,186,0.859984888506672,133.1,17.7351648351648,52,1273.91081940063,-1.04957987757021
18247,521342.634,5342574.762,147,71,76,28.941,0,2011,2,105,315,176,0.853063603815747,136.1,17.0351648351648,71,1273.91081940063,-1.04957987757021
18247,521342.634,5342574.762,158,93,65,32.403,0,2012,2,120,303,185,0.861781467174724,88.9,18.4296703296703,65,1273.91081940063,-1.04957987757021
18247,521342.634,5342574.762,182,63,119,15.659,1,2013,3,139,294,210,0.835428780929554,-156.9,18.6175824175824,71,1273.91081940063,-1.04957987757021
18247,521342.634,5342574.762,156,45,111,29.382,0,2014,2,117,322,176,0.826493819678744,191.6,17.4516483516484,59,1273.91081940063,-1.04957987757021
18247,521342.634,5342574.762,169,120,49,30.636,0,2015,1,120,320,185,0.861392130148231,-154.6,20.4153846153846,65,1273.91081940063,-1.04957987757021
18247,521342.634,5342574.762,180,93,87,22.382,0,2016,2,132,324,185,0.894451584615583,50.9,18.5681318681319,53,1273.91081940063,-1.04957987757021
18247,521342.634,5342574.762,144,107,37,25.048,0,2017,1,124,292,184,0.856278553221108,-2.3,19.1582417582418,60,1273.91081940063,-1.04957987757021
18247,521342.634,5342574.762,170,61,109,35.087,0,2018,2,110,304,154,0.923484733977338,-151.3,19.9417582417582,44,1273.91081940063,-1.04957987757021
18247,521342.634,5342574.762,156,99,57,16.853,0,2019,1,134,294,185,0.836799024206293,-73.4,20.0571428571429,51,1273.91081940063,-1.04957987757021
18247,521342.634,5342574.762,0,0,0,21.073,0,2020,0,121,301,193,0.819460441107078,-13.6,18.3758241758242,72,1273.91081940063,-1.04957987757021
18250,521342.634,5341879.793,86,84,2,24.263,0,2001,2,127,282,184,0.833777265675698,116.8,17.4,57,1306.12656347837,-0.626700846272241
18250,521342.634,5341879.793,163,48,115,16.37,0,2002,3,134,299,186,0.860610773738666,52.7,17.567032967033,52,1306.12656347837,-0.626700846272241
18250,521342.634,5341879.793,179,93,86,22.467,0,2003,1,127,268,177,0.844248252938496,-198,22.3252747252747,50,1306.12656347837,-0.626700846272241
18250,521342.634,5341879.793,180,27,153,11.049,0,2004,2,140,289,186,0.821105444613394,209.7,17.0835164835165,46,1306.12656347837,-0.626700846272241
18250,521342.634,5341879.793,180,84,96,22.845,0,2005,2,131,299,178,0.866656852570655,44.2,17.3054945054945,47,1306.12656347837,-0.626700846272241
18250,521342.634,5341879.793,187,63,124,31.467,1,2006,3,122,316,184,0.830437131278835,92.3,18.2626373626374,62,1306.12656347837,-0.626700846272241
18250,521342.634,5341879.793,145,86,59,32.389,0,2007,3,114,284,185,0.821892279222342,332.6,16.5076923076923,71,1306.12656347837,-0.626700846272241
18250,521342.634,5341879.793,153,55,98,10.783,0,2008,3,138,271,193,0.843862455344176,50.1,16.9747252747253,55,1306.12656347837,-0.626700846272241
18250,521342.634,5341879.793,190,61,129,26.517,0,2009,2,119,286,177,0.894887606032304,55,17.8153846153846,58,1306.12656347837,-0.626700846272241
18250,521342.634,5341879.793,169,70,99,10.448,0,2010,2,140,281,185,0.845494291192016,133.1,17.7351648351648,45,1306.12656347837,-0.626700846272241
18250,521342.634,5341879.793,158,103,55,25.951,0,2011,1,109,312,168,0.854302060606391,136.1,17.0351648351648,59,1306.12656347837,-0.626700846272241
18250,521342.634,5341879.793,172,79,93,27.325,0,2012,2,125,296,177,0.866465939881062,88.9,18.4296703296703,52,1306.12656347837,-0.626700846272241
18250,521342.634,5341879.793,202,81,121,11.339,1,2013,2,143,290,193,0.859476436273529,-156.9,18.6175824175824,50,1306.12656347837,-0.626700846272241
18250,521342.634,5341879.793,161,43,118,28.765,0,2014,2,118,321,177,0.845254934580272,191.6,17.4516483516484,59,1306.12656347837,-0.626700846272241
18250,521342.634,5341879.793,169,93,76,29.753,0,2015,1,121,310,176,0.870609784512881,-154.6,20.4153846153846,55,1306.12656347837,-0.626700846272241
18250,521342.634,5341879.793,173,109,64,20.433,0,2016,1,134,313,186,0.868692961159179,50.9,18.5681318681319,52,1306.12656347837,-0.626700846272241
18250,521342.634,5341879.793,151,114,37,22.582,0,2017,1,127,296,177,0.846607082624535,-2.3,19.1582417582418,50,1306.12656347837,-0.626700846272241
18250,521342.634,5341879.793,178,93,85,24.263,0,2018,1,123,303,177,0.843826941250604,-151.3,19.9417582417582,54,1306.12656347837,-0.626700846272241
18250,521342.634,5341879.793,174,97,77,12.101,0,2019,1,139,296,184,0.80622370306392,-73.4,20.0571428571429,45,1306.12656347837,-0.626700846272241
18250,521342.634,5341879.793,151,96,55,15.363,1,2020,1,130,292,178,0.814158668745676,-13.6,18.3758241758242,48,1306.12656347837,-0.626700846272241
18251,521342.634,5341648.137,86,85,1,29.381,0,2001,3,122,291,185,0.836246887289796,116.8,17.4,63,1313.47249318982,-1.25202968250352
18251,521342.634,5341648.137,162,49,113,19.282,0,2002,2,131,302,185,0.857395784870703,52.7,17.567032967033,54,1313.47249318982,-1.25202968250352
18251,521342.634,5341648.137,178,93,85,23.326,0,2003,1,126,269,177,0.841641660597719,-198,22.3252747252747,51,1313.47249318982,-1.25202968250352
18251,521342.634,5341648.137,183,27,156,13.797,0,2004,2,137,297,185,0.836313562875278,209.7,17.0835164835165,48,1313.47249318982,-1.25202968250352
18251,521342.634,5341648.137,171,85,86,29.22,0,2005,3,125,296,184,0.863139398466767,44.2,17.3054945054945,59,1313.47249318982,-1.25202968250352
18251,521342.634,5341648.137,187,63,124,32.448,1,2006,2,121,321,177,0.829534936124933,92.3,18.2626373626374,56,1313.47249318982,-1.25202968250352
18251,521342.634,5341648.137,145,86,59,33.028,0,2007,3,113,281,201,0.795744349974247,332.6,16.5076923076923,88,1313.47249318982,-1.25202968250352
18251,521342.634,5341648.137,152,52,100,12.778,0,2008,3,135,270,194,0.84605409796262,50.1,16.9747252747253,59,1313.47249318982,-1.25202968250352
18251,521342.634,5341648.137,192,61,131,22.397,0,2009,2,124,289,177,0.895276743914986,55,17.8153846153846,53,1313.47249318982,-1.25202968250352
18251,521342.634,5341648.137,168,75,93,16.748,0,2010,2,133,295,178,0.830804317094031,133.1,17.7351648351648,45,1313.47249318982,-1.25202968250352
18251,521342.634,5341648.137,156,93,63,30.511,1,2011,1,103,313,161,0.83150708438006,136.1,17.0351648351648,58,1313.47249318982,-1.25202968250352
18251,521342.634,5341648.137,170,79,91,38.92,0,2012,2,114,293,176,0.856557072261906,88.9,18.4296703296703,62,1313.47249318982,-1.25202968250352
18251,521342.634,5341648.137,190,81,109,40.499,1,2013,3,115,290,192,0.852738847178463,-156.9,18.6175824175824,77,1313.47249318982,-1.25202968250352
18251,521342.634,5341648.137,157,42,115,24.496,0,2014,2,124,321,185,0.838253469290386,191.6,17.4516483516484,61,1313.47249318982,-1.25202968250352
18251,521342.634,5341648.137,170,93,77,27.527,0,2015,1,123,295,176,0.860907879153926,-154.6,20.4153846153846,53,1313.47249318982,-1.25202968250352
18251,521342.634,5341648.137,173,102,71,21.442,0,2016,1,133,308,185,0.860388014425399,50.9,18.5681318681319,52,1313.47249318982,-1.25202968250352
18251,521342.634,5341648.137,150,108,42,23.411,0,2017,1,126,298,170,0.814658322857837,-2.3,19.1582417582418,44,1313.47249318982,-1.25202968250352
18251,521342.634,5341648.137,174,93,81,41.999,0,2018,1,103,307,176,0.826974291730561,-151.3,19.9417582417582,73,1313.47249318982,-1.25202968250352
18251,521342.634,5341648.137,175,138,37,22.081,0,2019,1,129,297,176,0.801624027967189,-73.4,20.0571428571429,47,1313.47249318982,-1.25202968250352
18251,521342.634,5341648.137,151,96,55,17.862,1,2020,1,126,294,184,0.792602191638152,-13.6,18.3758241758242,58,1313.47249318982,-1.25202968250352
18252,521342.634,5341416.481,159,93,66,28.345,0,2001,4,123,292,186,0.841373890424856,116.8,17.4,63,1298.44118445639,1.18979960238502
18252,521342.634,5341416.481,158,60,98,23.157,0,2002,3,127,307,185,0.829683568035273,52.7,17.567032967033,58,1298.44118445639,1.18979960238502
18252,521342.634,5341416.481,168,93,75,24.203,0,2003,1,125,287,177,0.824075397197943,-198,22.3252747252747,52,1298.44118445639,1.18979960238502
18252,521342.634,5341416.481,181,110,71,14.77,0,2004,2,136,296,201,0.89688318514013,209.7,17.0835164835165,65,1298.44118445639,1.18979960238502
18252,521342.634,5341416.481,173,99,74,29.22,0,2005,1,125,298,177,0.845181143271723,44.2,17.3054945054945,52,1298.44118445639,1.18979960238502
18252,521342.634,5341416.481,190,55,135,28.664,1,2006,2,125,325,185,0.809258484486771,92.3,18.2626373626374,60,1298.44118445639,1.18979960238502
18252,521342.634,5341416.481,135,93,42,35.753,0,2007,2,109,287,208,0.765042779087703,332.6,16.5076923076923,99,1298.44118445639,1.18979960238502
18252,521342.634,5341416.481,161,49,112,19.785,0,2008,2,126,283,185,0.827756465019789,50.1,16.9747252747253,59,1298.44118445639,1.18979960238502
18252,521342.634,5341416.481,185,64,121,35.598,0,2009,2,109,283,176,0.876620594530011,55,17.8153846153846,67,1298.44118445639,1.18979960238502
18252,521342.634,5341416.481,172,93,79,15.83,0,2010,1,134,295,178,0.805052981421511,133.1,17.7351648351648,44,1298.44118445639,1.18979960238502
18252,521342.634,5341416.481,152,93,59,28.941,0,2011,1,105,313,161,0.831353609047232,136.1,17.0351648351648,56,1298.44118445639,1.18979960238502
18252,521342.634,5341416.481,180,80,100,32.403,0,2012,2,120,302,177,0.85147793072683,88.9,18.4296703296703,57,1298.44118445639,1.18979960238502
18252,521342.634,5341416.481,198,138,60,18.745,1,2013,1,136,290,192,0.841990013937614,-156.9,18.6175824175824,56,1298.44118445639,1.18979960238502
18252,521342.634,5341416.481,159,45,114,26.087,0,2014,3,122,322,185,0.813164868050648,191.6,17.4516483516484,63,1298.44118445639,1.18979960238502
18252,521342.634,5341416.481,163,93,70,42.595,0,2015,2,106,329,184,0.791876064741894,-154.6,20.4153846153846,78,1298.44118445639,1.18979960238502
18252,521342.634,5341416.481,173,131,42,21.442,0,2016,1,133,313,184,0.837884750727576,50.9,18.5681318681319,51,1298.44118445639,1.18979960238502
18252,521342.634,5341416.481,152,114,38,31.385,3,2017,1,116,292,177,0.819082493747768,-2.3,19.1582417582418,61,1298.44118445639,1.18979960238502
18252,521342.634,5341416.481,179,93,86,32.524,0,2018,2,113,314,161,0.851225345857616,-151.3,19.9417582417582,48,1298.44118445639,1.18979960238502
18252,521342.634,5341416.481,171,101,70,24.842,2,2019,1,126,294,177,0.794018367954439,-73.4,20.0571428571429,51,1298.44118445639,1.18979960238502
18252,521342.634,5341416.481,94,72,22,21.659,1,2020,3,120,297,186,0.790303808980129,-13.6,18.3758241758242,66,1298.44118445639,1.18979960238502
18253,521342.634,5341184.824,160,93,67,27.333,0,2001,4,124,293,185,0.875729270497064,116.8,17.4,61,1253.05700695796,0.0396123079522231
18253,521342.634,5341184.824,160,61,99,21.191,0,2002,3,129,299,186,0.844384637540739,52.7,17.567032967033,57,1253.05700695796,0.0396123079522231
18253,521342.634,5341184.824,169,93,76,25.099,0,2003,1,124,287,169,0.84310887944243,-198,22.3252747252747,45,1253.05700695796,0.0396123079522231
18253,521342.634,5341184.824,182,102,80,11.934,0,2004,2,139,299,201,0.891214374222598,209.7,17.0835164835165,62,1253.05700695796,0.0396123079522231
18253,521342.634,5341184.824,173,100,73,24.974,0,2005,1,129,295,178,0.87025414549993,44.2,17.3054945054945,49,1253.05700695796,0.0396123079522231
18253,521342.634,5341184.824,192,53,139,14.179,1,2006,3,140,322,194,0.852530210649134,92.3,18.2626373626374,54,1253.05700695796,0.0396123079522231
18253,521342.634,5341184.824,138,93,45,33.028,0,2007,2,113,293,209,0.801006062469532,332.6,16.5076923076923,96,1253.05700695796,0.0396123079522231
18253,521342.634,5341184.824,159,50,109,18.901,0,2008,3,127,286,186,0.843330302805925,50.1,16.9747252747253,59,1253.05700695796,0.0396123079522231
18253,521342.634,5341184.824,182,64,118,39.614,0,2009,3,105,287,185,0.886611573180213,55,17.8153846153846,80,1253.05700695796,0.0396123079522231
18253,521342.634,5341184.824,175,93,82,10.448,0,2010,2,140,298,185,0.840149470229703,133.1,17.7351648351648,45,1253.05700695796,0.0396123079522231
18253,521342.634,5341184.824,152,93,59,28.173,0,2011,1,106,307,162,0.856726994341787,136.1,17.0351648351648,56,1253.05700695796,0.0396123079522231
18253,521342.634,5341184.824,181,80,101,25.322,0,2012,2,127,301,178,0.863613630497575,88.9,18.4296703296703,51,1253.05700695796,0.0396123079522231
18253,521342.634,5341184.824,200,93,107,9.09,0,2013,2,145,288,193,0.861926507296087,-156.9,18.6175824175824,48,1253.05700695796,0.0396123079522231
18253,521342.634,5341184.824,154,43,111,24.496,0,2014,3,124,323,186,0.818758598245382,191.6,17.4516483516484,62,1253.05700695796,0.0396123079522231
18253,521342.634,5341184.824,168,124,44,34.827,0,2015,1,115,292,185,0.815315219400677,-154.6,20.4153846153846,70,1253.05700695796,0.0396123079522231
18253,521342.634,5341184.824,173,93,80,13.41,0,2016,2,141,310,185,0.848333078960686,50.9,18.5681318681319,44,1253.05700695796,0.0396123079522231
18253,521342.634,5341184.824,152,116,36,26.643,0,2017,1,122,291,177,0.838896709590449,-2.3,19.1582417582418,55,1253.05700695796,0.0396123079522231
18253,521342.634,5341184.824,180,81,99,27.471,0,2018,2,119,311,162,0.853575942593449,-151.3,19.9417582417582,43,1253.05700695796,0.0396123079522231
18253,521342.634,5341184.824,173,93,80,12.101,0,2019,2,139,297,185,0.814587945553107,-73.4,20.0571428571429,46,1253.05700695796,0.0396123079522231
18253,521342.634,5341184.824,86,73,13,18.51,1,2020,1,125,298,192,0.822870091734412,-13.6,18.3758241758242,67,1253.05700695796,0.0396123079522231
18254,521342.634,5340953.168,86,85,1,29.381,0,2001,3,122,309,177,0.875896694943838,116.8,17.4,55,1292.19815831726,-1.039193108062
18254,521342.634,5340953.168,140,71,69,21.191,0,2002,2,129,307,185,0.864586025102194,52.7,17.567032967033,56,1292.19815831726,-1.039193108062
18254,521342.634,5340953.168,175,136,39,25.099,0,2003,1,124,289,169,0.84830265630359,-198,22.3252747252747,45,1292.19815831726,-1.039193108062
18254,521342.634,5340953.168,169,60,109,15.771,0,2004,2,135,317,178,0.854046255893112,209.7,17.0835164835165,43,1292.19815831726,-1.039193108062
18254,521342.634,5340953.168,173,100,73,27.16,0,2005,1,127,307,177,0.879314376168895,44.2,17.3054945054945,50,1292.19815831726,-1.039193108062
18254,521342.634,5340953.168,186,59,127,40.893,2,2006,3,113,317,185,0.833656846915965,92.3,18.2626373626374,72,1292.19815831726,-1.039193108062
18254,521342.634,5340953.168,0,0,0,32.389,0,2007,0,114,302,170,0.84315292502351,332.6,16.5076923076923,56,1292.19815831726,-1.039193108062
18254,521342.634,5340953.168,180,55,125,16.416,0,2008,3,130,297,193,0.838882635560488,50.1,16.9747252747253,63,1292.19815831726,-1.039193108062
18254,521342.634,5340953.168,182,66,116,50.282,0,2009,3,96,293,192,0.906267165093348,55,17.8153846153846,96,1292.19815831726,-1.039193108062
18254,521342.634,5340953.168,174,73,101,13.1,0,2010,2,137,293,177,0.817103897038631,133.1,17.7351648351648,40,1292.19815831726,-1.039193108062
18254,521342.634,5340953.168,150,93,57,25.242,0,2011,1,110,317,161,0.848973914828571,136.1,17.0351648351648,51,1292.19815831726,-1.039193108062
18254,521342.634,5340953.168,178,104,74,31.399,0,2012,1,121,297,177,0.876204709023889,88.9,18.4296703296703,56,1292.19815831726,-1.039193108062
18254,521342.634,5340953.168,197,93,104,20.729,1,2013,2,134,297,194,0.859666274837745,-156.9,18.6175824175824,60,1292.19815831726,-1.039193108062
18254,521342.634,5340953.168,164,45,119,28.765,0,2014,2,118,326,169,0.814123524397121,191.6,17.4516483516484,51,1292.19815831726,-1.039193108062
18254,521342.634,5340953.168,164,93,71,37.257,0,2015,1,112,331,176,0.831742655699291,-154.6,20.4153846153846,64,1292.19815831726,-1.039193108062
18254,521342.634,5340953.168,184,149,35,19.418,0,2016,1,135,318,185,0.849536371156397,50.9,18.5681318681319,50,1292.19815831726,-1.039193108062
18254,521342.634,5340953.168,150,106,44,30.63,2,2017,1,117,293,178,0.845814632986532,-2.3,19.1582417582418,61,1292.19815831726,-1.039193108062
18254,521342.634,5340953.168,172,78,94,25.848,0,2018,2,121,300,169,0.807389824643301,-151.3,19.9417582417582,48,1292.19815831726,-1.039193108062
18254,521342.634,5340953.168,168,108,60,13.943,0,2019,1,137,289,178,0.812670277996397,-73.4,20.0571428571429,41,1292.19815831726,-1.039193108062
18254,521342.634,5340953.168,84,82,2,20.455,1,2020,1,122,300,184,0.803505877263939,-13.6,18.3758241758242,62,1292.19815831726,-1.039193108062
18255,521342.634,5340721.512,86,86,0,35.888,0,2001,3,116,308,176,0.874726776217669,116.8,17.4,60,1292.73891575397,0.242891599921804
18255,521342.634,5340721.512,139,71,68,27.175,0,2002,2,123,313,185,0.87192658922834,52.7,17.567032967033,62,1292.73891575397,0.242891599921804
18255,521342.634,5340721.512,173,122,51,30.46,0,2003,1,118,289,162,0.835153849269455,-198,22.3252747252747,44,1292.73891575397,0.242891599921804
18255,521342.634,5340721.512,169,60,109,13.797,0,2004,2,137,311,185,0.87550035310912,209.7,17.0835164835165,48,1292.73891575397,0.242891599921804
18255,521342.634,5340721.512,173,99,74,27.16,0,2005,1,127,302,177,0.89780060823776,44.2,17.3054945054945,50,1292.73891575397,0.242891599921804
18255,521342.634,5340721.512,192,58,134,19.112,1,2006,2,135,319,185,0.840130708494837,92.3,18.2626373626374,50,1292.73891575397,0.242891599921804
18255,521342.634,5340721.512,0,0,0,34.358,0,2007,0,111,298,161,0.826502786329441,332.6,16.5076923076923,50,1292.73891575397,0.242891599921804
18255,521342.634,5340721.512,177,52,125,24.594,0,2008,3,121,293,193,0.854380975399043,50.1,16.9747252747253,72,1292.73891575397,0.242891599921804
18255,521342.634,5340721.512,183,66,117,45.038,0,2009,2,100,288,184,0.969213772965283,55,17.8153846153846,84,1292.73891575397,0.242891599921804
18255,521342.634,5340721.512,175,70,105,14.913,0,2010,2,135,299,178,0.842260451153786,133.1,17.7351648351648,43,1292.73891575397,0.242891599921804
18255,521342.634,5340721.512,147,93,54,31.308,1,2011,2,102,314,161,0.842228122882998,136.1,17.0351648351648,59,1292.73891575397,0.242891599921804
18255,521342.634,5340721.512,178,102,76,31.399,0,2012,1,121,294,169,0.870846732212203,88.9,18.4296703296703,48,1292.73891575397,0.242891599921804
18255,521342.634,5340721.512,199,93,106,13.586,1,2013,2,141,290,201,0.8641080891549,-156.9,18.6175824175824,60,1292.73891575397,0.242891599921804
18255,521342.634,5340721.512,158,40,118,33.646,0,2014,3,110,322,202,0.84882901433988,191.6,17.4516483516484,92,1292.73891575397,0.242891599921804
18255,521342.634,5340721.512,169,93,76,35.617,0,2015,2,114,309,168,0.835197432154089,-154.6,20.4153846153846,54,1292.73891575397,0.242891599921804
18255,521342.634,5340721.512,177,93,84,25.207,0,2016,2,129,315,185,0.862817435016415,50.9,18.5681318681319,56,1292.73891575397,0.242891599921804
18255,521342.634,5340721.512,148,93,55,29.833,1,2017,1,118,295,170,0.840097025793062,-2.3,19.1582417582418,52,1292.73891575397,0.242891599921804
18255,521342.634,5340721.512,161,97,64,44.029,0,2018,2,101,304,232,0.781925742439127,-151.3,19.9417582417582,131,1292.73891575397,0.242891599921804
18255,521342.634,5340721.512,167,93,74,16.853,0,2019,1,134,290,178,0.823886562965214,-73.4,20.0571428571429,44,1292.73891575397,0.242891599921804
18255,521342.634,5340721.512,93,86,7,17.862,1,2020,2,126,302,178,0.814408122235714,-13.6,18.3758241758242,52,1292.73891575397,0.242891599921804
18260,521342.634,5339563.23,0,0,0,21.264,0,2001,1,130,298,186,0.862129723717665,116.8,17.4,56,1287.09725084704,1.50529076233184
18260,521342.634,5339563.23,164,78,86,11.812,0,2002,3,139,290,193,0.874342393812891,52.7,17.567032967033,54,1287.09725084704,1.50529076233184
18260,521342.634,5339563.23,173,57,116,24.203,0,2003,2,125,288,178,0.850707526862063,-198,22.3252747252747,53,1287.09725084704,1.50529076233184
18260,521342.634,5339563.23,171,43,128,13.797,0,2004,3,137,329,200,0.84834209321287,209.7,17.0835164835165,63,1287.09725084704,1.50529076233184
18260,521342.634,5339563.23,172,93,79,20.823,0,2005,2,133,306,186,0.886535291683718,44.2,17.3054945054945,53,1287.09725084704,1.50529076233184
18260,521342.634,5339563.23,198,67,131,5.768,1,2006,2,148,326,192,0.820351572310101,92.3,18.2626373626374,44,1287.09725084704,1.50529076233184
18260,521342.634,5339563.23,160,93,67,36.473,0,2007,1,108,298,176,0.869774098474851,332.6,16.5076923076923,68,1287.09725084704,1.50529076233184
18260,521342.634,5339563.23,148,59,89,14.174,0,2008,3,133,299,200,0.853215972218372,50.1,16.9747252747253,67,1287.09725084704,1.50529076233184
18260,521342.634,5339563.23,182,62,120,37.626,0,2009,2,107,289,184,0.867782763178297,55,17.8153846153846,77,1287.09725084704,1.50529076233184
18260,521342.634,5339563.23,176,64,112,16.748,0,2010,2,133,297,185,0.867698835680558,133.1,17.7351648351648,52,1287.09725084704,1.50529076233184
18260,521342.634,5339563.23,93,93,0,27.418,0,2011,2,107,317,186,0.80336439171998,136.1,17.0351648351648,79,1287.09725084704,1.50529076233184
18260,521342.634,5339563.23,174,81,93,29.388,0,2012,2,123,301,177,0.862965626845576,88.9,18.4296703296703,54,1287.09725084704,1.50529076233184
18260,521342.634,5339563.23,188,61,127,13.586,1,2013,3,141,295,192,0.838384254048438,-156.9,18.6175824175824,51,1287.09725084704,1.50529076233184
18260,521342.634,5339563.23,155,52,103,29.981,0,2014,2,116,323,169,0.840082305061496,191.6,17.4516483516484,53,1287.09725084704,1.50529076233184
18260,521342.634,5339563.23,167,93,74,27.527,0,2015,1,123,311,176,0.841604299517458,-154.6,20.4153846153846,53,1287.09725084704,1.50529076233184
18260,521342.634,5339563.23,177,121,56,42.404,7,2016,1,113,321,177,0.888578366426,50.9,18.5681318681319,64,1287.09725084704,1.50529076233184
18260,521342.634,5339563.23,153,93,60,22.582,0,2017,1,127,296,177,0.823278166316003,-2.3,19.1582417582418,50,1287.09725084704,1.50529076233184
18260,521342.634,5339563.23,173,62,111,31.681,0,2018,2,114,298,168,0.856161887196672,-151.3,19.9417582417582,54,1287.09725084704,1.50529076233184
18260,521342.634,5339563.23,167,101,66,14.889,0,2019,1,136,301,184,0.81249737286417,-73.4,20.0571428571429,48,1287.09725084704,1.50529076233184
18260,521342.634,5339563.23,93,73,20,19.829,1,2020,3,123,306,192,0.800245396447335,-13.6,18.3758241758242,69,1287.09725084704,1.50529076233184
18261,521342.634,5339331.573,0,0,0,29.381,0,2001,2,122,299,186,0.874574036687891,116.8,17.4,64,1247.39664459567,-1.43847738131847
18261,521342.634,5339331.573,158,78,80,30.636,0,2002,3,119,292,185,0.877497890203087,52.7,17.567032967033,66,1247.39664459567,-1.43847738131847
18261,521342.634,5339331.573,170,58,112,30.46,0,2003,2,118,287,177,0.854468560090043,-198,22.3252747252747,59,1247.39664459567,-1.43847738131847
18261,521342.634,5339331.573,172,42,130,17.848,0,2004,3,133,330,193,0.840962330565959,209.7,17.0835164835165,60,1247.39664459567,-1.43847738131847
18261,521342.634,5339331.573,168,93,75,33.142,0,2005,2,121,307,184,0.879010893953223,44.2,17.3054945054945,63,1247.39664459567,-1.43847738131847
18261,521342.634,5339331.573,188,67,121,22.033,1,2006,2,132,339,177,0.806479811650097,92.3,18.2626373626374,45,1247.39664459567,-1.43847738131847
18261,521342.634,5339331.573,160,93,67,42.066,0,2007,1,101,299,169,0.868606165781115,332.6,16.5076923076923,68,1247.39664459567,-1.43847738131847
18261,521342.634,5339331.573,143,60,83,13.466,0,2008,3,134,300,201,0.858123459562586,50.1,16.9747252747253,67,1247.39664459567,-1.43847738131847
18261,521342.634,5339331.573,186,64,122,28.202,0,2009,2,117,290,170,0.880216326815923,55,17.8153846153846,53,1247.39664459567,-1.43847738131847
18261,521342.634,5339331.573,175,66,109,20.929,0,2010,3,128,299,185,0.850304386430357,133.1,17.7351648351648,57,1247.39664459567,-1.43847738131847
18261,521342.634,5339331.573,97,95,2,33.726,1,2011,1,99,319,178,0.812985803817313,136.1,17.0351648351648,79,1247.39664459567,-1.43847738131847
18261,521342.634,5339331.573,172,82,90,37.848,0,2012,2,115,300,176,0.868627472739481,88.9,18.4296703296703,61,1247.39664459567,-1.43847738131847
18261,521342.634,5339331.573,187,59,128,23.774,1,2013,3,131,302,250,0.868573655338532,-156.9,18.6175824175824,119,1247.39664459567,-1.43847738131847
18261,521342.634,5339331.573,155,53,102,35.525,1,2014,3,107,322,208,0.850442922085943,191.6,17.4516483516484,101,1247.39664459567,-1.43847738131847
18261,521342.634,5339331.573,160,93,67,39.889,0,2015,1,109,331,170,0.869977848038902,-154.6,20.4153846153846,61,1247.39664459567,-1.43847738131847
18261,521342.634,5339331.573,179,113,66,21.442,0,2016,1,133,327,193,0.864485023105607,50.9,18.5681318681319,60,1247.39664459567,-1.43847738131847
18261,521342.634,5339331.573,152,94,58,28.227,0,2017,1,120,298,170,0.841038968475144,-2.3,19.1582417582418,50,1247.39664459567,-1.43847738131847
18261,521342.634,5339331.573,171,62,109,38.911,0,2018,2,106,317,162,0.86701220473182,-151.3,19.9417582417582,56,1247.39664459567,-1.43847738131847
18261,521342.634,5339331.573,167,101,66,23.928,1,2019,1,127,311,177,0.835873232438864,-73.4,20.0571428571429,50,1247.39664459567,-1.43847738131847
18261,521342.634,5339331.573,86,79,7,24.299,1,2020,1,115,309,193,0.775804286404628,-13.6,18.3758241758242,78,1247.39664459567,-1.43847738131847
18285,521342.634,5333771.821,0,0,0,49.362,0,2001,2,104,326,192,0.876292890780358,103.5,18.1120879120879,88,1071.84122051973,-0.212796934569867
18285,521342.634,5333771.821,155,80,75,29.741,0,2002,3,120,301,202,0.867698953642758,46.4,18.2428571428571,82,1071.84122051973,-0.212796934569867
18285,521342.634,5333771.821,159,100,59,35.12,0,2003,1,112,301,170,0.873545069714202,-203.8,22.9692307692308,58,1071.84122051973,-0.212796934569867
18285,521342.634,5333771.821,164,68,96,29.278,0,2004,2,121,302,178,0.859034429501634,196.1,17.7461538461538,57,1071.84122051973,-0.212796934569867
18285,521342.634,5333771.821,153,97,56,39.638,0,2005,1,115,308,177,0.889340285571435,38.9,17.9032967032967,62,1071.84122051973,-0.212796934569867
18285,521342.634,5333771.821,189,73,116,24.016,0,2006,2,130,326,178,0.869371056503211,82.6,18.867032967033,48,1071.84122051973,-0.212796934569867
18285,521342.634,5333771.821,0,0,0,37.648,0,2007,0,106,288,200,0.859463641646837,317.9,17.0824175824176,94,1071.84122051973,-0.212796934569867
18285,521342.634,5333771.821,134,67,67,24.635,0,2008,3,121,302,216,0.872795544181423,40.8,17.6131868131868,95,1071.84122051973,-0.212796934569867
18285,521342.634,5333771.821,165,83,82,49.053,0,2009,3,97,295,232,0.852971113474057,41,18.5230769230769,135,1071.84122051973,-0.212796934569867
18285,521342.634,5333771.821,168,93,75,25.687,0,2010,2,123,305,185,0.878037719755097,122,18.3626373626374,62,1071.84122051973,-0.212796934569867
18285,521342.634,5333771.821,95,79,16,33.958,1,2011,2,100,310,168,0.888773078754252,127.1,17.5,68,1071.84122051973,-0.212796934569867
18285,521342.634,5333771.821,159,93,66,33.376,0,2012,2,119,313,233,0.866606189688873,82.8,18.7043956043956,114,1071.84122051973,-0.212796934569867
18285,521342.634,5333771.821,167,93,74,15.626,0,2013,2,139,300,186,0.914897179848873,-163.1,19.2582417582418,47,1071.84122051973,-0.212796934569867
18285,521342.634,5333771.821,159,95,64,32.779,0,2014,1,111,315,178,0.87842282290137,176.9,17.856043956044,67,1071.84122051973,-0.212796934569867
18285,521342.634,5333771.821,167,93,74,35.641,0,2015,2,114,333,185,0.868369664864484,-158.6,20.9142857142857,71,1071.84122051973,-0.212796934569867
18285,521342.634,5333771.821,166,93,73,32.703,0,2016,2,122,333,185,0.895778813704116,45.5,18.8857142857143,63,1071.84122051973,-0.212796934569867
18285,521342.634,5333771.821,153,93,60,35.559,5,2017,2,110,296,217,0.881012809614625,-10.8,19.7879120879121,107,1071.84122051973,-0.212796934569867
18285,521342.634,5333771.821,167,62,105,36.816,0,2018,2,109,315,176,0.879657937387878,-154,20.578021978022,67,1071.84122051973,-0.212796934569867
18285,521342.634,5333771.821,145,83,62,29,4,2019,2,121,328,177,0.878791610368239,-79.8,20.6626373626374,56,1071.84122051973,-0.212796934569867
18285,521342.634,5333771.821,105,94,11,27.747,1,2020,2,109,306,209,0.833142780344453,-19.2,19.0648351648352,100,1071.84122051973,-0.212796934569867
18346,521342.634,5319640.783,0,0,0,42.682,0,2001,1,109,322,176,0.854482012663704,-27.4,20.4835164835165,67,938.570217516757,-1.13988079783773
18346,521342.634,5319640.783,86,82,4,48.125,0,2002,1,98,325,170,0.837308860035442,-6.4,20.3582417582418,72,938.570217516757,-1.13988079783773
18346,521342.634,5319640.783,0,0,0,40.303,0,2003,0,101,308,153,0.830124655819447,-214,25.1549450549451,52,938.570217516757,-1.13988079783773
18346,521342.634,5319640.783,138,97,41,40.368,0,2004,2,107,330,210,0.774916500890343,89.5,19.9813186813187,103,938.570217516757,-1.13988079783773
18346,521342.634,5319640.783,140,93,47,64.302,1,2005,2,89,310,154,0.846155023142293,-56.9,20.0681318681319,65,938.570217516757,-1.13988079783773
18346,521342.634,5319640.783,173,73,100,35.499,0,2006,2,115,341,169,0.830554372488038,14.9,21.0197802197802,54,938.570217516757,-1.13988079783773
18346,521342.634,5319640.783,0,0,0,74.644,0,2007,0,67,316,209,0.832563638139648,211.1,19.1692307692308,142,938.570217516757,-1.13988079783773
18346,521342.634,5319640.783,0,0,0,30.668,0,2008,0,116,299,186,0.86515452189093,-2.3,19.6692307692308,70,938.570217516757,-1.13988079783773
18346,521342.634,5319640.783,125,57,68,38.547,0,2009,2,102,311,154,0.856499760962951,-3.7,20.6208791208791,52,938.570217516757,-1.13988079783773
18346,521342.634,5319640.783,154,97,57,32.856,0,2010,1,111,308,177,0.836895482834671,49.3,20.289010989011,66,938.570217516757,-1.13988079783773
18346,521342.634,5319640.783,113,72,41,46.856,1,2011,3,81,323,249,0.823416801265507,90,19.4703296703297,168,938.570217516757,-1.13988079783773
18346,521342.634,5319640.783,0,0,0,50.945,0,2012,0,99,303,186,0.869907848831836,-6.9,20.7978021978022,87,938.570217516757,-1.13988079783773
18346,521342.634,5319640.783,141,61,80,38.417,0,2013,3,115,314,184,0.859141319010455,-200.4,21.4142857142857,69,938.570217516757,-1.13988079783773
18346,521342.634,5319640.783,0,0,0,57.774,0,2014,0,75,341,185,0.865562948084701,49.7,19.8813186813187,110,938.570217516757,-1.13988079783773
18346,521342.634,5319640.783,0,0,0,46.718,0,2015,0,101,334,161,0.836968454194179,-218.5,23.0923076923077,60,938.570217516757,-1.13988079783773
18346,521342.634,5319640.783,158,93,65,55.656,1,2016,2,99,321,184,0.899246730833532,-40.7,21.0384615384615,85,938.570217516757,-1.13988079783773
18346,521342.634,5319640.783,109,93,16,42.356,3,2017,1,98,306,169,0.839749941412489,-78.7,22.1241758241758,71,938.570217516757,-1.13988079783773
18346,521342.634,5319640.783,82,64,18,48.201,0,2018,1,96,303,168,0.874358494449782,-139.1,22.778021978022,72,938.570217516757,-1.13988079783773
18346,521342.634,5319640.783,125,93,32,40.247,1,2019,1,107,325,169,0.8500490924985,-119,22.8142857142857,62,938.570217516757,-1.13988079783773
18346,521342.634,5319640.783,0,0,0,47.247,0,2020,0,83,312,176,0.832869858441464,-119.1,21.1978021978022,93,938.570217516757,-1.13988079783773
18467,521574.291,5342343.106,86,86,0,24.263,0,2001,3,127,291,192,0.880708950635052,116.8,17.4,65,1093.37367760513,-1.26576082808267
18467,521574.291,5342343.106,159,46,113,27.175,0,2002,3,123,284,186,0.860330899570603,52.7,17.567032967033,63,1093.37367760513,-1.26576082808267
18467,521574.291,5342343.106,174,85,89,26.947,0,2003,2,122,299,177,0.883313545734068,-198,22.3252747252747,55,1093.37367760513,-1.26576082808267
18467,521574.291,5342343.106,164,57,107,22.11,0,2004,2,129,324,186,0.880133581316026,209.7,17.0835164835165,57,1093.37367760513,-1.26576082808267
18467,521574.291,5342343.106,180,98,82,28.191,0,2005,1,126,295,170,0.886728891497526,44.2,17.3054945054945,44,1093.37367760513,-1.26576082808267
18467,521574.291,5342343.106,192,55,137,25.077,1,2006,2,129,319,177,0.815955283377459,92.3,18.2626373626374,48,1093.37367760513,-1.26576082808267
18467,521574.291,5342343.106,127,93,34,39.541,0,2007,3,104,284,185,0.846860159639386,332.6,16.5076923076923,81,1093.37367760513,-1.26576082808267
18467,521574.291,5342343.106,178,53,125,18.046,0,2008,2,128,286,186,0.877809138246315,50.1,16.9747252747253,58,1093.37367760513,-1.26576082808267
18467,521574.291,5342343.106,182,55,127,32.652,0,2009,3,112,290,209,0.870278622087939,55,17.8153846153846,97,1093.37367760513,-1.26576082808267
18467,521574.291,5342343.106,170,64,106,16.748,0,2010,3,133,291,209,0.868222627183158,133.1,17.7351648351648,76,1093.37367760513,-1.26576082808267
18467,521574.291,5342343.106,151,93,58,29.721,0,2011,1,104,309,161,0.871657518168593,136.1,17.0351648351648,57,1093.37367760513,-1.26576082808267
18467,521574.291,5342343.106,172,80,92,36.732,0,2012,3,116,303,201,0.87580963405039,88.9,18.4296703296703,85,1093.37367760513,-1.26576082808267
18467,521574.291,5342343.106,190,82,108,10.218,1,2013,3,144,295,193,0.885686401616121,-156.9,18.6175824175824,49,1093.37367760513,-1.26576082808267
18467,521574.291,5342343.106,156,51,105,34.27,1,2014,2,109,322,168,0.850318816059285,191.6,17.4516483516484,59,1093.37367760513,-1.26576082808267
18467,521574.291,5342343.106,175,93,82,29.753,0,2015,1,121,316,177,0.897315878590547,-154.6,20.4153846153846,56,1093.37367760513,-1.26576082808267
18467,521574.291,5342343.106,176,94,82,19.418,0,2016,2,135,310,210,0.87359443268645,50.9,18.5681318681319,75,1093.37367760513,-1.26576082808267
18467,521574.291,5342343.106,150,93,57,29.833,1,2017,2,118,296,184,0.88136783121033,-2.3,19.1582417582418,66,1093.37367760513,-1.26576082808267
18467,521574.291,5342343.106,178,93,85,30.829,0,2018,1,115,314,177,0.894315361838293,-151.3,19.9417582417582,62,1093.37367760513,-1.26576082808267
18467,521574.291,5342343.106,161,93,68,29.334,4,2019,1,121,295,177,0.879670134501808,-73.4,20.0571428571429,56,1093.37367760513,-1.26576082808267
18467,521574.291,5342343.106,150,73,77,25.425,1,2020,2,113,299,177,0.86294905697237,-13.6,18.3758241758242,64,1093.37367760513,-1.26576082808267
18469,521574.291,5341879.793,86,84,2,19.38,0,2001,2,132,283,186,0.858592727415063,116.8,17.4,54,1285.02449908285,-1.03822350907194
18469,521574.291,5341879.793,164,48,116,14.477,0,2002,3,136,285,186,0.875684222140821,52.7,17.567032967033,50,1285.02449908285,-1.03822350907194
18469,521574.291,5341879.793,180,108,72,21.63,0,2003,1,128,284,178,0.850629219124557,-198,22.3252747252747,50,1285.02449908285,-1.03822350907194
18469,521574.291,5341879.793,176,31,145,15.771,0,2004,2,135,294,185,0.827059915786597,209.7,17.0835164835165,50,1285.02449908285,-1.03822350907194
18469,521574.291,5341879.793,180,77,103,20.823,0,2005,4,133,300,184,0.866008843580188,44.2,17.3054945054945,51,1285.02449908285,-1.03822350907194
18469,521574.291,5341879.793,190,63,127,18.152,1,2006,2,136,315,186,0.834988625031723,92.3,18.2626373626374,50,1285.02449908285,-1.03822350907194
18469,521574.291,5341879.793,152,82,70,27.442,0,2007,3,122,282,210,0.811800827075815,332.6,16.5076923076923,88,1285.02449908285,-1.03822350907194
18469,521574.291,5341879.793,153,55,98,10.115,0,2008,3,139,272,194,0.87836450724029,50.1,16.9747252747253,55,1285.02449908285,-1.03822350907194
18469,521574.291,5341879.793,192,58,134,18.436,0,2009,2,129,290,178,0.891299748393978,55,17.8153846153846,49,1285.02449908285,-1.03822350907194
18469,521574.291,5341879.793,171,70,101,8.706,0,2010,2,142,281,193,0.858050286719195,133.1,17.7351648351648,51,1285.02449908285,-1.03822350907194
18469,521574.291,5341879.793,158,93,65,23.21,0,2011,1,113,309,169,0.86940576467029,136.1,17.0351648351648,56,1285.02449908285,-1.03822350907194
18469,521574.291,5341879.793,169,77,92,35.602,0,2012,3,117,306,185,0.863313582768348,88.9,18.4296703296703,68,1285.02449908285,-1.03822350907194
18469,521574.291,5341879.793,200,82,118,5.777,0,2013,3,148,296,201,0.863367454050466,-156.9,18.6175824175824,53,1285.02449908285,-1.03822350907194
18469,521574.291,5341879.793,159,43,116,26.087,0,2014,2,122,319,186,0.85386840726335,191.6,17.4516483516484,64,1285.02449908285,-1.03822350907194
18469,521574.291,5341879.793,168,93,75,26.281,0,2015,2,124,305,192,0.850942149937917,-154.6,20.4153846153846,68,1285.02449908285,-1.03822350907194
18469,521574.291,5341879.793,171,93,78,19.418,0,2016,2,135,300,185,0.856715539120233,50.9,18.5681318681319,50,1285.02449908285,-1.03822350907194
18469,521574.291,5341879.793,149,94,55,17.108,0,2017,2,133,304,193,0.890477865731373,-2.3,19.1582417582418,60,1285.02449908285,-1.03822350907194
18469,521574.291,5341879.793,174,100,74,36.94,0,2018,1,108,306,177,0.868459640580921,-151.3,19.9417582417582,69,1285.02449908285,-1.03822350907194
18469,521574.291,5341879.793,179,142,37,7.543,0,2019,1,144,298,186,0.846586876642875,-73.4,20.0571428571429,42,1285.02449908285,-1.03822350907194
18469,521574.291,5341879.793,154,93,61,14.182,1,2020,2,132,289,185,0.834416704088378,-13.6,18.3758241758242,53,1285.02449908285,-1.03822350907194
18470,521574.291,5341648.137,86,84,2,22.242,0,2001,3,129,282,185,0.855282744979851,116.8,17.4,56,1346.48965434951,-0.618697518157292
18470,521574.291,5341648.137,163,49,114,15.412,0,2002,2,135,304,193,0.843082951751631,52.7,17.567032967033,58,1346.48965434951,-0.618697518157292
18470,521574.291,5341648.137,179,93,86,24.203,0,2003,1,125,271,176,0.821020640087197,-198,22.3252747252747,51,1346.48965434951,-0.618697518157292
18470,521574.291,5341648.137,183,27,156,8.516,0,2004,3,143,293,193,0.801809556627823,209.7,17.0835164835165,50,1346.48965434951,-0.618697518157292
18470,521574.291,5341648.137,180,84,96,23.897,0,2005,3,130,299,178,0.84605254157155,44.2,17.3054945054945,48,1346.48965434951,-0.618697518157292
18470,521574.291,5341648.137,190,63,127,22.033,1,2006,2,132,314,185,0.804132964816456,92.3,18.2626373626374,53,1346.48965434951,-0.618697518157292
18470,521574.291,5341648.137,153,86,67,27.442,0,2007,3,122,283,209,0.780965609094642,332.6,16.5076923076923,87,1346.48965434951,-0.618697518157292
18470,521574.291,5341648.137,152,53,99,13.466,0,2008,3,134,266,192,0.841668336470897,50.1,16.9747252747253,58,1346.48965434951,-0.618697518157292
18470,521574.291,5341648.137,194,62,132,19.221,0,2009,2,128,288,177,0.877008042738467,55,17.8153846153846,49,1346.48965434951,-0.618697518157292
18470,521574.291,5341648.137,167,75,92,8.706,0,2010,2,142,278,185,0.81762874301765,133.1,17.7351648351648,43,1346.48965434951,-0.618697518157292
18470,521574.291,5341648.137,156,93,63,24.549,0,2011,1,111,312,169,0.842433159784092,136.1,17.0351648351648,58,1346.48965434951,-0.618697518157292
18470,521574.291,5341648.137,171,78,93,34.503,0,2012,2,118,290,177,0.85127327991238,88.9,18.4296703296703,59,1346.48965434951,-0.618697518157292
18470,521574.291,5341648.137,189,81,108,44.481,1,2013,3,111,287,192,0.850837700800348,-156.9,18.6175824175824,81,1346.48965434951,-0.618697518157292
18470,521574.291,5341648.137,161,41,120,23.702,0,2014,2,125,317,185,0.83468191436802,191.6,17.4516483516484,60,1346.48965434951,-0.618697518157292
18470,521574.291,5341648.137,168,93,75,32.41,0,2015,2,118,287,184,0.810766371434363,-154.6,20.4153846153846,66,1346.48965434951,-0.618697518157292
18470,521574.291,5341648.137,173,105,68,21.442,0,2016,1,133,306,185,0.855055190541295,50.9,18.5681318681319,52,1346.48965434951,-0.618697518157292
18470,521574.291,5341648.137,151,112,39,22.582,0,2017,1,127,295,170,0.808976084592611,-2.3,19.1582417582418,43,1346.48965434951,-0.618697518157292
18470,521574.291,5341648.137,175,93,82,34.205,0,2018,1,111,296,170,0.853713813727797,-151.3,19.9417582417582,59,1346.48965434951,-0.618697518157292
18470,521574.291,5341648.137,175,135,40,14.889,0,2019,1,136,298,184,0.794033378858642,-73.4,20.0571428571429,48,1346.48965434951,-0.618697518157292
18470,521574.291,5341648.137,150,96,54,17.862,1,2020,2,126,291,186,0.811724406137246,-13.6,18.3758241758242,60,1346.48965434951,-0.618697518157292
18471,521574.291,5341416.481,159,93,66,27.333,0,2001,4,124,295,192,0.820788170676868,116.8,17.4,68,1288.11921119549,0.803403843211981
18471,521574.291,5341416.481,157,61,96,24.173,0,2002,3,126,304,185,0.82187757963289,52.7,17.567032967033,59,1288.11921119549,0.803403843211981
18471,521574.291,5341416.481,167,93,74,28.806,0,2003,1,120,270,169,0.80389077303861,-198,22.3252747252747,49,1288.11921119549,0.803403843211981
18471,521574.291,5341416.481,181,122,59,21.105,0,2004,1,130,290,201,0.890677813057261,209.7,17.0835164835165,71,1288.11921119549,0.803403843211981
18471,521574.291,5341416.481,174,98,76,27.16,0,2005,1,127,291,185,0.828342442673376,44.2,17.3054945054945,58,1288.11921119549,0.803403843211981
18471,521574.291,5341416.481,189,53,136,29.573,1,2006,3,124,323,192,0.808240270133485,92.3,18.2626373626374,68,1288.11921119549,0.803403843211981
18471,521574.291,5341416.481,135,93,42,35.753,0,2007,1,109,292,153,0.829797248325783,332.6,16.5076923076923,44,1288.11921119549,0.803403843211981
18471,521574.291,5341416.481,159,50,109,20.699,0,2008,3,125,286,184,0.820440655674223,50.1,16.9747252747253,59,1288.11921119549,0.803403843211981
18471,521574.291,5341416.481,188,64,124,28.202,0,2009,2,117,283,177,0.875100303565796,55,17.8153846153846,60,1288.11921119549,0.803403843211981
18471,521574.291,5341416.481,175,126,49,20.149,0,2010,1,129,288,178,0.828298591871039,133.1,17.7351648351648,49,1288.11921119549,0.803403843211981
18471,521574.291,5341416.481,147,98,49,29.721,0,2011,1,104,308,162,0.814221753889852,136.1,17.0351648351648,58,1288.11921119549,0.803403843211981
18471,521574.291,5341416.481,182,79,103,32.403,0,2012,2,120,295,177,0.844842710979433,88.9,18.4296703296703,57,1288.11921119549,0.803403843211981
18471,521574.291,5341416.481,198,132,66,18.745,1,2013,1,136,291,193,0.839614381597704,-156.9,18.6175824175824,57,1288.11921119549,0.803403843211981
18471,521574.291,5341416.481,154,46,108,28.133,0,2014,3,119,316,184,0.815788535404981,191.6,17.4516483516484,65,1288.11921119549,0.803403843211981
18471,521574.291,5341416.481,169,132,37,38.991,0,2015,1,110,296,178,0.801737996630566,-154.6,20.4153846153846,68,1288.11921119549,0.803403843211981
18471,521574.291,5341416.481,171,99,72,19.418,0,2016,1,135,299,186,0.849888656621425,50.9,18.5681318681319,51,1288.11921119549,0.803403843211981
18471,521574.291,5341416.481,150,98,52,29.025,0,2017,2,119,291,193,0.828500059156186,-2.3,19.1582417582418,74,1288.11921119549,0.803403843211981
18471,521574.291,5341416.481,173,93,80,39.924,0,2018,1,105,299,161,0.834564229342184,-151.3,19.9417582417582,56,1288.11921119549,0.803403843211981
18471,521574.291,5341416.481,169,93,76,25.763,3,2019,1,125,294,177,0.821649172779981,-73.4,20.0571428571429,52,1288.11921119549,0.803403843211981
18471,521574.291,5341416.481,86,72,14,22.185,1,2020,1,119,295,184,0.789150699919173,-13.6,18.3758241758242,65,1288.11921119549,0.803403843211981
18472,521574.291,5341184.824,160,93,67,28.345,0,2001,4,123,290,192,0.878057025703789,116.8,17.4,69,1160.97027384873,-0.921897216797815
18472,521574.291,5341184.824,158,62,96,24.173,0,2002,3,126,292,185,0.873994529025929,52.7,17.567032967033,59,1160.97027384873,-0.921897216797815
18472,521574.291,5341184.824,166,100,66,32.108,0,2003,1,116,288,184,0.850835820144666,-198,22.3252747252747,68,1160.97027384873,-0.921897216797815
18472,521574.291,5341184.824,173,94,79,18.923,0,2004,2,132,294,194,0.883670581475956,209.7,17.0835164835165,62,1160.97027384873,-0.921897216797815
18472,521574.291,5341184.824,178,93,85,26.07,0,2005,2,128,294,177,0.891387441692635,44.2,17.3054945054945,49,1160.97027384873,-0.921897216797815
18472,521574.291,5341184.824,191,55,136,16.262,1,2006,3,138,321,193,0.866103604624455,92.3,18.2626373626374,55,1160.97027384873,-0.921897216797815
18472,521574.291,5341184.824,136,93,43,35.048,0,2007,1,110,291,153,0.860560737285163,332.6,16.5076923076923,43,1160.97027384873,-0.921897216797815
18472,521574.291,5341184.824,160,52,108,17.218,0,2008,3,129,286,193,0.869757591753873,50.1,16.9747252747253,64,1160.97027384873,-0.921897216797815
18472,521574.291,5341184.824,186,65,121,33.61,0,2009,2,111,287,177,0.901526187148918,55,17.8153846153846,66,1160.97027384873,-0.921897216797815
18472,521574.291,5341184.824,176,93,83,17.622,0,2010,1,132,303,178,0.85994312356538,133.1,17.7351648351648,46,1160.97027384873,-0.921897216797815
18472,521574.291,5341184.824,151,93,58,28.941,0,2011,2,105,310,169,0.868180006221673,136.1,17.0351648351648,64,1160.97027384873,-0.921897216797815
18472,521574.291,5341184.824,182,80,102,24.307,0,2012,2,128,301,177,0.870340653751254,88.9,18.4296703296703,49,1160.97027384873,-0.921897216797815
18472,521574.291,5341184.824,199,93,106,11.339,1,2013,2,143,288,216,0.877006629178264,-156.9,18.6175824175824,73,1160.97027384873,-0.921897216797815
18472,521574.291,5341184.824,158,41,117,30.572,0,2014,3,115,315,201,0.871279213488615,191.6,17.4516483516484,86,1160.97027384873,-0.921897216797815
18472,521574.291,5341184.824,168,115,53,34.827,0,2015,2,115,311,208,0.830451672046528,-154.6,20.4153846153846,93,1160.97027384873,-0.921897216797815
18472,521574.291,5341184.824,171,96,75,19.418,0,2016,1,135,319,178,0.838633776984765,50.9,18.5681318681319,43,1160.97027384873,-0.921897216797815
18472,521574.291,5341184.824,150,99,51,31.385,3,2017,1,116,293,177,0.872285429669071,-2.3,19.1582417582418,61,1160.97027384873,-0.921897216797815
18472,521574.291,5341184.824,177,93,84,34.205,0,2018,1,111,322,170,0.889214231983598,-151.3,19.9417582417582,59,1160.97027384873,-0.921897216797815
18472,521574.291,5341184.824,169,93,76,23.928,1,2019,2,127,296,184,0.851051301942593,-73.4,20.0571428571429,57,1160.97027384873,-0.921897216797815
18472,521574.291,5341184.824,86,73,13,23.227,1,2020,1,117,298,177,0.852488132914046,-13.6,18.3758241758242,60,1160.97027384873,-0.921897216797815
18480,521574.291,5339331.573,0,0,0,46.16,0,2001,2,107,299,185,0.857223537396696,116.8,17.4,78,1226.07842901326,-0.334230493716485
18480,521574.291,5339331.573,160,78,82,26.209,0,2002,2,124,291,186,0.876973717359795,52.7,17.567032967033,62,1226.07842901326,-0.334230493716485
18480,521574.291,5339331.573,170,58,112,31.289,0,2003,2,117,284,176,0.854259278046874,-198,22.3252747252747,59,1226.07842901326,-0.334230493716485
18480,521574.291,5339331.573,173,41,132,16.798,0,2004,3,134,330,208,0.839910315065267,209.7,17.0835164835165,74,1226.07842901326,-0.334230493716485
18480,521574.291,5339331.573,168,93,75,35.225,0,2005,1,119,305,178,0.87464480728306,44.2,17.3054945054945,59,1226.07842901326,-0.334230493716485
18480,521574.291,5339331.573,188,67,121,18.152,1,2006,3,136,327,184,0.785202274362668,92.3,18.2626373626374,48,1226.07842901326,-0.334230493716485
18480,521574.291,5339331.573,159,93,66,45.71,0,2007,1,97,302,168,0.868206215722471,332.6,16.5076923076923,71,1226.07842901326,-0.334230493716485
18480,521574.291,5339331.573,150,60,90,12.108,0,2008,3,136,305,193,0.845341650570436,50.1,16.9747252747253,57,1226.07842901326,-0.334230493716485
18480,521574.291,5339331.573,181,66,115,39.614,0,2009,2,105,291,176,0.867101109045679,55,17.8153846153846,71,1226.07842901326,-0.334230493716485
18480,521574.291,5339331.573,176,64,112,21.716,0,2010,2,127,300,193,0.863139898125263,133.1,17.7351648351648,66,1226.07842901326,-0.334230493716485
18480,521574.291,5339331.573,95,94,1,32.093,1,2011,2,101,321,217,0.779720844093886,136.1,17.0351648351648,116,1226.07842901326,-0.334230493716485
18480,521574.291,5339331.573,175,82,93,30.389,0,2012,2,122,306,176,0.873646986843974,88.9,18.4296703296703,54,1226.07842901326,-0.334230493716485
18480,521574.291,5339331.573,178,61,117,40.499,1,2013,2,115,292,185,0.841506383394826,-156.9,18.6175824175824,70,1226.07842901326,-0.334230493716485
18480,521574.291,5339331.573,156,45,111,35.525,1,2014,3,107,323,209,0.854819583416312,191.6,17.4516483516484,102,1226.07842901326,-0.334230493716485
18480,521574.291,5339331.573,160,93,67,38.991,0,2015,1,110,318,169,0.839908369382145,-154.6,20.4153846153846,59,1226.07842901326,-0.334230493716485
18480,521574.291,5339331.573,182,93,89,20.433,0,2016,2,134,329,185,0.871597116552444,50.9,18.5681318681319,51,1226.07842901326,-0.334230493716485
18480,521574.291,5339331.573,153,94,59,28.227,0,2017,1,120,297,178,0.824318420264402,-2.3,19.1582417582418,58,1226.07842901326,-0.334230493716485
18480,521574.291,5339331.573,168,62,106,49.525,0,2018,2,96,316,169,0.851478624769827,-151.3,19.9417582417582,73,1226.07842901326,-0.334230493716485
18480,521574.291,5339331.573,169,93,76,20.006,0,2019,1,131,299,177,0.816700170431713,-73.4,20.0571428571429,46,1226.07842901326,-0.334230493716485
18480,521574.291,5339331.573,86,72,14,25.425,1,2020,1,113,310,194,0.780486161893015,-13.6,18.3758241758242,81,1226.07842901326,-0.334230493716485
18481,521574.291,5339099.917,178,137,41,28.345,0,2001,3,123,319,193,0.817176388806793,116.8,17.4,70,1176.92656445994,1.44597771530442
18481,521574.291,5339099.917,145,93,52,33.966,0,2002,2,115,293,186,0.840086869559293,52.7,17.567032967033,71,1176.92656445994,1.44597771530442
18481,521574.291,5339099.917,156,59,97,35.425,0,2003,2,112,305,162,0.821371975582118,-198,22.3252747252747,50,1176.92656445994,1.44597771530442
18481,521574.291,5339099.917,150,73,77,30.751,0,2004,3,119,330,192,0.823325461615998,209.7,17.0835164835165,73,1176.92656445994,1.44597771530442
18481,521574.291,5339099.917,148,102,46,40.72,0,2005,1,114,309,177,0.854370285174834,44.2,17.3054945054945,63,1176.92656445994,1.44597771530442
18481,521574.291,5339099.917,193,62,131,28.664,1,2006,2,125,342,170,0.801519118243071,92.3,18.2626373626374,45,1176.92656445994,1.44597771530442
18481,521574.291,5339099.917,93,93,0,45.71,0,2007,2,97,303,186,0.798935925346046,332.6,16.5076923076923,89,1176.92656445994,1.44597771530442
18481,521574.291,5339099.917,160,96,64,24.594,0,2008,1,121,295,177,0.868568413185167,50.1,16.9747252747253,56,1176.92656445994,1.44597771530442
18481,521574.291,5339099.917,167,63,104,43.877,0,2009,2,101,313,153,0.820221133596807,55,17.8153846153846,52,1176.92656445994,1.44597771530442
18481,521574.291,5339099.917,169,93,76,26.78,0,2010,2,120,294,185,0.832430608648345,133.1,17.7351648351648,65,1176.92656445994,1.44597771530442
18481,521574.291,5339099.917,86,57,29,39.022,1,2011,1,93,321,160,0.85189637412363,136.1,17.0351648351648,67,1176.92656445994,1.44597771530442
18481,521574.291,5339099.917,148,95,53,44.549,1,2012,1,108,305,170,0.867512622455853,88.9,18.4296703296703,62,1176.92656445994,1.44597771530442
18481,521574.291,5339099.917,177,70,107,37.581,1,2013,3,118,302,192,0.833534696433456,-156.9,18.6175824175824,74,1176.92656445994,1.44597771530442
18481,521574.291,5339099.917,0,0,0,53.611,0,2014,0,83,316,177,0.811595069759722,191.6,17.4516483516484,94,1176.92656445994,1.44597771530442
18481,521574.291,5339099.917,161,93,68,42.595,0,2015,1,106,336,161,0.812236848894928,-154.6,20.4153846153846,55,1176.92656445994,1.44597771530442
18481,521574.291,5339099.917,177,94,83,35.983,3,2016,1,119,324,176,0.863518914201851,50.9,18.5681318681319,57,1176.92656445994,1.44597771530442
18481,521574.291,5339099.917,138,99,39,43.24,7,2017,1,100,310,169,0.794121076900445,-2.3,19.1582417582418,69,1176.92656445994,1.44597771530442
18481,521574.291,5339099.917,164,74,90,41.999,0,2018,2,103,302,153,0.8268721075576,-151.3,19.9417582417582,50,1176.92656445994,1.44597771530442
18481,521574.291,5339099.917,148,94,54,37.924,4,2019,1,111,309,169,0.809149453056578,-73.4,20.0571428571429,58,1176.92656445994,1.44597771530442
18481,521574.291,5339099.917,0,0,0,39.707,0,2020,0,93,313,192,0.76682134340857,-13.6,18.3758241758242,99,1176.92656445994,1.44597771530442
18482,521574.291,5338868.261,175,127,48,36.992,0,2001,3,115,326,193,0.845099435447229,116.8,17.4,78,1111.03642092185,-1.38044878463605
18482,521574.291,5338868.261,145,93,52,39.887,0,2002,2,108,297,225,0.861690826747595,52.7,17.567032967033,117,1111.03642092185,-1.38044878463605
18482,521574.291,5338868.261,156,61,95,42.316,1,2003,2,104,306,162,0.827915069604483,-198,22.3252747252747,58,1111.03642092185,-1.38044878463605
18482,521574.291,5338868.261,148,73,75,35.22,0,2004,3,114,335,192,0.835889485669349,209.7,17.0835164835165,78,1111.03642092185,-1.38044878463605
18482,521574.291,5338868.261,0,0,0,56.127,0,2005,0,100,309,169,0.835937962403583,44.2,17.3054945054945,69,1111.03642092185,-1.38044878463605
18482,521574.291,5338868.261,185,61,124,37.629,2,2006,2,116,343,169,0.822187548429588,92.3,18.2626373626374,53,1111.03642092185,-1.38044878463605
18482,521574.291,5338868.261,0,0,0,52.881,0,2007,0,90,314,194,0.829077733611107,332.6,16.5076923076923,104,1111.03642092185,-1.38044878463605
18482,521574.291,5338868.261,0,0,0,46.349,0,2008,0,102,307,177,0.856968774240095,50.1,16.9747252747253,75,1111.03642092185,-1.38044878463605
18482,521574.291,5338868.261,168,66,102,37.626,0,2009,3,107,312,224,0.835094522933905,55,17.8153846153846,117,1111.03642092185,-1.38044878463605
18482,521574.291,5338868.261,168,97,71,28.237,0,2010,2,118,291,225,0.876763842794737,133.1,17.7351648351648,107,1111.03642092185,-1.38044878463605
18482,521574.291,5338868.261,86,57,29,40.811,1,2011,1,91,320,154,0.833863237354349,136.1,17.0351648351648,63,1111.03642092185,-1.38044878463605
18482,521574.291,5338868.261,149,99,50,53.706,3,2012,1,97,305,169,0.869877401121028,88.9,18.4296703296703,72,1111.03642092185,-1.38044878463605
18482,521574.291,5338868.261,181,66,115,42.443,1,2013,2,113,303,178,0.848150181080518,-156.9,18.6175824175824,65,1111.03642092185,-1.38044878463605
18482,521574.291,5338868.261,0,0,0,56.074,0,2014,0,80,320,208,0.841608558636532,191.6,17.4516483516484,128,1111.03642092185,-1.38044878463605
18482,521574.291,5338868.261,157,93,64,45.375,0,2015,1,103,337,168,0.861453230708173,-154.6,20.4153846153846,65,1111.03642092185,-1.38044878463605
18482,521574.291,5338868.261,172,93,79,50.412,7,2016,2,106,331,193,0.84835497889534,50.9,18.5681318681319,87,1111.03642092185,-1.38044878463605
18482,521574.291,5338868.261,138,100,38,51.665,7,2017,1,90,310,162,0.829347474466671,-2.3,19.1582417582418,72,1111.03642092185,-1.38044878463605
18482,521574.291,5338868.261,159,75,84,60.009,2,2018,2,87,304,177,0.836799114929565,-151.3,19.9417582417582,90,1111.03642092185,-1.38044878463605
18482,521574.291,5338868.261,151,93,58,40.576,4,2019,1,108,317,162,0.852711125796924,-73.4,20.0571428571429,54,1111.03642092185,-1.38044878463605
18482,521574.291,5338868.261,0,0,0,41.457,0,2020,0,91,312,193,0.810890699309562,-13.6,18.3758241758242,102,1111.03642092185,-1.38044878463605
18565,521574.291,5319640.783,0,0,0,134.911,0,2001,2,30,307,97,1.11960232532362,-27.4,20.4835164835165,67,980.864228259753,0.822996296503809
18565,521574.291,5319640.783,86,82,4,52.644,1,2002,1,93,328,162,0.849921756393113,-6.4,20.3582417582418,69,980.864228259753,0.822996296503809
18565,521574.291,5319640.783,0,0,0,42.01,0,2003,0,99,319,153,0.838058981916591,-214,25.1549450549451,54,980.864228259753,0.822996296503809
18565,521574.291,5319640.783,137,94,43,45.37,0,2004,1,102,332,153,0.777691598781264,89.5,19.9813186813187,51,980.864228259753,0.822996296503809
18565,521574.291,5319640.783,139,93,46,67.403,1,2005,2,86,317,154,0.840680825036859,-56.9,20.0681318681319,68,980.864228259753,0.822996296503809
18565,521574.291,5319640.783,173,75,98,36.428,0,2006,2,114,342,169,0.83847967547873,14.9,21.0197802197802,55,980.864228259753,0.822996296503809
18565,521574.291,5319640.783,0,0,0,75.851,0,2007,0,66,311,217,0.834312595818576,211.1,19.1692307692308,151,980.864228259753,0.822996296503809
18565,521574.291,5319640.783,86,84,2,34.125,0,2008,1,113,302,217,0.838305094669643,-2.3,19.6692307692308,104,980.864228259753,0.822996296503809
18565,521574.291,5319640.783,132,58,74,37.676,0,2009,2,103,314,146,0.841741189538375,-3.7,20.6208791208791,43,980.864228259753,0.822996296503809
18565,521574.291,5319640.783,154,96,58,38.232,0,2010,1,105,309,177,0.841645359434752,49.3,20.289010989011,72,980.864228259753,0.822996296503809
18565,521574.291,5319640.783,114,72,42,47.712,2,2011,3,80,323,242,0.828022998350661,90,19.4703296703297,162,980.864228259753,0.822996296503809
18565,521574.291,5319640.783,120,93,27,55.349,2,2012,2,93,309,209,0.849852302701916,-6.9,20.7978021978022,116,980.864228259753,0.822996296503809
18565,521574.291,5319640.783,139,64,75,44.222,0,2013,2,109,314,177,0.855605395823365,-200.4,21.4142857142857,68,980.864228259753,0.822996296503809
18565,521574.291,5319640.783,0,0,0,61.311,0,2014,0,71,340,193,0.884628892509544,49.7,19.8813186813187,122,980.864228259753,0.822996296503809
18565,521574.291,5319640.783,0,0,0,55.55,0,2015,0,93,331,153,0.850311217889839,-218.5,23.0923076923077,60,980.864228259753,0.822996296503809
18565,521574.291,5319640.783,152,95,57,63.625,1,2016,1,91,327,184,0.894112503816077,-40.7,21.0384615384615,93,980.864228259753,0.822996296503809
18565,521574.291,5319640.783,110,93,17,46.562,3,2017,1,93,310,168,0.837016608286244,-78.7,22.1241758241758,75,980.864228259753,0.822996296503809
18565,521574.291,5319640.783,86,68,18,46.033,0,2018,1,98,295,153,0.870554236989457,-139.1,22.778021978022,55,980.864228259753,0.822996296503809
18565,521574.291,5319640.783,130,96,34,45.934,2,2019,1,101,328,161,0.830263967298991,-119,22.8142857142857,60,980.864228259753,0.822996296503809
18565,521574.291,5319640.783,0,0,0,97.896,0,2020,0,40,318,186,0.817292298928902,-119.1,21.1978021978022,146,980.864228259753,0.822996296503809
18566,521574.291,5319409.127,0,0,0,131.572,0,2001,0,33,312,98,1.08915558999719,-27.4,20.4835164835165,65,979.360756951814,0.57493958904618
18566,521574.291,5319409.127,86,82,4,55.602,1,2002,1,90,324,169,0.865026986283815,-6.4,20.3582417582418,79,979.360756951814,0.57493958904618
18566,521574.291,5319409.127,0,0,0,42.01,0,2003,0,99,327,154,0.850189562910563,-214,25.1549450549451,55,979.360756951814,0.57493958904618
18566,521574.291,5319409.127,138,94,44,45.37,0,2004,1,102,328,169,0.833217444461007,89.5,19.9813186813187,67,979.360756951814,0.57493958904618
18566,521574.291,5319409.127,148,122,26,57.452,1,2005,1,96,311,160,0.860481953902596,-56.9,20.0681318681319,64,979.360756951814,0.57493958904618
18566,521574.291,5319409.127,172,73,99,39.35,0,2006,2,111,342,161,0.836380777547426,14.9,21.0197802197802,50,979.360756951814,0.57493958904618
18566,521574.291,5319409.127,0,0,0,72.329,0,2007,0,69,316,218,0.825782190034007,211.1,19.1692307692308,149,979.360756951814,0.57493958904618
18566,521574.291,5319409.127,86,84,2,31.814,0,2008,1,115,309,225,0.846191493945225,-2.3,19.6692307692308,110,979.360756951814,0.57493958904618
18566,521574.291,5319409.127,131,61,70,36.822,0,2009,2,104,313,146,0.850611431981865,-3.7,20.6208791208791,42,979.360756951814,0.57493958904618
18566,521574.291,5319409.127,154,97,57,35.461,0,2010,1,108,309,177,0.845726392292248,49.3,20.289010989011,69,979.360756951814,0.57493958904618
18566,521574.291,5319409.127,113,72,41,45.182,0,2011,3,83,323,242,0.832073747173782,90,19.4703296703297,159,979.360756951814,0.57493958904618
18566,521574.291,5319409.127,120,93,27,54.623,2,2012,1,94,307,170,0.860485644281183,-6.9,20.7978021978022,76,979.360756951814,0.57493958904618
18566,521574.291,5319409.127,141,63,78,45.242,0,2013,2,108,313,170,0.852393573789083,-200.4,21.4142857142857,62,979.360756951814,0.57493958904618
18566,521574.291,5319409.127,0,0,0,61.311,0,2014,0,71,340,200,0.868984280654633,49.7,19.8813186813187,129,979.360756951814,0.57493958904618
18566,521574.291,5319409.127,0,0,0,49.837,0,2015,0,98,337,153,0.862783968057493,-218.5,23.0923076923077,55,979.360756951814,0.57493958904618
18566,521574.291,5319409.127,157,93,64,58.709,1,2016,1,96,332,169,0.890644891056713,-40.7,21.0384615384615,73,979.360756951814,0.57493958904618
18566,521574.291,5319409.127,111,95,16,49.241,3,2017,1,90,311,162,0.850344157744728,-78.7,22.1241758241758,72,979.360756951814,0.57493958904618
18566,521574.291,5319409.127,86,68,18,46.033,0,2018,1,98,316,168,0.86566628720483,-139.1,22.778021978022,70,979.360756951814,0.57493958904618
18566,521574.291,5319409.127,129,93,36,45.934,2,2019,1,101,328,168,0.844444411471416,-119,22.8142857142857,67,979.360756951814,0.57493958904618
18566,521574.291,5319409.127,0,0,0,46.293,0,2020,0,84,316,169,0.83099205152569,-119.1,21.1978021978022,85,979.360756951814,0.57493958904618
18689,521805.947,5341648.137,93,93,0,24.263,0,2001,4,127,269,185,0.864037418124599,116.8,17.4,58,1319.18844425143,1.08724664549391
18689,521805.947,5341648.137,149,52,97,10.932,0,2002,2,140,306,185,0.820054778642612,52.7,17.567032967033,45,1319.18844425143,1.08724664549391
18689,521805.947,5341648.137,172,65,107,24.203,0,2003,2,125,288,170,0.845761818340018,-198,22.3252747252747,45,1319.18844425143,1.08724664549391
18689,521805.947,5341648.137,173,110,63,7.664,0,2004,1,144,291,192,0.848573226140873,209.7,17.0835164835165,48,1319.18844425143,1.08724664549391
18689,521805.947,5341648.137,171,120,51,21.82,0,2005,1,132,291,184,0.881672463014541,44.2,17.3054945054945,52,1319.18844425143,1.08724664549391
18689,521805.947,5341648.137,198,56,142,3.503,1,2006,2,150,312,201,0.847609373232201,92.3,18.2626373626374,51,1319.18844425143,1.08724664549391
18689,521805.947,5341648.137,158,93,65,29.972,0,2007,1,118,282,177,0.837899152356853,332.6,16.5076923076923,59,1319.18844425143,1.08724664549391
18689,521805.947,5341648.137,177,46,131,7.42,0,2008,3,143,267,201,0.848343105998896,50.1,16.9747252747253,58,1319.18844425143,1.08724664549391
18689,521805.947,5341648.137,187,50,137,17.654,0,2009,2,130,296,185,0.875958017396336,55,17.8153846153846,55,1319.18844425143,1.08724664549391
18689,521805.947,5341648.137,185,76,109,9.572,0,2010,2,141,281,185,0.857859516865993,133.1,17.7351648351648,44,1319.18844425143,1.08724664549391
18689,521805.947,5341648.137,159,60,99,22.565,0,2011,2,114,312,169,0.856617257290118,136.1,17.0351648351648,55,1319.18844425143,1.08724664549391
18689,521805.947,5341648.137,173,78,95,26.328,0,2012,2,126,294,178,0.87072023090913,88.9,18.4296703296703,52,1319.18844425143,1.08724664549391
18689,521805.947,5341648.137,195,60,135,14.64,1,2013,2,140,286,194,0.877689883423723,-156.9,18.6175824175824,54,1319.18844425143,1.08724664549391
18689,521805.947,5341648.137,162,67,95,28.765,0,2014,2,118,305,169,0.870397914987699,191.6,17.4516483516484,51,1319.18844425143,1.08724664549391
18689,521805.947,5341648.137,169,93,76,23.884,0,2015,2,126,332,194,0.838129510114882,-154.6,20.4153846153846,68,1319.18844425143,1.08724664549391
18689,521805.947,5341648.137,180,154,26,13.41,0,2016,1,141,320,185,0.856387879389945,50.9,18.5681318681319,44,1319.18844425143,1.08724664549391
18689,521805.947,5341648.137,147,106,41,18.018,0,2017,1,132,287,178,0.844957337766479,-2.3,19.1582417582418,46,1319.18844425143,1.08724664549391
18689,521805.947,5341648.137,175,94,81,11.645,0,2018,2,140,291,185,0.841943534418472,-151.3,19.9417582417582,45,1319.18844425143,1.08724664549391
18689,521805.947,5341648.137,181,106,75,9.341,0,2019,1,142,296,185,0.837804531766171,-73.4,20.0571428571429,43,1319.18844425143,1.08724664549391
18689,521805.947,5341648.137,141,96,45,15.967,1,2020,2,129,292,193,0.820613811976123,-13.6,18.3758241758242,64,1319.18844425143,1.08724664549391
18690,521805.947,5341416.481,0,0,0,42.649,0,2001,2,110,290,184,0.8560485813343,116.8,17.4,74,1309.02744736911,-0.59563278617659
18690,521805.947,5341416.481,141,66,75,30.636,0,2002,3,119,312,186,0.86112837164372,52.7,17.567032967033,67,1309.02744736911,-0.59563278617659
18690,521805.947,5341416.481,162,93,69,28.806,0,2003,1,120,276,169,0.816172628628299,-198,22.3252747252747,49,1309.02744736911,-0.59563278617659
18690,521805.947,5341416.481,165,117,48,21.105,0,2004,1,130,295,193,0.841820748845693,209.7,17.0835164835165,63,1309.02744736911,-0.59563278617659
18690,521805.947,5341416.481,164,129,35,30.232,0,2005,1,124,297,170,0.829843097676137,44.2,17.3054945054945,46,1309.02744736911,-0.59563278617659
18690,521805.947,5341416.481,190,57,133,35.519,2,2006,2,118,326,185,0.81643961608592,92.3,18.2626373626374,67,1309.02744736911,-0.59563278617659
18690,521805.947,5341416.481,144,94,50,37.96,0,2007,1,106,294,169,0.821533342003797,332.6,16.5076923076923,63,1309.02744736911,-0.59563278617659
18690,521805.947,5341416.481,81,51,30,17.218,0,2008,1,129,286,186,0.836321261617414,50.1,16.9747252747253,57,1309.02744736911,-0.59563278617659
18690,521805.947,5341416.481,180,57,123,37.626,0,2009,2,107,279,178,0.870240670924038,55,17.8153846153846,71,1309.02744736911,-0.59563278617659
18690,521805.947,5341416.481,153,70,83,20.149,0,2010,2,129,296,178,0.839043807587896,133.1,17.7351648351648,49,1309.02744736911,-0.59563278617659
18690,521805.947,5341416.481,143,98,45,29.721,0,2011,1,104,313,169,0.832776188884087,136.1,17.0351648351648,65,1309.02744736911,-0.59563278617659
18690,521805.947,5341416.481,172,80,92,30.389,0,2012,2,122,293,177,0.83547755890932,88.9,18.4296703296703,55,1309.02744736911,-0.59563278617659
18690,521805.947,5341416.481,182,62,120,30.012,1,2013,3,125,294,192,0.84576139577072,-156.9,18.6175824175824,67,1309.02744736911,-0.59563278617659
18690,521805.947,5341416.481,131,47,84,34.27,1,2014,3,109,308,234,0.87929622951828,191.6,17.4516483516484,125,1309.02744736911,-0.59563278617659
18690,521805.947,5341416.481,164,78,86,30.636,0,2015,3,120,312,185,0.819870302210412,-154.6,20.4153846153846,65,1309.02744736911,-0.59563278617659
18690,521805.947,5341416.481,186,93,93,20.433,0,2016,2,134,308,178,0.868529597522805,50.9,18.5681318681319,44,1309.02744736911,-0.59563278617659
18690,521805.947,5341416.481,134,107,27,30.63,2,2017,1,117,288,178,0.822709388569024,-2.3,19.1582417582418,61,1309.02744736911,-0.59563278617659
18690,521805.947,5341416.481,166,55,111,35.998,0,2018,2,109,290,162,0.845689358599117,-151.3,19.9417582417582,53,1309.02744736911,-0.59563278617659
18690,521805.947,5341416.481,158,93,65,20.006,0,2019,2,131,294,185,0.810320264757579,-73.4,20.0571428571429,54,1309.02744736911,-0.59563278617659
18690,521805.947,5341416.481,0,0,0,19.829,0,2020,0,123,295,185,0.791161866465919,-13.6,18.3758241758242,62,1309.02744736911,-0.59563278617659
18701,521805.947,5338868.261,0,0,0,41.484,0,2001,2,111,308,192,0.846653867739358,116.8,17.4,81,1085.76085600478,-1.33787229363379
18701,521805.947,5338868.261,0,0,0,33.158,0,2002,0,116,298,225,0.851798077053516,52.7,17.567032967033,109,1085.76085600478,-1.33787229363379
18701,521805.947,5338868.261,158,78,80,38.746,1,2003,2,108,301,160,0.847335543224651,-198,22.3252747252747,52,1085.76085600478,-1.33787229363379
18701,521805.947,5338868.261,142,85,57,30.751,0,2004,3,119,332,192,0.862300473762441,209.7,17.0835164835165,73,1085.76085600478,-1.33787229363379
18701,521805.947,5338868.261,143,93,50,52.64,0,2005,3,103,317,200,0.849049975634854,44.2,17.3054945054945,97,1085.76085600478,-1.33787229363379
18701,521805.947,5338868.261,177,74,103,34.472,2,2006,3,119,343,240,0.832533780669099,92.3,18.2626373626374,121,1085.76085600478,-1.33787229363379
18701,521805.947,5338868.261,0,0,0,53.959,0,2007,0,89,310,169,0.866813069016727,332.6,16.5076923076923,80,1085.76085600478,-1.33787229363379
18701,521805.947,5338868.261,86,58,28,34.697,0,2008,1,112,303,225,0.859157587716942,50.1,16.9747252747253,113,1085.76085600478,-1.33787229363379
18701,521805.947,5338868.261,170,61,109,64.48,2,2009,2,86,312,169,0.876656291655513,55,17.8153846153846,83,1085.76085600478,-1.33787229363379
18701,521805.947,5338868.261,161,93,68,29.782,0,2010,1,116,293,177,0.847704404288063,133.1,17.7351648351648,61,1085.76085600478,-1.33787229363379
18701,521805.947,5338868.261,121,72,49,40.811,1,2011,2,91,321,161,0.864388780840892,136.1,17.0351648351648,70,1085.76085600478,-1.33787229363379
18701,521805.947,5338868.261,151,93,58,46.311,1,2012,1,106,312,169,0.864303395202026,88.9,18.4296703296703,63,1085.76085600478,-1.33787229363379
18701,521805.947,5338868.261,179,79,100,38.629,1,2013,3,117,304,185,0.859042518354163,-156.9,18.6175824175824,68,1085.76085600478,-1.33787229363379
18701,521805.947,5338868.261,153,96,57,45.36,3,2014,2,93,338,225,0.860803422115125,191.6,17.4516483516484,132,1085.76085600478,-1.33787229363379
18701,521805.947,5338868.261,151,93,58,43.493,0,2015,1,105,334,153,0.845153813719229,-154.6,20.4153846153846,48,1085.76085600478,-1.33787229363379
18701,521805.947,5338868.261,163,98,65,45.77,7,2016,1,110,327,168,0.895065517129619,50.9,18.5681318681319,58,1085.76085600478,-1.33787229363379
18701,521805.947,5338868.261,135,95,40,36.584,6,2017,1,109,314,177,0.842275069823003,-2.3,19.1582417582418,68,1085.76085600478,-1.33787229363379
18701,521805.947,5338868.261,161,93,68,36.94,0,2018,1,108,341,153,0.859939565244117,-151.3,19.9417582417582,45,1085.76085600478,-1.33787229363379
18701,521805.947,5338868.261,147,93,54,40.576,4,2019,1,108,302,170,0.801556067879006,-73.4,20.0571428571429,62,1085.76085600478,-1.33787229363379
18701,521805.947,5338868.261,0,0,0,36.352,0,2020,0,97,308,193,0.808628010776731,-13.6,18.3758241758242,96,1085.76085600478,-1.33787229363379
18785,521805.947,5319409.127,0,0,0,129.373,0,2001,1,35,331,169,0.851920920661386,-27.4,20.4835164835165,134,965.815695080783,-1.50093143024801
18785,521805.947,5319409.127,0,0,0,54.594,0,2002,0,91,323,168,0.854882682141904,-6.4,20.3582417582418,77,965.815695080783,-1.50093143024801
18785,521805.947,5319409.127,133,93,40,45.523,6,2003,1,95,332,152,0.84365101232865,-214,25.1549450549451,57,965.815695080783,-1.50093143024801
18785,521805.947,5319409.127,141,93,48,42.311,0,2004,1,105,332,162,0.848540757093022,89.5,19.9813186813187,57,965.815695080783,-1.50093143024801
18785,521805.947,5319409.127,152,93,59,58.377,1,2005,2,95,313,153,0.858973395982608,-56.9,20.0681318681319,58,965.815695080783,-1.50093143024801
18785,521805.947,5319409.127,166,94,72,50.448,1,2006,1,101,340,160,0.839042869359715,14.9,21.0197802197802,59,965.815695080783,-1.50093143024801
18785,521805.947,5319409.127,0,0,0,72.329,0,2007,0,69,317,154,0.850908630280926,211.1,19.1692307692308,85,965.815695080783,-1.50093143024801
18785,521805.947,5319409.127,0,0,0,37.408,0,2008,0,110,310,217,0.859249796749107,-2.3,19.6692307692308,107,965.815695080783,-1.50093143024801
18785,521805.947,5319409.127,138,63,75,51.739,0,2009,2,89,312,153,0.86487089244435,-3.7,20.6208791208791,64,965.815695080783,-1.50093143024801
18785,521805.947,5319409.127,155,93,62,34.574,0,2010,2,109,311,224,0.856593624496941,49.3,20.289010989011,115,965.815695080783,-1.50093143024801
18785,521805.947,5319409.127,86,80,6,44.365,0,2011,1,84,323,242,0.84001937665951,90,19.4703296703297,158,965.815695080783,-1.50093143024801
18785,521805.947,5319409.127,93,93,0,56.087,2,2012,1,92,311,146,0.834259223843068,-6.9,20.7978021978022,54,965.815695080783,-1.50093143024801
18785,521805.947,5319409.127,154,101,53,46.292,0,2013,1,107,299,169,0.849831176110522,-200.4,21.4142857142857,62,965.815695080783,-1.50093143024801
18785,521805.947,5319409.127,86,68,18,45.312,0,2014,1,90,340,161,0.858898356695405,49.7,19.8813186813187,71,965.815695080783,-1.50093143024801
18785,521805.947,5319409.127,93,93,0,49.837,0,2015,1,98,340,146,0.855684124959252,-218.5,23.0923076923077,48,965.815695080783,-1.50093143024801
18785,521805.947,5319409.127,160,93,67,57.701,1,2016,1,97,333,176,0.882934482897225,-40.7,21.0384615384615,79,965.815695080783,-1.50093143024801
18785,521805.947,5319409.127,112,93,19,51.113,3,2017,1,88,299,161,0.852329905458026,-78.7,22.1241758241758,73,965.815695080783,-1.50093143024801
18785,521805.947,5319409.127,0,0,0,46.033,0,2018,0,98,314,162,0.846390755002069,-139.1,22.778021978022,64,965.815695080783,-1.50093143024801
18785,521805.947,5319409.127,129,93,36,44.96,2,2019,1,102,332,161,0.838106203378231,-119,22.8142857142857,59,965.815695080783,-1.50093143024801
18785,521805.947,5319409.127,86,82,4,44.434,7,2020,1,86,314,177,0.831297593261498,-119.1,21.1978021978022,91,965.815695080783,-1.50093143024801
18786,521805.947,5319177.47,0,0,0,119.76,0,2001,2,43,328,169,0.854954581758618,-27.4,20.4835164835165,126,1003.60462393698,0.413847446084486
18786,521805.947,5319177.47,107,93,14,46.431,0,2002,1,100,324,168,0.845964529014432,-6.4,20.3582417582418,68,1003.60462393698,0.413847446084486
18786,521805.947,5319177.47,0,0,0,42.01,0,2003,0,99,285,153,0.850738892184217,-214,25.1549450549451,54,1003.60462393698,0.413847446084486
18786,521805.947,5319177.47,153,85,68,39.423,0,2004,2,108,329,169,0.848383305371025,89.5,19.9813186813187,61,1003.60462393698,0.413847446084486
18786,521805.947,5319177.47,0,0,0,92.748,0,2005,0,62,313,161,0.860473470895805,-56.9,20.0681318681319,99,1003.60462393698,0.413847446084486
18786,521805.947,5319177.47,170,66,104,40.376,0,2006,2,110,336,161,0.844455098096007,14.9,21.0197802197802,51,1003.60462393698,0.413847446084486
18786,521805.947,5319177.47,0,0,0,75.851,0,2007,0,66,313,218,0.826180278008488,211.1,19.1692307692308,152,1003.60462393698,0.413847446084486
18786,521805.947,5319177.47,0,0,0,38.512,0,2008,0,109,306,225,0.833628416785398,-2.3,19.6692307692308,116,1003.60462393698,0.413847446084486
18786,521805.947,5319177.47,86,62,24,38.547,0,2009,1,102,301,162,0.906818668685834,-3.7,20.6208791208791,60,1003.60462393698,0.413847446084486
18786,521805.947,5319177.47,155,93,62,31.203,0,2010,1,113,302,177,0.844575282694944,49.3,20.289010989011,64,1003.60462393698,0.413847446084486
18786,521805.947,5319177.47,0,0,0,40.234,0,2011,0,89,323,241,0.828154147911021,90,19.4703296703297,152,1003.60462393698,0.413847446084486
18786,521805.947,5319177.47,93,93,0,50.945,2,2012,1,99,307,169,0.90343753062116,-6.9,20.7978021978022,70,1003.60462393698,0.413847446084486
18786,521805.947,5319177.47,146,93,53,48.495,0,2013,1,105,292,160,0.871805729057823,-200.4,21.4142857142857,55,1003.60462393698,0.413847446084486
18786,521805.947,5319177.47,0,0,0,49.428,0,2014,0,85,337,160,0.860855293824515,49.7,19.8813186813187,75,1003.60462393698,0.413847446084486
18786,521805.947,5319177.47,0,0,0,46.718,0,2015,0,101,320,153,0.879460226810279,-218.5,23.0923076923077,52,1003.60462393698,0.413847446084486
18786,521805.947,5319177.47,148,97,51,64.633,1,2016,1,90,330,177,0.878634723741461,-40.7,21.0384615384615,87,1003.60462393698,0.413847446084486
18786,521805.947,5319177.47,117,93,24,47.443,3,2017,1,92,314,161,0.829173296581131,-78.7,22.1241758241758,69,1003.60462393698,0.413847446084486
18786,521805.947,5319177.47,161,72,89,46.033,0,2018,2,98,305,145,0.864470409484776,-139.1,22.778021978022,47,1003.60462393698,0.413847446084486
18786,521805.947,5319177.47,100,95,5,43.051,2,2019,1,104,331,161,0.825802092722278,-119,22.8142857142857,57,1003.60462393698,0.413847446084486
18786,521805.947,5319177.47,86,85,1,35.778,0,2020,1,96,315,168,0.807105326688389,-119.1,21.1978021978022,72,1003.60462393698,0.413847446084486
18900,522037.603,5343501.388,0,0,0,32.137,0,2001,2,119,289,186,0.87522648487442,118,17.3307692307692,67,1237.08858159078,-0.992907684861816
18900,522037.603,5343501.388,134,73,61,25.772,0,2002,3,124,293,185,0.850680776864235,53.4,17.5120879120879,61,1237.08858159078,-0.992907684861816
18900,522037.603,5343501.388,179,65,114,27.419,0,2003,2,121,302,177,0.860454122147967,-198.1,22.256043956044,56,1237.08858159078,-0.992907684861816
18900,522037.603,5343501.388,182,35,147,15.586,0,2004,3,135,329,209,0.858369819960469,210.8,17.0318681318681,74,1237.08858159078,-0.992907684861816
18900,522037.603,5343501.388,161,93,68,31.593,0,2005,2,122,306,200,0.881299005284475,45.7,17.2395604395604,78,1237.08858159078,-0.992907684861816
18900,522037.603,5343501.388,199,63,136,18.792,1,2006,3,135,332,193,0.866102462188516,93.4,18.2021978021978,58,1237.08858159078,-0.992907684861816
18900,522037.603,5343501.388,142,93,49,37.424,0,2007,2,106,290,209,0.852753440784291,334.9,16.4472527472527,103,1237.08858159078,-0.992907684861816
18900,522037.603,5343501.388,182,55,127,26.469,0,2008,3,119,295,193,0.889469672357713,51.4,16.9230769230769,74,1237.08858159078,-0.992907684861816
18900,522037.603,5343501.388,173,57,116,43.498,0,2009,3,101,303,185,0.897930060138001,56.1,17.7604395604396,84,1237.08858159078,-0.992907684861816
18900,522037.603,5343501.388,170,74,96,23.649,0,2010,2,124,295,177,0.867373616995946,134.3,17.6802197802198,53,1237.08858159078,-0.992907684861816
18900,522037.603,5343501.388,142,65,77,29.597,0,2011,2,104,316,169,0.872630011697654,136.8,16.9703296703297,65,1237.08858159078,-0.992907684861816
18900,522037.603,5343501.388,172,93,79,34.981,0,2012,2,117,306,218,0.873547890269631,90.5,18.343956043956,101,1237.08858159078,-0.992907684861816
18900,522037.603,5343501.388,178,64,114,23.358,1,2013,3,131,306,225,0.860163174242252,-155.5,18.543956043956,94,1237.08858159078,-0.992907684861816
18900,522037.603,5343501.388,152,68,84,34.944,1,2014,3,107,323,200,0.857652574046229,192.7,17.3769230769231,93,1237.08858159078,-0.992907684861816
18900,522037.603,5343501.388,166,93,73,31.919,0,2015,1,118,336,177,0.906339845566005,-153.6,20.3384615384615,59,1237.08858159078,-0.992907684861816
18900,522037.603,5343501.388,182,93,89,19.099,0,2016,2,135,329,186,0.876842699048335,52.4,18.4901098901099,51,1237.08858159078,-0.992907684861816
18900,522037.603,5343501.388,122,93,29,28.537,0,2017,2,119,293,192,0.876689082797483,-1.7,19.1,73,1237.08858159078,-0.992907684861816
18900,522037.603,5343501.388,174,93,81,31.365,0,2018,1,114,302,170,0.879738232236409,-150.7,19.8846153846154,56,1237.08858159078,-0.992907684861816
18900,522037.603,5343501.388,154,93,61,23.541,1,2019,2,127,299,184,0.883837690442155,-73,20.0010989010989,57,1237.08858159078,-0.992907684861816
18900,522037.603,5343501.388,86,63,23,27.074,1,2020,1,110,306,240,0.828909397414518,-12.8,18.3098901098901,130,1237.08858159078,-0.992907684861816
18901,522037.603,5343269.732,0,0,0,48.712,0,2001,2,104,296,185,0.867091782794309,118,17.3307692307692,81,1218.27606091131,0.22112170855153
18901,522037.603,5343269.732,154,72,82,26.717,0,2002,2,123,293,178,0.851938222458197,53.4,17.5120879120879,55,1218.27606091131,0.22112170855153
18901,522037.603,5343269.732,174,58,116,38.093,1,2003,2,108,279,168,0.849310449526887,-198.1,22.256043956044,60,1218.27606091131,0.22112170855153
18901,522037.603,5343269.732,167,27,140,22.694,0,2004,3,128,332,272,0.879190366210045,210.8,17.0318681318681,144,1218.27606091131,0.22112170855153
18901,522037.603,5343269.732,157,95,62,42.097,0,2005,1,112,307,176,0.856486357333491,45.7,17.2395604395604,64,1218.27606091131,0.22112170855153
18901,522037.603,5343269.732,196,68,128,27.331,1,2006,2,126,325,170,0.845248622910686,93.4,18.2021978021978,44,1218.27606091131,0.22112170855153
18901,522037.603,5343269.732,148,94,54,40.609,0,2007,2,102,295,224,0.826133023316896,334.9,16.4472527472527,122,1218.27606091131,0.22112170855153
18901,522037.603,5343269.732,176,52,124,19.715,0,2008,3,126,301,210,0.83338565227144,51.4,16.9230769230769,84,1218.27606091131,0.22112170855153
18901,522037.603,5343269.732,192,62,130,26.312,0,2009,3,119,302,169,0.88237064882589,56.1,17.7604395604396,50,1218.27606091131,0.22112170855153
18901,522037.603,5343269.732,173,72,101,23.649,0,2010,2,124,310,170,0.834213238015891,134.3,17.6802197802198,46,1218.27606091131,0.22112170855153
18901,522037.603,5343269.732,93,93,0,34.361,1,2011,1,98,320,154,0.83212607097593,136.8,16.9703296703297,56,1218.27606091131,0.22112170855153
18901,522037.603,5343269.732,166,81,85,39.243,0,2012,2,113,312,177,0.878573065628124,90.5,18.343956043956,64,1218.27606091131,0.22112170855153
18901,522037.603,5343269.732,176,77,99,30.592,1,2013,3,124,305,185,0.840169298687522,-155.5,18.543956043956,61,1218.27606091131,0.22112170855153
18901,522037.603,5343269.732,158,94,64,40.947,3,2014,1,98,324,161,0.831902942435065,192.7,17.3769230769231,63,1218.27606091131,0.22112170855153
18901,522037.603,5343269.732,157,93,64,40.17,0,2015,1,108,340,162,0.861039055967658,-153.6,20.3384615384615,54,1218.27606091131,0.22112170855153
18901,522037.603,5343269.732,186,93,93,22.016,0,2016,2,132,319,194,0.859051645747361,52.4,18.4901098901099,62,1218.27606091131,0.22112170855153
18901,522037.603,5343269.732,151,94,57,34.45,4,2017,1,111,301,177,0.846864592118597,-1.7,19.1,66,1218.27606091131,0.22112170855153
18901,522037.603,5343269.732,179,69,110,33.012,0,2018,2,112,303,161,0.866047560881348,-150.7,19.8846153846154,49,1218.27606091131,0.22112170855153
18901,522037.603,5343269.732,160,93,67,27.975,4,2019,1,122,299,170,0.818159136772123,-73,20.0010989010989,48,1218.27606091131,0.22112170855153
18901,522037.603,5343269.732,0,0,0,29.59,0,2020,0,106,307,170,0.801975254160665,-12.8,18.3098901098901,64,1218.27606091131,0.22112170855153
18902,522037.603,5343038.075,0,0,0,53.456,0,2001,2,100,290,178,0.874784626933394,118,17.3307692307692,78,1211.34845090114,-0.152769428662718
18902,522037.603,5343038.075,154,71,83,26.717,0,2002,3,123,292,184,0.864416959307366,53.4,17.5120879120879,61,1211.34845090114,-0.152769428662718
18902,522037.603,5343038.075,175,58,117,38.093,1,2003,2,108,284,162,0.856350635551006,-198.1,22.256043956044,54,1211.34845090114,-0.152769428662718
18902,522037.603,5343038.075,168,28,140,25.305,0,2004,2,125,333,177,0.85662297418493,210.8,17.0318681318681,52,1211.34845090114,-0.152769428662718
18902,522037.603,5343038.075,159,95,64,45.369,0,2005,1,109,300,176,0.870232215685616,45.7,17.2395604395604,67,1211.34845090114,-0.152769428662718
18902,522037.603,5343038.075,185,67,118,54.354,3,2006,2,102,323,178,0.852292919741658,93.4,18.2021978021978,76,1211.34845090114,-0.152769428662718
18902,522037.603,5343038.075,136,94,42,52.057,2,2007,2,90,293,184,0.854419636572477,334.9,16.4472527472527,94,1211.34845090114,-0.152769428662718
18902,522037.603,5343038.075,175,50,125,14.167,0,2008,3,133,297,225,0.851582900845477,51.4,16.9230769230769,92,1211.34845090114,-0.152769428662718
18902,522037.603,5343038.075,193,62,131,23.858,0,2009,2,122,307,169,0.896033487676834,56.1,17.7604395604396,47,1211.34845090114,-0.152769428662718
18902,522037.603,5343038.075,169,73,96,23.649,0,2010,2,124,309,177,0.835062123984717,134.3,17.6802197802198,53,1211.34845090114,-0.152769428662718
18902,522037.603,5343038.075,0,0,0,35.21,0,2011,0,97,318,154,0.828215600663131,136.8,16.9703296703297,57,1211.34845090114,-0.152769428662718
18902,522037.603,5343038.075,165,81,84,40.189,0,2012,2,112,313,177,0.878060966789415,90.5,18.343956043956,65,1211.34845090114,-0.152769428662718
18902,522037.603,5343038.075,173,78,95,37.967,1,2013,3,117,303,218,0.797803906417267,-155.5,18.543956043956,101,1211.34845090114,-0.152769428662718
18902,522037.603,5343038.075,158,94,64,39.539,3,2014,1,100,321,161,0.826311686234379,192.7,17.3769230769231,61,1211.34845090114,-0.152769428662718
18902,522037.603,5343038.075,157,93,64,41.066,0,2015,1,107,336,169,0.872799347198608,-153.6,20.3384615384615,62,1211.34845090114,-0.152769428662718
18902,522037.603,5343038.075,179,93,86,26.773,0,2016,1,127,318,178,0.860990312925774,52.4,18.4901098901099,51,1211.34845090114,-0.152769428662718
18902,522037.603,5343038.075,156,93,63,31.555,3,2017,1,115,295,177,0.84986231223649,-1.7,19.1,62,1211.34845090114,-0.152769428662718
18902,522037.603,5343038.075,180,66,114,32.196,0,2018,2,113,321,169,0.869940162678724,-150.7,19.8846153846154,56,1211.34845090114,-0.152769428662718
18902,522037.603,5343038.075,165,93,72,30.625,4,2019,1,119,306,178,0.822327798522304,-73,20.0010989010989,59,1211.34845090114,-0.152769428662718
18902,522037.603,5343038.075,0,0,0,36.857,0,2020,0,96,306,169,0.803919641271583,-12.8,18.3098901098901,73,1211.34845090114,-0.152769428662718
18908,522037.603,5341648.137,93,93,0,27.333,0,2001,4,124,270,185,0.879399384259974,116.8,17.4,61,1255.36257426801,-0.809667849184292
18908,522037.603,5341648.137,146,53,93,17.347,0,2002,3,133,307,186,0.843050238124201,52.7,17.567032967033,53,1255.36257426801,-0.809667849184292
18908,522037.603,5341648.137,172,65,107,22.467,0,2003,2,127,308,177,0.852641298811026,-198,22.3252747252747,50,1255.36257426801,-0.809667849184292
18908,522037.603,5341648.137,171,97,74,11.934,0,2004,1,139,286,186,0.867097522610646,209.7,17.0835164835165,47,1255.36257426801,-0.809667849184292
18908,522037.603,5341648.137,169,120,49,27.16,0,2005,1,127,291,178,0.886462598261807,44.2,17.3054945054945,51,1255.36257426801,-0.809667849184292
18908,522037.603,5341648.137,196,56,140,6.858,1,2006,2,147,312,200,0.861301329186545,92.3,18.2626373626374,53,1255.36257426801,-0.809667849184292
18908,522037.603,5341648.137,144,93,51,35.753,0,2007,2,109,281,217,0.799495607129265,332.6,16.5076923076923,108,1255.36257426801,-0.809667849184292
18908,522037.603,5341648.137,180,46,134,10.783,0,2008,3,138,272,210,0.888305790376724,50.1,16.9747252747253,72,1255.36257426801,-0.809667849184292
18908,522037.603,5341648.137,188,53,135,19.221,0,2009,2,128,299,177,0.883047558666675,55,17.8153846153846,49,1255.36257426801,-0.809667849184292
18908,522037.603,5341648.137,180,77,103,17.622,0,2010,2,132,306,178,0.871519541561591,133.1,17.7351648351648,46,1255.36257426801,-0.809667849184292
18908,522037.603,5341648.137,155,69,86,24.549,0,2011,2,111,310,169,0.868103229471914,136.1,17.0351648351648,58,1255.36257426801,-0.809667849184292
18908,522037.603,5341648.137,172,78,94,30.389,0,2012,2,122,305,177,0.876839705068347,88.9,18.4296703296703,55,1255.36257426801,-0.809667849184292
18908,522037.603,5341648.137,193,62,131,19.732,1,2013,2,135,283,201,0.894554584653235,-156.9,18.6175824175824,66,1255.36257426801,-0.809667849184292
18908,522037.603,5341648.137,162,60,102,28.765,0,2014,2,118,301,170,0.876474622353873,191.6,17.4516483516484,52,1255.36257426801,-0.809667849184292
18908,522037.603,5341648.137,166,93,73,38.991,0,2015,2,110,329,208,0.854334080504144,-154.6,20.4153846153846,98,1255.36257426801,-0.809667849184292
18908,522037.603,5341648.137,180,156,24,11.421,0,2016,1,143,316,185,0.872856115179594,50.9,18.5681318681319,42,1255.36257426801,-0.809667849184292
18908,522037.603,5341648.137,149,125,24,20.746,0,2017,1,129,292,185,0.872985022646377,-2.3,19.1582417582418,56,1255.36257426801,-0.809667849184292
18908,522037.603,5341648.137,175,93,82,9.118,0,2018,2,143,296,186,0.841400094450094,-151.3,19.9417582417582,43,1255.36257426801,-0.809667849184292
18908,522037.603,5341648.137,171,109,62,23.027,0,2019,1,128,300,185,0.859308719308071,-73.4,20.0571428571429,57,1255.36257426801,-0.809667849184292
18908,522037.603,5341648.137,145,105,40,19.169,1,2020,1,124,303,186,0.829579466765885,-13.6,18.3758241758242,62,1255.36257426801,-0.809667849184292
18909,522037.603,5341416.481,0,0,0,42.649,0,2001,2,110,293,178,0.860893670841203,116.8,17.4,68,1279.61097229202,1.16362576377297
18909,522037.603,5341416.481,143,67,76,27.175,0,2002,3,123,310,185,0.865116683232194,52.7,17.567032967033,62,1279.61097229202,1.16362576377297
18909,522037.603,5341416.481,160,94,66,32.92,0,2003,1,115,301,169,0.815582889159439,-198,22.3252747252747,54,1279.61097229202,1.16362576377297
18909,522037.603,5341416.481,163,120,43,16.798,0,2004,1,134,302,185,0.867879170792972,209.7,17.0835164835165,51,1279.61097229202,1.16362576377297
18909,522037.603,5341416.481,164,129,35,31.202,0,2005,1,123,305,177,0.842913787455584,44.2,17.3054945054945,54,1279.61097229202,1.16362576377297
18909,522037.603,5341416.481,190,61,129,28.664,1,2006,2,125,325,184,0.839518515474832,92.3,18.2626373626374,59,1279.61097229202,1.16362576377297
18909,522037.603,5341416.481,142,93,49,35.048,0,2007,2,110,298,209,0.800801734979878,332.6,16.5076923076923,99,1279.61097229202,1.16362576377297
18909,522037.603,5341416.481,86,54,32,16.416,0,2008,1,130,290,194,0.858895337201349,50.1,16.9747252747253,64,1279.61097229202,1.16362576377297
18909,522037.603,5341416.481,188,59,129,25.678,0,2009,4,120,298,185,0.854199459588072,55,17.8153846153846,65,1279.61097229202,1.16362576377297
18909,522037.603,5341416.481,153,72,81,20.149,0,2010,3,129,305,184,0.848003106167162,133.1,17.7351648351648,55,1279.61097229202,1.16362576377297
18909,522037.603,5341416.481,146,93,53,31.308,1,2011,2,102,315,169,0.843842069201956,136.1,17.0351648351648,67,1279.61097229202,1.16362576377297
18909,522037.603,5341416.481,175,80,95,30.389,0,2012,2,122,296,177,0.857903623625494,88.9,18.4296703296703,55,1279.61097229202,1.16362576377297
18909,522037.603,5341416.481,186,63,123,23.774,1,2013,2,131,289,193,0.861788191947176,-156.9,18.6175824175824,62,1279.61097229202,1.16362576377297
18909,522037.603,5341416.481,127,41,86,34.896,1,2014,3,108,309,185,0.834910648432809,191.6,17.4516483516484,77,1279.61097229202,1.16362576377297
18909,522037.603,5341416.481,168,77,91,34.827,0,2015,2,115,308,177,0.85738286439083,-154.6,20.4153846153846,62,1279.61097229202,1.16362576377297
18909,522037.603,5341416.481,184,101,83,17.425,0,2016,1,137,315,184,0.862923081252791,50.9,18.5681318681319,47,1279.61097229202,1.16362576377297
18909,522037.603,5341416.481,133,107,26,25.048,0,2017,1,124,291,184,0.832250207345014,-2.3,19.1582417582418,60,1279.61097229202,1.16362576377297
18909,522037.603,5341416.481,169,56,113,31.681,0,2018,2,114,314,162,0.874006805255942,-151.3,19.9417582417582,48,1279.61097229202,1.16362576377297
18909,522037.603,5341416.481,160,119,41,21.056,0,2019,1,130,294,184,0.824157264349536,-73.4,20.0571428571429,54,1279.61097229202,1.16362576377297
18909,522037.603,5341416.481,0,0,0,18.51,0,2020,0,125,297,193,0.808849067356713,-13.6,18.3758241758242,68,1279.61097229202,1.16362576377297
19121,522269.26,5343038.075,0,0,0,48.712,0,2001,2,104,295,178,0.86758128088665,118,17.3307692307692,74,1179.70485834286,1.21378553371383
19121,522269.26,5343038.075,86,62,24,28.465,0,2002,1,121,309,184,0.863482225734387,53.4,17.5120879120879,63,1179.70485834286,1.21378553371383
19121,522269.26,5343038.075,159,71,88,34.004,0,2003,2,113,286,168,0.852807333670826,-198.1,22.256043956044,55,1179.70485834286,1.21378553371383
19121,522269.26,5343038.075,146,33,113,25.305,0,2004,3,125,310,185,0.851320368034153,210.8,17.0318681318681,60,1179.70485834286,1.21378553371383
19121,522269.26,5343038.075,155,93,62,48.578,0,2005,1,106,302,168,0.914658349179542,45.7,17.2395604395604,62,1179.70485834286,1.21378553371383
19121,522269.26,5343038.075,194,70,124,23.657,1,2006,2,130,325,178,0.87301185645413,93.4,18.2021978021978,48,1179.70485834286,1.21378553371383
19121,522269.26,5343038.075,141,83,58,50.994,1,2007,2,91,301,177,0.876050909546491,334.9,16.4472527472527,86,1179.70485834286,1.21378553371383
19121,522269.26,5343038.075,86,67,19,10.118,0,2008,1,139,296,210,0.85608428256553,51.4,16.9230769230769,71,1179.70485834286,1.21378553371383
19121,522269.26,5343038.075,167,68,99,48.485,0,2009,2,97,293,169,0.876482642441877,56.1,17.7604395604396,72,1179.70485834286,1.21378553371383
19121,522269.26,5343038.075,143,69,74,32.76,0,2010,3,112,304,202,0.871091708363144,134.3,17.6802197802198,90,1179.70485834286,1.21378553371383
19121,522269.26,5343038.075,134,68,66,35.21,1,2011,2,97,317,162,0.856072513205091,136.8,16.9703296703297,65,1179.70485834286,1.21378553371383
19121,522269.26,5343038.075,160,93,67,32.859,0,2012,1,119,307,177,0.875755238255444,90.5,18.343956043956,58,1179.70485834286,1.21378553371383
19121,522269.26,5343038.075,169,63,106,29.49,1,2013,3,125,303,232,0.842855450839036,-155.5,18.543956043956,107,1179.70485834286,1.21378553371383
19121,522269.26,5343038.075,155,56,99,39.539,3,2014,3,100,338,225,0.854242329977819,192.7,17.3769230769231,125,1179.70485834286,1.21378553371383
19121,522269.26,5343038.075,93,93,0,37.527,0,2015,1,111,330,176,0.874215285574202,-153.6,20.3384615384615,65,1179.70485834286,1.21378553371383
19121,522269.26,5343038.075,161,93,68,35.384,3,2016,1,119,329,170,0.845928628905455,52.4,18.4901098901099,51,1179.70485834286,1.21378553371383
19121,522269.26,5343038.075,141,95,46,37.441,7,2017,1,107,297,170,0.855486132986878,-1.7,19.1,63,1179.70485834286,1.21378553371383
19121,522269.26,5343038.075,175,79,96,34.723,0,2018,2,110,338,161,0.881622019178784,-150.7,19.8846153846154,51,1179.70485834286,1.21378553371383
19121,522269.26,5343038.075,155,93,62,30.625,4,2019,2,119,304,201,0.839977702570823,-73,20.0010989010989,82,1179.70485834286,1.21378553371383
19121,522269.26,5343038.075,95,69,26,31.61,3,2020,2,103,319,170,0.819803736100529,-12.8,18.3098901098901,67,1179.70485834286,1.21378553371383
19128,522269.26,5341416.481,0,0,0,30.444,0,2001,2,121,294,184,0.875559163507771,116.8,17.4,63,1247.11099359816,0.439514417983834
19128,522269.26,5341416.481,138,59,79,29.793,0,2002,3,120,300,193,0.835750227236436,52.7,17.567032967033,73,1247.11099359816,0.439514417983834
19128,522269.26,5341416.481,165,64,101,31.289,0,2003,2,117,306,169,0.846693843580059,-198,22.3252747252747,52,1247.11099359816,0.439514417983834
19128,522269.26,5341416.481,169,119,50,25.676,0,2004,1,125,324,192,0.851705912183561,209.7,17.0835164835165,67,1247.11099359816,0.439514417983834
19128,522269.26,5341416.481,163,120,43,34.166,0,2005,1,120,298,177,0.878460001195787,44.2,17.3054945054945,57,1247.11099359816,0.439514417983834
19128,522269.26,5341416.481,189,56,133,29.573,1,2006,3,124,326,185,0.837108409278067,92.3,18.2626373626374,61,1247.11099359816,0.439514417983834
19128,522269.26,5341416.481,0,0,0,37.96,0,2007,0,106,298,177,0.855946423912257,332.6,16.5076923076923,71,1247.11099359816,0.439514417983834
19128,522269.26,5341416.481,86,55,31,1.514,0,2008,1,154,297,209,0.846868499608831,50.1,16.9747252747253,55,1247.11099359816,0.439514417983834
19128,522269.26,5341416.481,178,63,115,45.038,0,2009,2,100,304,170,0.87088645750438,55,17.8153846153846,70,1247.11099359816,0.439514417983834
19128,522269.26,5341416.481,146,69,77,20.929,0,2010,3,128,304,184,0.85712813305791,133.1,17.7351648351648,56,1247.11099359816,0.439514417983834
19128,522269.26,5341416.481,0,0,0,32.898,0,2011,0,100,311,177,0.846739560180167,136.1,17.0351648351648,77,1247.11099359816,0.439514417983834
19128,522269.26,5341416.481,166,79,87,41.854,0,2012,2,111,305,178,0.859131799761218,88.9,18.4296703296703,67,1247.11099359816,0.439514417983834
19128,522269.26,5341416.481,183,132,51,26.812,1,2013,1,128,288,192,0.86552267432666,-156.9,18.6175824175824,64,1247.11099359816,0.439514417983834
19128,522269.26,5341416.481,151,43,108,32.409,0,2014,2,112,310,186,0.834467093548712,191.6,17.4516483516484,74,1247.11099359816,0.439514417983834
19128,522269.26,5341416.481,175,77,98,34.04,0,2015,2,116,321,169,0.857364969528589,-154.6,20.4153846153846,53,1247.11099359816,0.439514417983834
19128,522269.26,5341416.481,175,120,55,21.442,0,2016,1,133,320,178,0.873908102951351,50.9,18.5681318681319,45,1247.11099359816,0.439514417983834
19128,522269.26,5341416.481,151,105,46,29.025,0,2017,1,119,295,176,0.829425503736409,-2.3,19.1582417582418,57,1247.11099359816,0.439514417983834
19128,522269.26,5341416.481,152,60,92,49.525,0,2018,2,96,301,169,0.845810836031049,-151.3,19.9417582417582,73,1247.11099359816,0.439514417983834
19128,522269.26,5341416.481,162,93,69,23.928,1,2019,1,127,295,177,0.834298067104585,-73.4,20.0571428571429,50,1247.11099359816,0.439514417983834
19128,522269.26,5341416.481,86,71,15,22.185,1,2020,1,119,306,185,0.824925153672177,-13.6,18.3758241758242,66,1247.11099359816,0.439514417983834
19181,522269.26,5329138.694,0,0,0,51.732,0,2001,2,102,315,184,0.816826221308624,103.5,18.1120879120879,82,1185.0167065793,0.85267119753872
19181,522269.26,5329138.694,86,72,14,29.741,0,2002,1,120,294,209,0.768074983633823,46.4,18.2428571428571,89,1185.0167065793,0.85267119753872
19181,522269.26,5329138.694,160,101,59,33.403,0,2003,1,114,314,170,0.766122263222566,-203.8,22.9692307692308,56,1185.0167065793,0.85267119753872
19181,522269.26,5329138.694,168,108,60,31.063,0,2004,1,119,314,185,0.791519677668223,196.1,17.7461538461538,66,1185.0167065793,0.85267119753872
19181,522269.26,5329138.694,152,100,52,50.776,0,2005,1,105,313,161,0.78075681362814,38.9,17.9032967032967,56,1185.0167065793,0.85267119753872
19181,522269.26,5329138.694,192,65,127,38.802,1,2006,3,116,327,216,0.775729953393475,82.6,18.867032967033,100,1185.0167065793,0.85267119753872
19181,522269.26,5329138.694,0,0,0,41.74,0,2007,0,101,307,170,0.83251990385084,317.9,17.0824175824176,69,1185.0167065793,0.85267119753872
19181,522269.26,5329138.694,86,76,10,45.233,2,2008,1,103,308,241,0.782714568284428,40.8,17.6131868131868,138,1185.0167065793,0.85267119753872
19181,522269.26,5329138.694,174,70,104,43.036,0,2009,2,102,304,169,0.841462795483316,41,18.5230769230769,67,1185.0167065793,0.85267119753872
19181,522269.26,5329138.694,163,76,87,30.712,0,2010,2,117,305,186,0.773599906607788,122,18.3626373626374,69,1185.0167065793,0.85267119753872
19181,522269.26,5329138.694,81,68,13,40.497,1,2011,1,93,320,169,0.767452978211081,127.1,17.5,76,1185.0167065793,0.85267119753872
19181,522269.26,5329138.694,156,81,75,40.85,0,2012,2,112,300,168,0.818685606813103,82.8,18.7043956043956,56,1185.0167065793,0.85267119753872
19181,522269.26,5329138.694,175,93,82,35.792,0,2013,1,120,299,178,0.830947572725537,-163.1,19.2582417582418,58,1185.0167065793,0.85267119753872
19181,522269.26,5329138.694,143,48,95,43.069,3,2014,3,96,340,225,0.840772820375197,176.9,17.856043956044,129,1185.0167065793,0.85267119753872
19181,522269.26,5329138.694,163,93,70,42.684,0,2015,1,106,322,160,0.754199772675742,-158.6,20.9142857142857,54,1185.0167065793,0.85267119753872
19181,522269.26,5329138.694,170,132,38,45.648,6,2016,1,110,323,170,0.833444659744376,45.5,18.8857142857143,60,1185.0167065793,0.85267119753872
19181,522269.26,5329138.694,134,94,40,34.789,4,2017,1,111,304,178,0.762397808482612,-10.8,19.7879120879121,67,1185.0167065793,0.85267119753872
19181,522269.26,5329138.694,166,93,73,49.14,0,2018,1,98,298,154,0.808186347227653,-154,20.578021978022,56,1185.0167065793,0.85267119753872
19181,522269.26,5329138.694,159,79,80,35.924,4,2019,2,113,319,169,0.76328334004831,-79.8,20.6626373626374,56,1185.0167065793,0.85267119753872
19181,522269.26,5329138.694,0,0,0,31.762,0,2020,0,103,306,178,0.746684462104952,-19.2,19.0648351648352,75,1185.0167065793,0.85267119753872
19182,522269.26,5328907.037,0,0,0,50.525,0,2001,2,103,295,186,0.835882993392148,103.5,18.1120879120879,83,1142.6170362091,1.42781980320167
19182,522269.26,5328907.037,86,72,14,36.646,0,2002,1,112,330,217,0.839271952930859,46.4,18.2428571428571,105,1142.6170362091,1.42781980320167
19182,522269.26,5328907.037,149,134,15,36.828,0,2003,1,110,312,154,0.809631035946835,-203.8,22.9692307692308,44,1142.6170362091,1.42781980320167
19182,522269.26,5328907.037,168,93,75,31.063,0,2004,1,119,323,169,0.812787999226048,196.1,17.7461538461538,50,1142.6170362091,1.42781980320167
19182,522269.26,5328907.037,149,125,24,53.016,0,2005,2,103,310,232,0.817042414564771,38.9,17.9032967032967,129,1142.6170362091,1.42781980320167
19182,522269.26,5328907.037,172,62,110,34.152,1,2006,2,120,335,169,0.786423441974559,82.6,18.867032967033,49,1142.6170362091,1.42781980320167
19182,522269.26,5328907.037,97,93,4,56.725,3,2007,2,86,293,217,0.835411954647286,317.9,17.0824175824176,131,1142.6170362091,1.42781980320167
19182,522269.26,5328907.037,86,54,32,30.024,0,2008,1,116,301,232,0.840414222498497,40.8,17.6131868131868,116,1142.6170362091,1.42781980320167
19182,522269.26,5328907.037,168,57,111,28.593,0,2009,2,116,303,168,0.847858191639303,41,18.5230769230769,52,1142.6170362091,1.42781980320167
19182,522269.26,5328907.037,161,93,68,33.48,0,2010,2,114,300,241,0.801799346876011,122,18.3626373626374,127,1142.6170362091,1.42781980320167
19182,522269.26,5328907.037,122,59,63,43.453,1,2011,3,90,314,217,0.798745930428775,127.1,17.5,127,1142.6170362091,1.42781980320167
19182,522269.26,5328907.037,135,73,62,43.577,0,2012,2,109,309,176,0.84766734783832,82.8,18.7043956043956,67,1142.6170362091,1.42781980320167
19182,522269.26,5328907.037,182,77,105,31.278,0,2013,2,124,304,178,0.813095554889987,-163.1,19.2582417582418,54,1142.6170362091,1.42781980320167
19182,522269.26,5328907.037,0,0,0,43.833,0,2014,0,95,313,265,0.83660232014261,176.9,17.856043956044,170,1142.6170362091,1.42781980320167
19182,522269.26,5328907.037,93,93,0,42.684,0,2015,1,106,335,161,0.838196025507039,-158.6,20.9142857142857,55,1142.6170362091,1.42781980320167
19182,522269.26,5328907.037,161,112,49,44.478,6,2016,1,111,322,200,0.859912719497961,45.5,18.8857142857143,89,1142.6170362091,1.42781980320167
19182,522269.26,5328907.037,131,94,37,38.645,7,2017,2,106,308,216,0.818691398238333,-10.8,19.7879120879121,110,1142.6170362091,1.42781980320167
19182,522269.26,5328907.037,0,0,0,43.333,0,2018,0,103,314,153,0.855435201446064,-154,20.578021978022,50,1142.6170362091,1.42781980320167
19182,522269.26,5328907.037,132,83,49,36.738,4,2019,2,112,326,170,0.785657776912297,-79.8,20.6626373626374,58,1142.6170362091,1.42781980320167
19182,522269.26,5328907.037,0,0,0,32.478,0,2020,0,102,309,194,0.771401427549834,-19.2,19.0648351648352,92,1142.6170362091,1.42781980320167
19347,522500.916,5341416.481,0,0,0,35.888,0,2001,2,116,290,184,0.87049890589721,116.8,17.4,68,1226.530251878,-0.65583198083482
19347,522500.916,5341416.481,136,58,78,31.477,0,2002,3,118,292,193,0.831633414978239,52.7,17.567032967033,75,1226.530251878,-0.65583198083482
19347,522500.916,5341416.481,164,61,103,32.108,0,2003,2,116,307,169,0.832408079460866,-198,22.3252747252747,53,1226.530251878,-0.65583198083482
19347,522500.916,5341416.481,165,93,72,27.35,0,2004,1,123,317,178,0.827231793961708,209.7,17.0835164835165,55,1226.530251878,-0.65583198083482
19347,522500.916,5341416.481,163,121,42,36.316,0,2005,1,118,298,178,0.868443229087942,44.2,17.3054945054945,60,1226.530251878,-0.65583198083482
19347,522500.916,5341416.481,189,56,133,29.573,1,2006,3,124,328,185,0.832237533885685,92.3,18.2626373626374,61,1226.530251878,-0.65583198083482
19347,522500.916,5341416.481,0,0,0,41.204,0,2007,0,102,300,178,0.854940885429722,332.6,16.5076923076923,76,1226.530251878,-0.65583198083482
19347,522500.916,5341416.481,86,55,31,1.514,0,2008,1,154,296,217,0.824930351581194,50.1,16.9747252747253,63,1226.530251878,-0.65583198083482
19347,522500.916,5341416.481,181,60,121,36.617,0,2009,2,108,300,176,0.877660043606259,55,17.8153846153846,68,1226.530251878,-0.65583198083482
19347,522500.916,5341416.481,148,67,81,22.475,0,2010,2,126,303,184,0.846783620667969,133.1,17.7351648351648,58,1226.530251878,-0.65583198083482
19347,522500.916,5341416.481,0,0,0,29.721,0,2011,0,104,318,170,0.847128372558801,136.1,17.0351648351648,66,1226.530251878,-0.65583198083482
19347,522500.916,5341416.481,171,79,92,32.403,0,2012,2,120,307,177,0.870857551531141,88.9,18.4296703296703,57,1226.530251878,-0.65583198083482
19347,522500.916,5341416.481,186,142,44,22.774,1,2013,1,132,279,186,0.860676601605011,-156.9,18.6175824175824,54,1226.530251878,-0.65583198083482
19347,522500.916,5341416.481,146,40,106,37.471,3,2014,3,104,310,217,0.890465216910876,191.6,17.4516483516484,113,1226.530251878,-0.65583198083482
19347,522500.916,5341416.481,167,77,90,42.595,0,2015,2,106,338,169,0.848212683942949,-154.6,20.4153846153846,63,1226.530251878,-0.65583198083482
19347,522500.916,5341416.481,169,93,76,23.323,0,2016,1,131,320,178,0.866341345988062,50.9,18.5681318681319,47,1226.530251878,-0.65583198083482
19347,522500.916,5341416.481,149,93,56,29.833,1,2017,1,118,296,176,0.826454173486589,-2.3,19.1582417582418,58,1226.530251878,-0.65583198083482
19347,522500.916,5341416.481,151,59,92,48.353,0,2018,2,97,308,176,0.833069059872369,-151.3,19.9417582417582,79,1226.530251878,-0.65583198083482
19347,522500.916,5341416.481,161,93,68,25.763,3,2019,1,125,296,177,0.82716250425113,-73.4,20.0571428571429,52,1226.530251878,-0.65583198083482
19347,522500.916,5341416.481,86,71,15,22.704,1,2020,1,118,297,184,0.832026220845972,-13.6,18.3758241758242,66,1226.530251878,-0.65583198083482
19387,522500.916,5332150.226,108,83,25,39.272,1,2001,3,113,296,178,0.877917548753875,103.5,18.1120879120879,65,1175.74669786293,-1.42920685728331
19387,522500.916,5332150.226,154,75,79,28.013,0,2002,3,122,300,226,0.865592203909263,46.4,18.2428571428571,104,1175.74669786293,-1.42920685728331
19387,522500.916,5332150.226,157,86,71,34.263,0,2003,2,113,318,161,0.871973605576273,-203.8,22.9692307692308,48,1175.74669786293,-1.42920685728331
19387,522500.916,5332150.226,159,94,65,30.168,0,2004,2,120,308,185,0.867007268033091,196.1,17.7461538461538,65,1175.74669786293,-1.42920685728331
19387,522500.916,5332150.226,162,93,69,42.902,0,2005,2,112,312,170,0.884623659854035,38.9,17.9032967032967,58,1175.74669786293,-1.42920685728331
19387,522500.916,5332150.226,183,66,117,54.03,1,2006,2,104,330,162,0.847105421397741,82.6,18.867032967033,58,1175.74669786293,-1.42920685728331
19387,522500.916,5332150.226,0,0,0,45.373,0,2007,0,97,291,202,0.845344010950716,317.9,17.0824175824176,105,1175.74669786293,-1.42920685728331
19387,522500.916,5332150.226,86,58,28,18.936,0,2008,1,127,300,217,0.864069400600555,40.8,17.6131868131868,90,1175.74669786293,-1.42920685728331
19387,522500.916,5332150.226,162,97,65,49.053,0,2009,1,97,284,169,0.917582994728916,41,18.5230769230769,72,1175.74669786293,-1.42920685728331
19387,522500.916,5332150.226,165,95,70,28.148,0,2010,1,120,303,177,0.890499394560571,122,18.3626373626374,57,1175.74669786293,-1.42920685728331
19387,522500.916,5332150.226,131,84,47,35.725,1,2011,2,98,314,176,0.856508732190788,127.1,17.5,78,1175.74669786293,-1.42920685728331
19387,522500.916,5332150.226,152,93,59,34.445,0,2012,2,118,312,193,0.887090476269589,82.8,18.7043956043956,75,1175.74669786293,-1.42920685728331
19387,522500.916,5332150.226,178,78,100,22.765,0,2013,3,132,298,194,0.889477213387974,-163.1,19.2582417582418,62,1175.74669786293,-1.42920685728331
19387,522500.916,5332150.226,152,50,102,36.632,3,2014,3,105,316,194,0.870578277585438,176.9,17.856043956044,89,1175.74669786293,-1.42920685728331
19387,522500.916,5332150.226,153,93,60,39.046,0,2015,1,110,296,177,0.901732188373206,-158.6,20.9142857142857,67,1175.74669786293,-1.42920685728331
19387,522500.916,5332150.226,168,120,48,30.443,0,2016,2,124,317,234,0.822281242801096,45.5,18.8857142857143,110,1175.74669786293,-1.42920685728331
19387,522500.916,5332150.226,94,93,1,34.789,4,2017,1,111,299,170,0.872185930489024,-10.8,19.7879120879121,59,1175.74669786293,-1.42920685728331
19387,522500.916,5332150.226,170,52,118,35.844,0,2018,2,110,303,161,0.889465270712742,-154,20.578021978022,51,1175.74669786293,-1.42920685728331
19387,522500.916,5332150.226,151,95,56,29.899,4,2019,1,120,292,170,0.869135166555171,-79.8,20.6626373626374,50,1175.74669786293,-1.42920685728331
19387,522500.916,5332150.226,93,93,0,31.059,3,2020,2,104,304,208,0.8130578506466,-19.2,19.0648351648352,104,1175.74669786293,-1.42920685728331
19399,522500.916,5329370.35,0,0,0,50.525,0,2001,2,103,322,178,0.831359720333627,103.5,18.1120879120879,75,1227.97566895589,-1.41036059387144
19399,522500.916,5329370.35,86,72,14,28.89,0,2002,1,121,294,192,0.787423018896477,46.4,18.2428571428571,71,1227.97566895589,-1.41036059387144
19399,522500.916,5329370.35,162,99,63,32.562,0,2003,1,115,304,168,0.771384963718298,-203.8,22.9692307692308,53,1227.97566895589,-1.41036059387144
19399,522500.916,5329370.35,167,110,57,31.965,0,2004,1,118,318,184,0.814883107196018,196.1,17.7461538461538,66,1227.97566895589,-1.41036059387144
19399,522500.916,5329370.35,153,100,53,46.32,0,2005,1,109,311,162,0.787838979923468,38.9,17.9032967032967,53,1227.97566895589,-1.41036059387144
19399,522500.916,5329370.35,192,63,129,41.171,1,2006,3,114,323,225,0.85890802956468,82.6,18.867032967033,111,1227.97566895589,-1.41036059387144
19399,522500.916,5329370.35,0,0,0,36.897,0,2007,0,107,297,233,0.826149901488943,317.9,17.0824175824176,126,1227.97566895589,-1.41036059387144
19399,522500.916,5329370.35,83,69,14,28.874,0,2008,1,117,305,184,0.81383843890736,40.8,17.6131868131868,67,1227.97566895589,-1.41036059387144
19399,522500.916,5329370.35,184,65,119,25.203,0,2009,3,120,308,162,0.842613006345202,41,18.5230769230769,42,1227.97566895589,-1.41036059387144
19399,522500.916,5329370.35,167,76,91,27.331,0,2010,3,121,308,210,0.81992864240062,122,18.3626373626374,89,1227.97566895589,-1.41036059387144
19399,522500.916,5329370.35,93,72,21,37.588,1,2011,3,96,321,233,0.828950312235589,127.1,17.5,137,1227.97566895589,-1.41036059387144
19399,522500.916,5329370.35,161,81,80,37.785,0,2012,2,115,307,162,0.827496086003529,82.8,18.7043956043956,47,1227.97566895589,-1.41036059387144
19399,522500.916,5329370.35,174,77,97,35.792,0,2013,3,120,300,233,0.785709070572667,-163.1,19.2582417582418,113,1227.97566895589,-1.41036059387144
19399,522500.916,5329370.35,146,48,98,38.673,3,2014,3,102,339,233,0.856115060444726,176.9,17.856043956044,131,1227.97566895589,-1.41036059387144
19399,522500.916,5329370.35,168,131,37,39.046,0,2015,1,110,325,153,0.824056448529189,-158.6,20.9142857142857,43,1227.97566895589,-1.41036059387144
19399,522500.916,5329370.35,168,126,42,49.248,6,2016,1,107,329,161,0.843644650036037,45.5,18.8857142857143,54,1227.97566895589,-1.41036059387144
19399,522500.916,5329370.35,132,94,38,37.886,7,2017,2,107,304,233,0.824989068994984,-10.8,19.7879120879121,126,1227.97566895589,-1.41036059387144
19399,522500.916,5329370.35,166,93,73,46.757,0,2018,1,100,306,153,0.83381636633135,-154,20.578021978022,53,1227.97566895589,-1.41036059387144
19399,522500.916,5329370.35,159,77,82,31.712,4,2019,2,118,316,169,0.802386270622263,-79.8,20.6626373626374,51,1227.97566895589,-1.41036059387144
19399,522500.916,5329370.35,0,0,0,26.508,0,2020,0,111,277,170,0.772103572135923,-19.2,19.0648351648352,59,1227.97566895589,-1.41036059387144
19400,522500.916,5329138.694,0,0,0,48.234,0,2001,2,105,307,186,0.827097107265932,103.5,18.1120879120879,81,1237.73344256665,-1.23244383288025
19400,522500.916,5329138.694,86,71,15,28.013,0,2002,1,122,293,193,0.81330500806546,46.4,18.2428571428571,71,1237.73344256665,-1.23244383288025
19400,522500.916,5329138.694,161,101,60,32.562,0,2003,1,115,322,160,0.781311100353486,-203.8,22.9692307692308,45,1237.73344256665,-1.23244383288025
19400,522500.916,5329138.694,168,108,60,26.664,0,2004,1,124,328,185,0.81659346972157,196.1,17.7461538461538,61,1237.73344256665,-1.23244383288025
19400,522500.916,5329138.694,157,93,64,39.638,0,2005,2,115,311,169,0.788231246411626,38.9,17.9032967032967,54,1237.73344256665,-1.23244383288025
19400,522500.916,5329138.694,192,64,128,38.802,1,2006,2,116,327,176,0.794726477153902,82.6,18.867032967033,60,1237.73344256665,-1.23244383288025
19400,522500.916,5329138.694,0,0,0,40.043,0,2007,0,103,298,224,0.802331920941745,317.9,17.0824175824176,121,1237.73344256665,-1.23244383288025
19400,522500.916,5329138.694,82,70,12,23.631,0,2008,1,122,304,185,0.806941917336409,40.8,17.6131868131868,63,1237.73344256665,-1.23244383288025
19400,522500.916,5329138.694,176,67,109,33.246,0,2009,2,111,303,161,0.810142987663235,41,18.5230769230769,50,1237.73344256665,-1.23244383288025
19400,522500.916,5329138.694,164,76,88,28.148,0,2010,2,120,304,185,0.816725770395259,122,18.3626373626374,65,1237.73344256665,-1.23244383288025
19400,522500.916,5329138.694,95,68,27,38.555,1,2011,3,95,319,240,0.79009750747364,127.1,17.5,145,1237.73344256665,-1.23244383288025
19400,522500.916,5329138.694,157,81,76,37.785,0,2012,2,115,301,169,0.826897512930654,82.8,18.7043956043956,54,1237.73344256665,-1.23244383288025
19400,522500.916,5329138.694,175,103,72,35.792,0,2013,1,120,299,184,0.816219847849656,-163.1,19.2582417582418,64,1237.73344256665,-1.23244383288025
19400,522500.916,5329138.694,146,48,98,40.828,3,2014,2,99,341,170,0.809299107269384,176.9,17.856043956044,71,1237.73344256665,-1.23244383288025
19400,522500.916,5329138.694,164,93,71,40.878,0,2015,1,108,317,168,0.808782361051654,-158.6,20.9142857142857,60,1237.73344256665,-1.23244383288025
19400,522500.916,5329138.694,168,111,57,45.648,6,2016,1,110,322,169,0.83542352354641,45.5,18.8857142857143,59,1237.73344256665,-1.23244383288025
19400,522500.916,5329138.694,137,107,30,34.029,3,2017,1,112,303,170,0.803536327516516,-10.8,19.7879120879121,58,1237.73344256665,-1.23244383288025
19400,522500.916,5329138.694,173,127,46,39.97,0,2018,1,106,317,153,0.844326158203281,-154,20.578021978022,47,1237.73344256665,-1.23244383288025
19400,522500.916,5329138.694,159,79,80,31.712,4,2019,2,118,321,169,0.791691009868976,-79.8,20.6626373626374,51,1237.73344256665,-1.23244383288025
19400,522500.916,5329138.694,0,0,0,26.508,0,2020,0,111,276,169,0.744143063414192,-19.2,19.0648351648352,58,1237.73344256665,-1.23244383288025
19567,522732.572,5341184.824,0,0,0,55.554,0,2001,2,99,292,185,0.859591345711741,116.8,17.4,86,1244.8287551611,-1.52112054435727
19567,522732.572,5341184.824,157,65,92,30.636,0,2002,3,119,293,194,0.839098315938827,52.7,17.567032967033,75,1244.8287551611,-1.52112054435727
19567,522732.572,5341184.824,164,93,71,35.425,0,2003,1,112,302,161,0.81476182930785,-198,22.3252747252747,49,1244.8287551611,-1.52112054435727
19567,522732.572,5341184.824,162,99,63,30.751,0,2004,1,119,330,176,0.797669405109804,209.7,17.0835164835165,57,1244.8287551611,-1.52112054435727
19567,522732.572,5341184.824,0,0,0,43.966,0,2005,0,111,307,184,0.871363055562163,44.2,17.3054945054945,73,1244.8287551611,-1.52112054435727
19567,522732.572,5341184.824,185,64,121,29.573,1,2006,2,124,334,185,0.840740138994673,92.3,18.2626373626374,61,1244.8287551611,-1.52112054435727
19567,522732.572,5341184.824,93,93,0,42.066,0,2007,2,101,299,185,0.838931498239511,332.6,16.5076923076923,84,1244.8287551611,-1.52112054435727
19567,522732.572,5341184.824,86,56,30,20.699,0,2008,1,125,293,209,0.87339323575028,50.1,16.9747252747253,84,1244.8287551611,-1.52112054435727
19567,522732.572,5341184.824,180,58,122,29.053,0,2009,2,116,295,177,0.879403810159766,55,17.8153846153846,61,1244.8287551611,-1.52112054435727
19567,522732.572,5341184.824,177,100,77,21.716,0,2010,1,127,307,178,0.839165385333941,133.1,17.7351648351648,51,1244.8287551611,-1.52112054435727
19567,522732.572,5341184.824,0,0,0,32.898,0,2011,0,100,316,162,0.831039440893396,136.1,17.0351648351648,62,1244.8287551611,-1.52112054435727
19567,522732.572,5341184.824,170,82,88,43.658,0,2012,2,109,307,177,0.851997773071468,88.9,18.4296703296703,68,1244.8287551611,-1.52112054435727
19567,522732.572,5341184.824,186,76,110,22.774,1,2013,3,132,296,208,0.826853218356088,-156.9,18.6175824175824,76,1244.8287551611,-1.52112054435727
19567,522732.572,5341184.824,144,48,96,39.507,3,2014,2,101,322,177,0.831494304784489,191.6,17.4516483516484,76,1244.8287551611,-1.52112054435727
19567,522732.572,5341184.824,174,80,94,34.827,0,2015,2,115,330,169,0.860874502043712,-154.6,20.4153846153846,54,1244.8287551611,-1.52112054435727
19567,522732.572,5341184.824,170,107,63,38.189,5,2016,1,117,328,178,0.866649532672348,50.9,18.5681318681319,61,1244.8287551611,-1.52112054435727
19567,522732.572,5341184.824,150,103,47,36.584,6,2017,1,109,295,170,0.82478138450889,-2.3,19.1582417582418,61,1244.8287551611,-1.52112054435727
19567,522732.572,5341184.824,168,95,73,40.956,0,2018,1,104,313,170,0.851543119195691,-151.3,19.9417582417582,66,1244.8287551611,-1.52112054435727
19567,522732.572,5341184.824,157,94,63,32.944,4,2019,1,117,321,178,0.833390284126978,-73.4,20.0571428571429,61,1244.8287551611,-1.52112054435727
19567,522732.572,5341184.824,0,0,0,26.01,0,2020,0,112,308,185,0.805286164631891,-13.6,18.3758241758242,73,1244.8287551611,-1.52112054435727
19568,522732.572,5340953.168,0,0,0,80.785,0,2001,2,78,338,193,0.865192311966294,116.8,17.4,115,1138.19132552882,-0.130987069982149
19568,522732.572,5340953.168,144,93,51,40.744,0,2002,1,107,300,178,0.864031254074555,52.7,17.567032967033,71,1138.19132552882,-0.130987069982149
19568,522732.572,5340953.168,159,93,66,37.087,0,2003,1,110,320,154,0.812150268097092,-198,22.3252747252747,44,1138.19132552882,-0.130987069982149
19568,522732.572,5340953.168,142,94,48,40.944,0,2004,1,108,333,177,0.845189264949257,209.7,17.0835164835165,69,1138.19132552882,-0.130987069982149
19568,522732.572,5340953.168,0,0,0,45.08,0,2005,0,110,304,218,0.857414013245598,44.2,17.3054945054945,108,1138.19132552882,-0.130987069982149
19568,522732.572,5340953.168,192,67,125,30.508,1,2006,2,123,338,178,0.860271867933805,92.3,18.2626373626374,55,1138.19132552882,-0.130987069982149
19568,522732.572,5340953.168,0,0,0,72.39,0,2007,0,71,304,178,0.848743163977871,332.6,16.5076923076923,107,1138.19132552882,-0.130987069982149
19568,522732.572,5340953.168,86,61,25,23.59,0,2008,1,122,307,209,0.880785186595575,50.1,16.9747252747253,87,1138.19132552882,-0.130987069982149
19568,522732.572,5340953.168,174,61,113,32.652,0,2009,2,112,303,176,0.868713769707403,55,17.8153846153846,64,1138.19132552882,-0.130987069982149
19568,522732.572,5340953.168,134,94,40,32.234,0,2010,2,113,308,193,0.877228208412995,133.1,17.7351648351648,80,1138.19132552882,-0.130987069982149
19568,522732.572,5340953.168,103,93,10,44.357,1,2011,1,87,323,154,0.849383591189124,136.1,17.0351648351648,67,1138.19132552882,-0.130987069982149
19568,522732.572,5340953.168,169,81,88,36.732,0,2012,2,116,312,169,0.848866743862919,88.9,18.4296703296703,53,1138.19132552882,-0.130987069982149
19568,522732.572,5340953.168,178,79,99,35.424,1,2013,3,120,304,192,0.84361350179167,-156.9,18.6175824175824,72,1138.19132552882,-0.130987069982149
19568,522732.572,5340953.168,86,58,28,63.677,8,2014,1,71,320,186,0.831728329195248,191.6,17.4516483516484,115,1138.19132552882,-0.130987069982149
19568,522732.572,5340953.168,156,81,75,49.434,0,2015,2,99,341,170,0.869546748876906,-154.6,20.4153846153846,71,1138.19132552882,-0.130987069982149
19568,522732.572,5340953.168,158,94,64,67.358,8,2016,2,89,333,185,0.879466273509502,50.9,18.5681318681319,96,1138.19132552882,-0.130987069982149
19568,522732.572,5340953.168,150,96,54,41.733,7,2017,1,102,297,177,0.860261107286253,-2.3,19.1582417582418,75,1138.19132552882,-0.130987069982149
19568,522732.572,5340953.168,156,93,63,51.852,0,2018,2,94,315,185,0.856608113509921,-151.3,19.9417582417582,91,1138.19132552882,-0.130987069982149
19568,522732.572,5340953.168,150,80,70,37.924,4,2019,3,111,320,185,0.855854045783985,-73.4,20.0571428571429,74,1138.19132552882,-0.130987069982149
19568,522732.572,5340953.168,0,0,0,32.536,0,2020,0,102,314,201,0.820794648841826,-13.6,18.3758241758242,99,1138.19132552882,-0.130987069982149
19607,522732.572,5331918.57,105,85,20,44.831,6,2001,3,108,295,178,0.863572169348065,103.5,18.1120879120879,70,1182.2290870293,-1.34121438102489
19607,522732.572,5331918.57,160,66,94,32.346,0,2002,3,117,298,233,0.838196008926329,46.4,18.2428571428571,116,1182.2290870293,-1.34121438102489
19607,522732.572,5331918.57,168,62,106,35.12,0,2003,2,112,287,161,0.851727680233719,-203.8,22.9692307692308,49,1182.2290870293,-1.34121438102489
19607,522732.572,5331918.57,170,27,143,29.278,0,2004,3,121,306,233,0.826206241181502,196.1,17.7461538461538,112,1182.2290870293,-1.34121438102489
19607,522732.572,5331918.57,157,93,64,46.32,0,2005,1,109,316,169,0.877912253612736,38.9,17.9032967032967,60,1182.2290870293,-1.34121438102489
19607,522732.572,5331918.57,190,69,121,54.03,1,2006,2,104,334,162,0.839306425952948,82.6,18.867032967033,58,1182.2290870293,-1.34121438102489
19607,522732.572,5331918.57,0,0,0,51.423,0,2007,0,91,300,161,0.835448558990601,317.9,17.0824175824176,70,1182.2290870293,-1.34121438102489
19607,522732.572,5331918.57,186,56,130,23.631,0,2008,3,122,305,225,0.876168736762366,40.8,17.6131868131868,103,1182.2290870293,-1.34121438102489
19607,522732.572,5331918.57,175,64,111,62.364,1,2009,2,86,298,153,0.882053806142254,41,18.5230769230769,67,1182.2290870293,-1.34121438102489
19607,522732.572,5331918.57,169,75,94,32.534,0,2010,2,115,307,177,0.841091847575029,122,18.3626373626374,62,1182.2290870293,-1.34121438102489
19607,522732.572,5331918.57,129,84,45,36.643,1,2011,2,97,322,153,0.85090730305941,127.1,17.5,56,1182.2290870293,-1.34121438102489
19607,522732.572,5331918.57,169,107,62,37.785,0,2012,1,115,315,170,0.874891239670711,82.8,18.7043956043956,55,1182.2290870293,-1.34121438102489
19607,522732.572,5331918.57,177,97,80,52.004,0,2013,1,106,289,169,0.895636083604065,-163.1,19.2582417582418,63,1182.2290870293,-1.34121438102489
19607,522732.572,5331918.57,162,38,124,40.097,3,2014,2,100,320,184,0.852465679549124,176.9,17.856043956044,84,1182.2290870293,-1.34121438102489
19607,522732.572,5331918.57,161,93,68,42.684,0,2015,1,106,297,161,0.85712355529586,-158.6,20.9142857142857,55,1182.2290870293,-1.34121438102489
19607,522732.572,5331918.57,164,93,71,46.858,6,2016,1,109,322,170,0.866798622639281,45.5,18.8857142857143,61,1182.2290870293,-1.34121438102489
19607,522732.572,5331918.57,124,94,30,31.805,3,2017,1,115,302,177,0.844658799667503,-10.8,19.7879120879121,62,1182.2290870293,-1.34121438102489
19607,522732.572,5331918.57,174,123,51,36.816,0,2018,1,109,302,169,0.849179087406459,-154,20.578021978022,60,1182.2290870293,-1.34121438102489
19607,522732.572,5331918.57,173,95,78,33.457,4,2019,1,116,293,169,0.836923313291336,-79.8,20.6626373626374,53,1182.2290870293,-1.34121438102489
19607,522732.572,5331918.57,0,0,0,29.029,0,2020,0,107,307,185,0.824711274395606,-19.2,19.0648351648352,78,1182.2290870293,-1.34121438102489
19608,522732.572,5331686.914,103,83,20,49.362,8,2001,4,104,295,193,0.868864537124136,103.5,18.1120879120879,89,1176.98586325771,1.18270501213804
19608,522732.572,5331686.914,153,84,69,36.646,0,2002,3,112,291,185,0.87144438488502,46.4,18.2428571428571,73,1176.98586325771,1.18270501213804
19608,522732.572,5331686.914,157,60,97,34.263,0,2003,2,113,321,169,0.865635816445771,-203.8,22.9692307692308,56,1176.98586325771,1.18270501213804
19608,522732.572,5331686.914,166,100,66,26.664,0,2004,1,124,303,176,0.840713638492492,196.1,17.7461538461538,52,1176.98586325771,1.18270501213804
19608,522732.572,5331686.914,162,99,63,42.902,0,2005,1,112,309,177,0.885710809686396,38.9,17.9032967032967,65,1176.98586325771,1.18270501213804
19608,522732.572,5331686.914,193,66,127,25.082,0,2006,2,129,331,176,0.834185544104266,82.6,18.867032967033,47,1176.98586325771,1.18270501213804
19608,522732.572,5331686.914,0,0,0,53.537,0,2007,0,89,308,184,0.860652860802018,317.9,17.0824175824176,95,1176.98586325771,1.18270501213804
19608,522732.572,5331686.914,0,0,0,48.806,0,2008,0,100,297,184,0.842722185982634,40.8,17.6131868131868,84,1176.98586325771,1.18270501213804
19608,522732.572,5331686.914,170,58,112,51.564,0,2009,2,95,296,161,0.904368343725552,41,18.5230769230769,66,1176.98586325771,1.18270501213804
19608,522732.572,5331686.914,168,66,102,31.615,0,2010,2,116,299,177,0.872709983628905,122,18.3626373626374,61,1176.98586325771,1.18270501213804
19608,522732.572,5331686.914,94,94,0,32.287,1,2011,2,102,320,201,0.837967327927069,127.1,17.5,99,1176.98586325771,1.18270501213804
19608,522732.572,5331686.914,159,98,61,31.344,0,2012,1,121,309,178,0.88045110046806,82.8,18.7043956043956,57,1176.98586325771,1.18270501213804
19608,522732.572,5331686.914,172,93,79,25.819,0,2013,2,129,281,201,0.875544515546735,-163.1,19.2582417582418,72,1176.98586325771,1.18270501213804
19608,522732.572,5331686.914,154,43,111,37.981,3,2014,3,103,315,192,0.861315717641127,176.9,17.856043956044,89,1176.98586325771,1.18270501213804
19608,522732.572,5331686.914,158,93,65,34.844,0,2015,1,115,296,176,0.871050780886322,-158.6,20.9142857142857,61,1176.98586325771,1.18270501213804
19608,522732.572,5331686.914,171,93,78,39.103,5,2016,2,116,326,193,0.899036142468612,45.5,18.8857142857143,77,1176.98586325771,1.18270501213804
19608,522732.572,5331686.914,121,94,27,31.079,3,2017,2,116,292,209,0.864079413046943,-10.8,19.7879120879121,93,1176.98586325771,1.18270501213804
19608,522732.572,5331686.914,152,57,95,50.358,0,2018,2,97,299,176,0.862743851007581,-154,20.578021978022,79,1176.98586325771,1.18270501213804
19608,522732.572,5331686.914,164,80,84,28.119,4,2019,2,122,293,170,0.869151948024359,-79.8,20.6626373626374,48,1176.98586325771,1.18270501213804
19608,522732.572,5331686.914,0,0,0,28.381,0,2020,0,108,301,202,0.816575906925069,-19.2,19.0648351648352,94,1176.98586325771,1.18270501213804
19617,522732.572,5329602.006,86,82,4,39.272,1,2001,2,113,294,185,0.838096843440893,103.5,18.1120879120879,72,1216.58556418701,0.415190720978535
19617,522732.572,5329602.006,93,67,26,29.741,0,2002,2,120,296,178,0.812904164980664,46.4,18.2428571428571,58,1216.58556418701,0.415190720978535
19617,522732.572,5329602.006,169,53,116,42.224,1,2003,2,104,315,160,0.820770429556904,-203.8,22.9692307692308,56,1216.58556418701,0.415190720978535
19617,522732.572,5329602.006,170,100,70,32.885,0,2004,1,117,327,185,0.821181658685696,196.1,17.7461538461538,68,1216.58556418701,0.415190720978535
19617,522732.572,5329602.006,154,105,49,45.18,0,2005,1,110,306,168,0.816682294846317,38.9,17.9032967032967,58,1216.58556418701,0.415190720978535
19617,522732.572,5329602.006,186,62,124,25.082,0,2006,2,129,326,185,0.836520419525764,82.6,18.867032967033,56,1216.58556418701,0.415190720978535
19617,522732.572,5329602.006,86,79,7,34.746,0,2007,1,110,297,161,0.84626140381775,317.9,17.0824175824176,51,1216.58556418701,0.415190720978535
19617,522732.572,5329602.006,174,71,103,38.142,0,2008,2,109,310,178,0.825257579797903,40.8,17.6131868131868,69,1216.58556418701,0.415190720978535
19617,522732.572,5329602.006,175,63,112,35.331,0,2009,2,109,298,170,0.880875114995061,41,18.5230769230769,61,1216.58556418701,0.415190720978535
19617,522732.572,5329602.006,162,67,95,31.615,0,2010,2,116,303,170,0.824914044458991,122,18.3626373626374,54,1216.58556418701,0.415190720978535
19617,522732.572,5329602.006,147,98,49,34.83,1,2011,2,99,324,224,0.816465874880974,127.1,17.5,125,1216.58556418701,0.415190720978535
19617,522732.572,5329602.006,152,106,46,38.851,0,2012,1,114,306,169,0.843872085791344,82.8,18.7043956043956,55,1216.58556418701,0.415190720978535
19617,522732.572,5329602.006,169,107,62,23.773,0,2013,1,131,300,178,0.865400399663416,-163.1,19.2582417582418,47,1216.58556418701,0.415190720978535
19617,522732.572,5329602.006,155,57,98,39.378,3,2014,2,101,319,170,0.82949886097398,176.9,17.856043956044,69,1216.58556418701,0.415190720978535
19617,522732.572,5329602.006,174,93,81,55.437,4,2015,1,94,320,153,0.822559320460576,-158.6,20.9142857142857,59,1216.58556418701,0.415190720978535
19617,522732.572,5329602.006,169,117,52,32.703,0,2016,1,122,330,169,0.845198374307193,45.5,18.8857142857143,47,1216.58556418701,0.415190720978535
19617,522732.572,5329602.006,153,108,45,33.279,3,2017,1,113,306,169,0.816981069409244,-10.8,19.7879120879121,56,1216.58556418701,0.415190720978535
19617,522732.572,5329602.006,160,57,103,45.588,0,2018,2,101,316,160,0.831675816252145,-154,20.578021978022,59,1216.58556418701,0.415190720978535
19617,522732.572,5329602.006,163,94,69,30.808,4,2019,1,119,318,170,0.838134321137522,-79.8,20.6626373626374,51,1216.58556418701,0.415190720978535
19617,522732.572,5329602.006,0,0,0,31.762,0,2020,0,103,300,178,0.784664629599191,-19.2,19.0648351648352,75,1216.58556418701,0.415190720978535
19618,522732.572,5329370.35,86,84,2,34.888,0,2001,2,117,299,177,0.813430240923694,103.5,18.1120879120879,60,1250.66882493463,1.44239927601849
19618,522732.572,5329370.35,85,64,21,27.076,0,2002,1,123,291,177,0.83767823451795,46.4,18.2428571428571,54,1250.66882493463,1.44239927601849
19618,522732.572,5329370.35,168,52,116,32.562,0,2003,2,115,299,161,0.805763829872952,-203.8,22.9692307692308,46,1250.66882493463,1.44239927601849
19618,522732.572,5329370.35,171,94,77,34.798,0,2004,2,115,326,185,0.820763838343101,196.1,17.7461538461538,70,1250.66882493463,1.44239927601849
19618,522732.572,5329370.35,166,93,73,37.383,0,2005,2,117,303,169,0.804179309938113,38.9,17.9032967032967,52,1250.66882493463,1.44239927601849
19618,522732.572,5329370.35,187,56,131,42.383,1,2006,2,113,323,177,0.80511452395946,82.6,18.867032967033,64,1250.66882493463,1.44239927601849
19618,522732.572,5329370.35,86,77,9,37.648,0,2007,1,106,298,161,0.835721435070246,317.9,17.0824175824176,55,1250.66882493463,1.44239927601849
19618,522732.572,5329370.35,80,52,28,11.457,0,2008,1,137,300,185,0.790961918952231,40.8,17.6131868131868,48,1250.66882493463,1.44239927601849
19618,522732.572,5329370.35,179,64,115,29.472,0,2009,2,115,305,177,0.854008521346113,41,18.5230769230769,62,1250.66882493463,1.44239927601849
19618,522732.572,5329370.35,173,74,99,26.507,0,2010,2,122,306,178,0.823042084726293,122,18.3626373626374,56,1250.66882493463,1.44239927601849
19618,522732.572,5329370.35,93,67,26,35.725,1,2011,3,98,317,234,0.825986750798958,127.1,17.5,136,1250.66882493463,1.44239927601849
19618,522732.572,5329370.35,154,80,74,32.347,0,2012,3,120,293,241,0.841310779990168,82.8,18.7043956043956,121,1250.66882493463,1.44239927601849
19618,522732.572,5329370.35,182,47,135,40.309,0,2013,2,116,293,177,0.88637390909521,-163.1,19.2582417582418,61,1250.66882493463,1.44239927601849
19618,522732.572,5329370.35,160,41,119,38.673,3,2014,2,102,319,161,0.843938498984021,176.9,17.856043956044,59,1250.66882493463,1.44239927601849
19618,522732.572,5329370.35,162,93,69,41.8,0,2015,1,107,316,153,0.842805288317841,-158.6,20.9142857142857,46,1250.66882493463,1.44239927601849
19618,522732.572,5329370.35,171,128,43,30.443,0,2016,2,124,326,240,0.84809663257644,45.5,18.8857142857143,116,1250.66882493463,1.44239927601849
19618,522732.572,5329370.35,140,102,38,45.573,7,2017,1,97,308,161,0.830408412884633,-10.8,19.7879120879121,64,1250.66882493463,1.44239927601849
19618,522732.572,5329370.35,165,93,72,50.358,0,2018,1,97,304,153,0.783782619781567,-154,20.578021978022,56,1250.66882493463,1.44239927601849
19618,522732.572,5329370.35,168,78,90,30.808,4,2019,2,119,320,168,0.809813934257817,-79.8,20.6626373626374,49,1250.66882493463,1.44239927601849
19618,522732.572,5329370.35,0,0,0,27.747,0,2020,0,109,297,170,0.791576809242387,-19.2,19.0648351648352,61,1250.66882493463,1.44239927601849
19619,522732.572,5329138.694,86,85,1,41.461,3,2001,2,111,296,177,0.814267963074539,103.5,18.1120879120879,66,1245.89495204155,-0.754239784322973
19619,522732.572,5329138.694,83,63,20,27.076,0,2002,1,123,293,184,0.819889447726706,46.4,18.2428571428571,61,1245.89495204155,-0.754239784322973
19619,522732.572,5329138.694,169,52,117,27.482,0,2003,2,121,320,169,0.805615051791892,-203.8,22.9692307692308,48,1245.89495204155,-0.754239784322973
19619,522732.572,5329138.694,178,93,85,24.906,0,2004,2,126,325,192,0.824007679183403,196.1,17.7461538461538,66,1245.89495204155,-0.754239784322973
19619,522732.572,5329138.694,161,105,56,35.156,0,2005,1,119,303,169,0.802579942936205,38.9,17.9032967032967,50,1245.89495204155,-0.754239784322973
19619,522732.572,5329138.694,191,58,133,30.925,0,2006,2,123,322,177,0.806400603042641,82.6,18.867032967033,54,1245.89495204155,-0.754239784322973
19619,522732.572,5329138.694,86,77,9,38.424,0,2007,1,105,298,168,0.858783298675253,317.9,17.0824175824176,63,1245.89495204155,-0.754239784322973
19619,522732.572,5329138.694,86,54,32,12.125,0,2008,1,136,304,194,0.824945812952315,40.8,17.6131868131868,58,1245.89495204155,-0.754239784322973
19619,522732.572,5329138.694,176,68,108,31.302,0,2009,3,113,303,184,0.844897441365691,41,18.5230769230769,71,1245.89495204155,-0.754239784322973
19619,522732.572,5329138.694,168,74,94,30.712,0,2010,3,117,302,184,0.820378523740932,122,18.3626373626374,67,1245.89495204155,-0.754239784322973
19619,522732.572,5329138.694,93,64,29,36.643,1,2011,3,97,318,233,0.80806363488762,127.1,17.5,136,1245.89495204155,-0.754239784322973
19619,522732.572,5329138.694,152,80,72,34.445,0,2012,2,118,298,169,0.841037276292643,82.8,18.7043956043956,51,1245.89495204155,-0.754239784322973
19619,522732.572,5329138.694,182,51,131,41.354,0,2013,2,115,295,178,0.876642553892733,-163.1,19.2582417582418,63,1245.89495204155,-0.754239784322973
19619,522732.572,5329138.694,160,45,115,37.981,3,2014,2,103,318,162,0.849929281251265,176.9,17.856043956044,59,1245.89495204155,-0.754239784322973
19619,522732.572,5329138.694,159,94,65,46.483,0,2015,1,102,319,161,0.816708396504582,-158.6,20.9142857142857,59,1245.89495204155,-0.754239784322973
19619,522732.572,5329138.694,168,94,74,38.05,4,2016,1,117,327,169,0.845389201529211,45.5,18.8857142857143,52,1245.89495204155,-0.754239784322973
19619,522732.572,5329138.694,139,99,40,44.74,7,2017,1,98,307,169,0.818862935878246,-10.8,19.7879120879121,71,1245.89495204155,-0.754239784322973
19619,522732.572,5329138.694,173,93,80,36.816,0,2018,1,109,301,162,0.820554856469289,-154,20.578021978022,53,1245.89495204155,-0.754239784322973
19619,522732.572,5329138.694,167,78,89,31.712,4,2019,2,118,321,169,0.815365902771483,-79.8,20.6626373626374,51,1245.89495204155,-0.754239784322973
19619,522732.572,5329138.694,0,0,0,25.906,0,2020,0,112,279,209,0.749985322552976,-19.2,19.0648351648352,97,1245.89495204155,-0.754239784322973
19785,522964.229,5341416.481,0,0,0,129.763,0,2001,2,36,302,185,0.852060449634079,116.8,17.4,149,1261.79439150124,-1.50148327447671
19785,522964.229,5341416.481,159,65,94,32.329,0,2002,3,117,291,194,0.834147303185486,52.7,17.567032967033,77,1261.79439150124,-1.50148327447671
19785,522964.229,5341416.481,164,93,71,31.289,0,2003,1,117,307,162,0.811845228806258,-198,22.3252747252747,45,1261.79439150124,-1.50148327447671
19785,522964.229,5341416.481,163,98,65,21.105,0,2004,2,130,318,233,0.781557216103652,209.7,17.0835164835165,103,1261.79439150124,-1.50148327447671
19785,522964.229,5341416.481,0,0,0,32.157,0,2005,0,122,300,184,0.880270412692866,44.2,17.3054945054945,62,1261.79439150124,-1.50148327447671
19785,522964.229,5341416.481,187,62,125,24.051,1,2006,3,130,329,209,0.864843324576943,92.3,18.2626373626374,79,1261.79439150124,-1.50148327447671
19785,522964.229,5341416.481,0,0,0,35.048,0,2007,0,110,296,186,0.857972766094,332.6,16.5076923076923,76,1261.79439150124,-1.50148327447671
19785,522964.229,5341416.481,93,56,37,19.785,0,2008,3,126,298,201,0.860469104677736,50.1,16.9747252747253,75,1261.79439150124,-1.50148327447671
19785,522964.229,5341416.481,173,60,113,45.038,0,2009,2,100,282,162,0.847019427148711,55,17.8153846153846,62,1261.79439150124,-1.50148327447671
19785,522964.229,5341416.481,184,159,25,19.346,0,2010,1,130,295,185,0.854898983031269,133.1,17.7351648351648,55,1261.79439150124,-1.50148327447671
19785,522964.229,5341416.481,0,0,0,29.721,0,2011,0,104,302,162,0.843088763165007,136.1,17.0351648351648,58,1261.79439150124,-1.50148327447671
19785,522964.229,5341416.481,170,82,88,39.968,0,2012,2,113,299,176,0.875997803435331,88.9,18.4296703296703,63,1261.79439150124,-1.50148327447671
19785,522964.229,5341416.481,186,74,112,22.774,1,2013,2,132,296,200,0.829827822980562,-156.9,18.6175824175824,68,1261.79439150124,-1.50148327447671
19785,522964.229,5341416.481,147,49,98,31.174,0,2014,3,114,322,225,0.932414790241497,191.6,17.4516483516484,111,1261.79439150124,-1.50148327447671
19785,522964.229,5341416.481,170,80,90,33.252,0,2015,2,117,337,170,0.883381787265434,-154.6,20.4153846153846,53,1261.79439150124,-1.50148327447671
19785,522964.229,5341416.481,173,101,72,20.433,0,2016,1,134,309,184,0.859296881469838,50.9,18.5681318681319,50,1261.79439150124,-1.50148327447671
19785,522964.229,5341416.481,155,110,45,44.815,7,2017,1,98,291,178,0.832858914473134,-2.3,19.1582417582418,80,1261.79439150124,-1.50148327447671
19785,522964.229,5341416.481,168,100,68,46.134,0,2018,1,99,301,170,0.848397250938802,-151.3,19.9417582417582,71,1261.79439150124,-1.50148327447671
19785,522964.229,5341416.481,161,93,68,22.081,0,2019,1,129,309,177,0.841028157954314,-73.4,20.0571428571429,48,1261.79439150124,-1.50148327447671
19785,522964.229,5341416.481,0,0,0,23.757,0,2020,0,116,282,192,0.811915311542267,-13.6,18.3758241758242,76,1261.79439150124,-1.50148327447671
19786,522964.229,5341184.824,0,0,0,63.283,0,2001,3,92,290,184,0.85201726200681,116.8,17.4,92,1270.78103967327,1.36467115138113
19786,522964.229,5341184.824,158,64,94,32.329,0,2002,3,117,295,194,0.828146215005643,52.7,17.567032967033,77,1270.78103967327,1.36467115138113
19786,522964.229,5341184.824,171,93,78,31.289,0,2003,1,117,311,161,0.817518223729931,-198,22.3252747252747,44,1270.78103967327,1.36467115138113
19786,522964.229,5341184.824,163,104,59,23.018,0,2004,1,128,331,176,0.772495951032195,209.7,17.0835164835165,48,1270.78103967327,1.36467115138113
19786,522964.229,5341184.824,0,0,0,46.188,0,2005,0,109,309,209,0.806356469751791,44.2,17.3054945054945,100,1270.78103967327,1.36467115138113
19786,522964.229,5341184.824,187,64,123,27.774,1,2006,2,126,330,185,0.843762497669022,92.3,18.2626373626374,59,1270.78103967327,1.36467115138113
19786,522964.229,5341184.824,93,93,0,40.363,0,2007,1,103,302,178,0.847075906079304,332.6,16.5076923076923,75,1270.78103967327,1.36467115138113
19786,522964.229,5341184.824,86,57,29,17.218,0,2008,1,129,299,200,0.845508065148846,50.1,16.9747252747253,71,1270.78103967327,1.36467115138113
19786,522964.229,5341184.824,179,58,121,28.202,0,2009,2,117,281,176,0.882312103514608,55,17.8153846153846,59,1270.78103967327,1.36467115138113
19786,522964.229,5341184.824,177,93,84,23.195,0,2010,1,125,300,177,0.83884824643168,133.1,17.7351648351648,52,1270.78103967327,1.36467115138113
19786,522964.229,5341184.824,0,0,0,38.143,0,2011,0,94,317,161,0.831905959221766,136.1,17.0351648351648,67,1270.78103967327,1.36467115138113
19786,522964.229,5341184.824,167,82,85,45.445,1,2012,2,107,307,177,0.85551415981076,88.9,18.4296703296703,70,1270.78103967327,1.36467115138113
19786,522964.229,5341184.824,184,76,108,24.788,1,2013,3,130,297,201,0.811927535734208,-156.9,18.6175824175824,71,1270.78103967327,1.36467115138113
19786,522964.229,5341184.824,147,48,99,37.471,3,2014,2,104,324,178,0.814395499981073,191.6,17.4516483516484,74,1270.78103967327,1.36467115138113
19786,522964.229,5341184.824,167,80,87,40.807,0,2015,2,108,324,169,0.839837802796443,-154.6,20.4153846153846,61,1270.78103967327,1.36467115138113
19786,522964.229,5341184.824,173,135,38,29.368,0,2016,1,125,322,185,0.861672753833412,50.9,18.5681318681319,60,1270.78103967327,1.36467115138113
19786,522964.229,5341184.824,154,99,55,36.584,6,2017,1,109,295,176,0.810814815815351,-2.3,19.1582417582418,67,1270.78103967327,1.36467115138113
19786,522964.229,5341184.824,175,93,82,36.94,0,2018,2,108,302,169,0.844468637501606,-151.3,19.9417582417582,61,1270.78103967327,1.36467115138113
19786,522964.229,5341184.824,159,93,66,31.151,4,2019,1,119,304,176,0.798402281162814,-73.4,20.0571428571429,57,1270.78103967327,1.36467115138113
19786,522964.229,5341184.824,86,86,0,25.425,1,2020,1,113,307,194,0.786946724043131,-13.6,18.3758241758242,81,1270.78103967327,1.36467115138113
19787,522964.229,5340953.168,0,0,0,57.853,0,2001,3,97,324,192,0.83189347989725,116.8,17.4,95,1211.15444961202,0.549278643290053
19787,522964.229,5340953.168,144,83,61,39.036,0,2002,3,109,298,185,0.843478947608686,52.7,17.567032967033,76,1211.15444961202,0.549278643290053
19787,522964.229,5340953.168,162,93,69,33.746,0,2003,1,114,317,161,0.790665934990205,-198,22.3252747252747,47,1211.15444961202,0.549278643290053
19787,522964.229,5340953.168,139,94,45,36.154,0,2004,1,113,332,177,0.823640989296757,209.7,17.0835164835165,64,1211.15444961202,0.549278643290053
19787,522964.229,5340953.168,0,0,0,51.549,0,2005,0,104,313,168,0.833649837110416,44.2,17.3054945054945,64,1211.15444961202,0.549278643290053
19787,522964.229,5340953.168,186,69,117,42.054,2,2006,2,112,339,178,0.830493967797569,92.3,18.2626373626374,66,1211.15444961202,0.549278643290053
19787,522964.229,5340953.168,0,0,0,63.3,0,2007,0,80,305,216,0.803369176313392,332.6,16.5076923076923,136,1211.15444961202,0.549278643290053
19787,522964.229,5340953.168,86,61,25,23.59,0,2008,1,122,293,201,0.853790119375339,50.1,16.9747252747253,79,1211.15444961202,0.549278643290053
19787,522964.229,5340953.168,174,55,119,37.626,0,2009,2,107,292,170,0.881758485033819,55,17.8153846153846,63,1211.15444961202,0.549278643290053
19787,522964.229,5340953.168,133,95,38,27.496,0,2010,2,119,311,185,0.84363143882971,133.1,17.7351648351648,66,1211.15444961202,0.549278643290053
19787,522964.229,5340953.168,106,93,13,41.706,1,2011,1,90,320,154,0.827869029817541,136.1,17.0351648351648,64,1211.15444961202,0.549278643290053
19787,522964.229,5340953.168,167,80,87,46.311,1,2012,2,106,307,169,0.839849472666516,88.9,18.4296703296703,63,1211.15444961202,0.549278643290053
19787,522964.229,5340953.168,171,78,93,49.988,1,2013,3,106,301,185,0.844548585653673,-156.9,18.6175824175824,79,1211.15444961202,0.549278643290053
19787,522964.229,5340953.168,86,57,29,50.182,3,2014,1,87,325,170,0.816471779328701,191.6,17.4516483516484,83,1211.15444961202,0.549278643290053
19787,522964.229,5340953.168,156,81,75,47.355,0,2015,2,101,340,162,0.846216013087614,-154.6,20.4153846153846,61,1211.15444961202,0.549278643290053
19787,522964.229,5340953.168,165,93,72,42.404,7,2016,1,113,330,178,0.865307036871771,50.9,18.5681318681319,65,1211.15444961202,0.549278643290053
19787,522964.229,5340953.168,161,101,60,35.057,4,2017,1,111,295,177,0.814049048962337,-2.3,19.1582417582418,66,1211.15444961202,0.549278643290053
19787,522964.229,5340953.168,156,93,63,54.124,1,2018,1,92,312,160,0.865696700650765,-151.3,19.9417582417582,68,1211.15444961202,0.549278643290053
19787,522964.229,5340953.168,150,80,70,44.23,6,2019,2,104,324,169,0.798399002544575,-73.4,20.0571428571429,65,1211.15444961202,0.549278643290053
19787,522964.229,5340953.168,93,93,0,31.826,3,2020,2,103,315,192,0.799015868999409,-13.6,18.3758241758242,89,1211.15444961202,0.549278643290053
19788,522964.229,5340721.512,0,0,0,115.728,0,2001,2,48,331,241,0.853156163224884,116.8,17.4,193,1148.38530898995,-1.51532322640433
19788,522964.229,5340721.512,145,84,61,46.545,3,2002,3,100,298,192,0.856615987124175,52.7,17.567032967033,92,1148.38530898995,-1.51532322640433
19788,522964.229,5340721.512,160,93,67,36.254,0,2003,1,111,330,154,0.788283436972864,-198,22.3252747252747,43,1148.38530898995,-1.51532322640433
19788,522964.229,5340721.512,140,93,47,39.026,0,2004,1,110,332,170,0.827190784234727,209.7,17.0835164835165,60,1148.38530898995,-1.51532322640433
19788,522964.229,5340721.512,0,0,0,46.188,0,2005,0,109,312,169,0.8419942557154,44.2,17.3054945054945,60,1148.38530898995,-1.51532322640433
19788,522964.229,5340721.512,186,66,120,44.551,2,2006,2,110,341,177,0.825781128775166,92.3,18.2626373626374,67,1148.38530898995,-1.51532322640433
19788,522964.229,5340721.512,94,94,0,72.39,9,2007,2,71,311,217,0.809578065153357,332.6,16.5076923076923,146,1148.38530898995,-1.51532322640433
19788,522964.229,5340721.512,86,62,24,57.538,6,2008,1,92,303,185,0.847190228412287,50.1,16.9747252747253,93,1148.38530898995,-1.51532322640433
19788,522964.229,5340721.512,173,57,116,33.61,0,2009,2,111,304,177,0.882674928205781,55,17.8153846153846,66,1148.38530898995,-1.51532322640433
19788,522964.229,5340721.512,134,94,40,29.782,0,2010,1,116,315,178,0.839952590776891,133.1,17.7351648351648,62,1148.38530898995,-1.51532322640433
19788,522964.229,5340721.512,107,93,14,41.706,1,2011,1,90,322,153,0.815292640108139,136.1,17.0351648351648,63,1148.38530898995,-1.51532322640433
19788,522964.229,5340721.512,164,81,83,42.757,0,2012,2,110,310,162,0.841672341740738,88.9,18.4296703296703,52,1148.38530898995,-1.51532322640433
19788,522964.229,5340721.512,171,78,93,56.734,1,2013,3,101,307,192,0.839667565542746,-156.9,18.6175824175824,91,1148.38530898995,-1.51532322640433
19788,522964.229,5340721.512,86,59,27,59.349,8,2014,1,76,326,177,0.827177491893484,191.6,17.4516483516484,101,1148.38530898995,-1.51532322640433
19788,522964.229,5340721.512,155,82,73,48.377,0,2015,2,100,338,161,0.842546289639664,-154.6,20.4153846153846,61,1148.38530898995,-1.51532322640433
19788,522964.229,5340721.512,166,93,73,49.344,7,2016,1,107,335,178,0.875292765768043,50.9,18.5681318681319,71,1148.38530898995,-1.51532322640433
19788,522964.229,5340721.512,159,97,62,38.857,7,2017,1,106,300,170,0.827215985723101,-2.3,19.1582417582418,64,1148.38530898995,-1.51532322640433
19788,522964.229,5340721.512,163,98,65,38.911,0,2018,1,106,310,161,0.867956529522279,-151.3,19.9417582417582,55,1148.38530898995,-1.51532322640433
19788,522964.229,5340721.512,150,80,70,43.312,5,2019,2,105,330,162,0.806694149470998,-73.4,20.0571428571429,57,1148.38530898995,-1.51532322640433
19788,522964.229,5340721.512,93,93,0,33.263,3,2020,2,101,316,193,0.807687920612248,-13.6,18.3758241758242,92,1148.38530898995,-1.51532322640433
19824,522964.229,5332381.883,100,93,7,45.967,6,2001,3,107,303,178,0.899844365893635,103.5,18.1120879120879,71,1133.18035510076,-0.099702932596542
19824,522964.229,5332381.883,86,83,3,19.15,0,2002,1,131,295,209,0.865184651063213,46.4,18.2428571428571,78,1133.18035510076,-0.099702932596542
19824,522964.229,5332381.883,155,55,100,38.54,1,2003,2,108,336,161,0.8521205780469,-203.8,22.9692307692308,53,1133.18035510076,-0.099702932596542
19824,522964.229,5332381.883,157,93,64,35.791,0,2004,2,114,306,201,0.871082504633142,196.1,17.7461538461538,87,1133.18035510076,-0.099702932596542
19824,522964.229,5332381.883,163,93,70,45.18,0,2005,1,110,307,170,0.882532712044342,38.9,17.9032967032967,60,1133.18035510076,-0.099702932596542
19824,522964.229,5332381.883,183,68,115,43.612,1,2006,2,112,320,169,0.883852448190762,82.6,18.867032967033,57,1133.18035510076,-0.099702932596542
19824,522964.229,5332381.883,0,0,0,51.423,0,2007,0,91,290,217,0.855444471866216,317.9,17.0824175824176,126,1133.18035510076,-0.099702932596542
19824,522964.229,5332381.883,86,69,17,25.659,0,2008,1,120,295,168,0.863900479610861,40.8,17.6131868131868,48,1133.18035510076,-0.099702932596542
19824,522964.229,5332381.883,180,62,118,27.734,0,2009,2,117,306,169,0.892536501964098,41,18.5230769230769,52,1133.18035510076,-0.099702932596542
19824,522964.229,5332381.883,164,77,87,28.975,0,2010,2,119,293,178,0.887004993059768,122,18.3626373626374,59,1133.18035510076,-0.099702932596542
19824,522964.229,5332381.883,99,59,40,32.287,1,2011,2,102,314,177,0.87935448722464,127.1,17.5,75,1133.18035510076,-0.099702932596542
19824,522964.229,5332381.883,144,93,51,40.85,0,2012,2,112,317,193,0.899867601842415,82.8,18.7043956043956,81,1133.18035510076,-0.099702932596542
19824,522964.229,5332381.883,160,76,84,32.431,0,2013,3,123,294,201,0.898090437033699,-163.1,19.2582417582418,78,1133.18035510076,-0.099702932596542
19824,522964.229,5332381.883,154,52,102,34.042,1,2014,3,109,305,217,0.861542470453013,176.9,17.856043956044,108,1133.18035510076,-0.099702932596542
19824,522964.229,5332381.883,157,93,64,34.05,0,2015,1,116,328,162,0.881166047045449,-158.6,20.9142857142857,46,1133.18035510076,-0.099702932596542
19824,522964.229,5332381.883,157,94,63,17.351,0,2016,2,137,330,249,0.829193216357487,45.5,18.8857142857143,112,1133.18035510076,-0.099702932596542
19824,522964.229,5332381.883,125,94,31,31.079,3,2017,2,116,322,185,0.882886958363438,-10.8,19.7879120879121,69,1133.18035510076,-0.099702932596542
19824,522964.229,5332381.883,170,84,86,34.006,0,2018,2,112,329,170,0.90306452903838,-154,20.578021978022,58,1133.18035510076,-0.099702932596542
19824,522964.229,5332381.883,158,93,65,29,4,2019,1,121,329,177,0.888522719857685,-79.8,20.6626373626374,56,1133.18035510076,-0.099702932596542
19824,522964.229,5332381.883,93,93,0,31.059,3,2020,2,104,303,224,0.825321550274068,-19.2,19.0648351648352,120,1133.18035510076,-0.099702932596542
19825,522964.229,5332150.226,105,85,20,42.576,4,2001,3,110,289,177,0.866195326827476,103.5,18.1120879120879,67,1185.23701951784,-1.29268780756034
19825,522964.229,5332150.226,158,65,93,22.032,0,2002,3,128,296,241,0.813443616615645,46.4,18.2428571428571,113,1185.23701951784,-1.29268780756034
19825,522964.229,5332150.226,166,62,104,33.403,0,2003,2,114,294,168,0.848141569377524,-203.8,22.9692307692308,54,1185.23701951784,-1.29268780756034
19825,522964.229,5332150.226,170,29,141,29.278,0,2004,2,121,301,193,0.847359913752791,196.1,17.7461538461538,72,1185.23701951784,-1.29268780756034
19825,522964.229,5332150.226,159,97,62,44.038,0,2005,1,111,309,169,0.861253745341401,38.9,17.9032967032967,58,1185.23701951784,-1.29268780756034
19825,522964.229,5332150.226,197,65,132,29.895,0,2006,2,124,332,176,0.862226274308915,82.6,18.867032967033,52,1185.23701951784,-1.29268780756034
19825,522964.229,5332150.226,94,93,1,40.043,0,2007,1,103,300,154,0.805938779030802,317.9,17.0824175824176,51,1185.23701951784,-1.29268780756034
19825,522964.229,5332150.226,179,58,121,24.635,0,2008,3,121,296,232,0.842499148188512,40.8,17.6131868131868,111,1185.23701951784,-1.29268780756034
19825,522964.229,5332150.226,181,60,121,39.629,0,2009,2,105,298,146,0.843759928388701,41,18.5230769230769,41,1185.23701951784,-1.29268780756034
19825,522964.229,5332150.226,173,75,98,27.331,0,2010,2,121,304,170,0.844133850015271,122,18.3626373626374,49,1185.23701951784,-1.29268780756034
19825,522964.229,5332150.226,131,83,48,33.958,1,2011,2,100,319,162,0.850621399794487,127.1,17.5,62,1185.23701951784,-1.29268780756034
19825,522964.229,5332150.226,174,155,19,32.347,0,2012,1,120,308,169,0.876900131258443,82.8,18.7043956043956,49,1185.23701951784,-1.29268780756034
19825,522964.229,5332150.226,178,80,98,43.549,0,2013,2,113,291,176,0.899992787441069,-163.1,19.2582417582418,63,1185.23701951784,-1.29268780756034
19825,522964.229,5332150.226,166,40,126,33.407,0,2014,2,110,318,161,0.854039755014321,176.9,17.856043956044,51,1185.23701951784,-1.29268780756034
19825,522964.229,5332150.226,161,93,68,39.952,0,2015,1,109,304,161,0.865965730757405,-158.6,20.9142857142857,52,1185.23701951784,-1.29268780756034
19825,522964.229,5332150.226,168,113,55,38.05,4,2016,1,117,329,169,0.903152102505548,45.5,18.8857142857143,52,1185.23701951784,-1.29268780756034
19825,522964.229,5332150.226,127,98,29,28.745,0,2017,1,119,296,177,0.867284878662459,-10.8,19.7879120879121,58,1185.23701951784,-1.29268780756034
19825,522964.229,5332150.226,175,93,82,34.908,0,2018,1,111,305,169,0.90442006012556,-154,20.578021978022,58,1185.23701951784,-1.29268780756034
19825,522964.229,5332150.226,173,82,91,32.593,4,2019,2,117,292,170,0.873227987489902,-79.8,20.6626373626374,53,1185.23701951784,-1.29268780756034
19825,522964.229,5332150.226,0,0,0,25.906,0,2020,0,112,307,177,0.83638133272919,-19.2,19.0648351648352,65,1185.23701951784,-1.29268780756034
19826,522964.229,5331918.57,105,85,20,36.006,0,2001,3,116,295,177,0.848275522010585,103.5,18.1120879120879,61,1213.31603355175,0.911484248771281
19826,522964.229,5331918.57,157,66,91,23.03,0,2002,3,127,298,241,0.817685991506018,46.4,18.2428571428571,114,1213.31603355175,0.911484248771281
19826,522964.229,5331918.57,165,62,103,35.971,0,2003,2,111,283,160,0.815209857600639,-203.8,22.9692307692308,49,1213.31603355175,0.911484248771281
19826,522964.229,5331918.57,169,26,143,24.906,0,2004,2,126,305,186,0.83467177444986,196.1,17.7461538461538,60,1213.31603355175,0.911484248771281
19826,522964.229,5331918.57,157,93,64,45.18,0,2005,1,110,314,169,0.849339488165917,38.9,17.9032967032967,59,1213.31603355175,0.911484248771281
19826,522964.229,5331918.57,190,68,122,51.465,1,2006,2,106,330,170,0.843329686803076,82.6,18.867032967033,64,1213.31603355175,0.911484248771281
19826,522964.229,5331918.57,0,0,0,44.437,0,2007,0,98,298,153,0.810881473674897,317.9,17.0824175824176,55,1213.31603355175,0.911484248771281
19826,522964.229,5331918.57,174,56,118,39.294,1,2008,3,108,294,225,0.857731997005273,40.8,17.6131868131868,117,1213.31603355175,0.911484248771281
19826,522964.229,5331918.57,184,61,123,35.331,0,2009,2,109,297,152,0.863170516842989,41,18.5230769230769,43,1213.31603355175,0.911484248771281
19826,522964.229,5331918.57,172,75,97,27.331,0,2010,2,121,305,176,0.841034247099453,122,18.3626373626374,55,1213.31603355175,0.911484248771281
19826,522964.229,5331918.57,133,84,49,34.83,1,2011,2,99,320,154,0.845261289754926,127.1,17.5,55,1213.31603355175,0.911484248771281
19826,522964.229,5331918.57,174,155,19,33.376,0,2012,1,119,306,177,0.860685129296467,82.8,18.7043956043956,58,1213.31603355175,0.911484248771281
19826,522964.229,5331918.57,177,79,98,49.458,0,2013,2,108,292,176,0.895064356926065,-163.1,19.2582417582418,68,1213.31603355175,0.911484248771281
19826,522964.229,5331918.57,160,40,120,36.632,3,2014,2,105,319,177,0.857156603442,176.9,17.856043956044,72,1213.31603355175,0.911484248771281
19826,522964.229,5331918.57,158,93,65,55.437,4,2015,1,94,299,161,0.857772501635445,-158.6,20.9142857142857,67,1213.31603355175,0.911484248771281
19826,522964.229,5331918.57,168,112,56,33.772,0,2016,1,121,322,178,0.861989152180355,45.5,18.8857142857143,57,1213.31603355175,0.911484248771281
19826,522964.229,5331918.57,126,98,28,29.541,1,2017,1,118,300,184,0.848949234504423,-10.8,19.7879120879121,66,1213.31603355175,0.911484248771281
19826,522964.229,5331918.57,174,123,51,36.816,0,2018,1,109,306,162,0.881383138562664,-154,20.578021978022,53,1213.31603355175,0.911484248771281
19826,522964.229,5331918.57,178,93,85,26.352,4,2019,1,124,291,169,0.849673091624029,-79.8,20.6626373626374,45,1213.31603355175,0.911484248771281
19826,522964.229,5331918.57,0,0,0,25.906,0,2020,0,112,308,185,0.810365712896709,-19.2,19.0648351648352,73,1213.31603355175,0.911484248771281
19827,522964.229,5331686.914,104,83,21,36.006,0,2001,4,116,295,184,0.860887135919312,103.5,18.1120879120879,68,1234.03234060672,0.732741193187621
19827,522964.229,5331686.914,154,80,74,27.076,0,2002,3,123,284,194,0.853104676467034,46.4,18.2428571428571,71,1234.03234060672,0.732741193187621
19827,522964.229,5331686.914,163,56,107,29.244,0,2003,2,119,318,162,0.840729733067268,-203.8,22.9692307692308,43,1234.03234060672,0.732741193187621
19827,522964.229,5331686.914,165,96,69,21.135,0,2004,2,130,302,210,0.856450339343223,196.1,17.7461538461538,80,1234.03234060672,0.732741193187621
19827,522964.229,5331686.914,156,93,63,41.8,0,2005,1,113,308,178,0.869894050683158,38.9,17.9032967032967,65,1234.03234060672,0.732741193187621
19827,522964.229,5331686.914,197,66,131,14.072,0,2006,3,140,328,186,0.848943502793564,82.6,18.867032967033,46,1234.03234060672,0.732741193187621
19827,522964.229,5331686.914,0,0,0,43.519,0,2007,0,99,307,184,0.855153225448074,317.9,17.0824175824176,85,1234.03234060672,0.732741193187621
19827,522964.229,5331686.914,0,0,0,34.761,0,2008,0,112,289,185,0.844314815266029,40.8,17.6131868131868,73,1234.03234060672,0.732741193187621
19827,522964.229,5331686.914,169,60,109,52.802,0,2009,2,94,296,170,0.896864680474462,41,18.5230769230769,76,1234.03234060672,0.732741193187621
19827,522964.229,5331686.914,169,66,103,24.877,0,2010,2,124,285,184,0.837908590832864,122,18.3626373626374,60,1234.03234060672,0.732741193187621
19827,522964.229,5331686.914,86,85,1,33.111,1,2011,1,101,317,201,0.830632530653973,127.1,17.5,100,1234.03234060672,0.732741193187621
19827,522964.229,5331686.914,162,94,68,31.344,0,2012,2,121,308,192,0.863180300107282,82.8,18.7043956043956,71,1234.03234060672,0.732741193187621
19827,522964.229,5331686.914,170,93,77,23.773,0,2013,2,131,297,193,0.863128325090935,-163.1,19.2582417582418,62,1234.03234060672,0.732741193187621
19827,522964.229,5331686.914,158,50,108,31.519,0,2014,3,113,317,185,0.848688427425663,176.9,17.856043956044,72,1234.03234060672,0.732741193187621
19827,522964.229,5331686.914,160,93,67,33.255,0,2015,1,117,291,170,0.878088727811411,-158.6,20.9142857142857,53,1234.03234060672,0.732741193187621
19827,522964.229,5331686.914,170,126,44,31.57,0,2016,2,123,323,217,0.850711296398467,45.5,18.8857142857143,94,1234.03234060672,0.732741193187621
19827,522964.229,5331686.914,124,94,30,29.541,1,2017,2,118,291,217,0.849334691762657,-10.8,19.7879120879121,99,1234.03234060672,0.732741193187621
19827,522964.229,5331686.914,160,56,104,36.816,0,2018,2,109,313,170,0.877377462315427,-154,20.578021978022,61,1234.03234060672,0.732741193187621
19827,522964.229,5331686.914,168,82,86,24.54,2,2019,2,126,292,170,0.849620071954131,-79.8,20.6626373626374,44,1234.03234060672,0.732741193187621
19827,522964.229,5331686.914,0,0,0,23.11,0,2020,0,117,306,202,0.809061467981779,-19.2,19.0648351648352,85,1234.03234060672,0.732741193187621
19833,522964.229,5330296.975,86,83,3,45.967,6,2001,2,107,290,176,0.854598236449582,103.5,18.1120879120879,69,1202.33549600149,0.00730971037183849
19833,522964.229,5330296.975,152,68,84,33.203,0,2002,2,116,292,177,0.824706645084676,46.4,18.2428571428571,61,1202.33549600149,0.00730971037183849
19833,522964.229,5330296.975,158,59,99,35.12,0,2003,2,112,320,162,0.846274483428481,-203.8,22.9692307692308,50,1202.33549600149,0.00730971037183849
19833,522964.229,5330296.975,168,93,75,36.795,0,2004,2,113,306,185,0.845504409627531,196.1,17.7461538461538,72,1202.33549600149,0.00730971037183849
19833,522964.229,5330296.975,168,137,31,45.18,0,2005,1,110,308,162,0.871661261822462,38.9,17.9032967032967,52,1202.33549600149,0.00730971037183849
19833,522964.229,5330296.975,177,93,84,51.465,1,2006,1,106,325,176,0.841856120508709,82.6,18.867032967033,70,1202.33549600149,0.00730971037183849
19833,522964.229,5330296.975,0,0,0,47.311,0,2007,0,95,298,161,0.858036647534727,317.9,17.0824175824176,66,1202.33549600149,0.00730971037183849
19833,522964.229,5330296.975,86,54,32,27.767,0,2008,1,118,298,170,0.86897539792707,40.8,17.6131868131868,52,1202.33549600149,0.00730971037183849
19833,522964.229,5330296.975,172,64,108,45.396,0,2009,2,100,299,162,0.891643798569393,41,18.5230769230769,62,1202.33549600149,0.00730971037183849
19833,522964.229,5330296.975,150,70,80,28.975,0,2010,2,119,301,177,0.847429568638194,122,18.3626373626374,58,1202.33549600149,0.00730971037183849
19833,522964.229,5330296.975,137,64,73,34.83,1,2011,2,99,321,161,0.834415910086864,127.1,17.5,62,1202.33549600149,0.00730971037183849
19833,522964.229,5330296.975,162,93,69,26.282,0,2012,1,126,307,178,0.864258200476189,82.8,18.7043956043956,52,1202.33549600149,0.00730971037183849
19833,522964.229,5330296.975,196,68,128,11.311,0,2013,3,143,295,185,0.8525926164508,-163.1,19.2582417582418,42,1202.33549600149,0.00730971037183849
19833,522964.229,5330296.975,152,63,89,41.568,3,2014,3,98,315,226,0.842430845189826,176.9,17.856043956044,128,1202.33549600149,0.00730971037183849
19833,522964.229,5330296.975,165,93,72,53.012,2,2015,1,96,322,169,0.865441094345897,-158.6,20.9142857142857,73,1202.33549600149,0.00730971037183849
19833,522964.229,5330296.975,171,142,29,43.353,6,2016,1,112,325,176,0.887521189303094,45.5,18.8857142857143,64,1202.33549600149,0.00730971037183849
19833,522964.229,5330296.975,147,97,50,34.789,4,2017,1,111,299,169,0.841647036430414,-10.8,19.7879120879121,58,1202.33549600149,0.00730971037183849
19833,522964.229,5330296.975,145,52,93,39.97,0,2018,2,106,315,169,0.834832807374381,-154,20.578021978022,63,1202.33549600149,0.00730971037183849
19833,522964.229,5330296.975,153,93,60,35.924,4,2019,1,113,331,169,0.839927261240432,-79.8,20.6626373626374,56,1202.33549600149,0.00730971037183849
19833,522964.229,5330296.975,105,94,11,28.381,1,2020,1,108,306,177,0.818519144922986,-19.2,19.0648351648352,69,1202.33549600149,0.00730971037183849
19834,522964.229,5330065.319,86,83,3,40.363,2,2001,2,112,285,178,0.855242841897957,103.5,18.1120879120879,66,1211.00760104282,1.18518558681121
19834,522964.229,5330065.319,153,66,87,33.203,0,2002,2,116,294,177,0.820429906083298,46.4,18.2428571428571,61,1211.00760104282,1.18518558681121
19834,522964.229,5330065.319,159,59,100,34.263,0,2003,2,113,319,168,0.844792171509832,-203.8,22.9692307692308,55,1211.00760104282,1.18518558681121
19834,522964.229,5330065.319,169,100,69,34.798,0,2004,1,115,306,186,0.845919854036674,196.1,17.7461538461538,71,1211.00760104282,1.18518558681121
19834,522964.229,5330065.319,167,130,37,48.62,0,2005,1,107,310,161,0.843674958916014,38.9,17.9032967032967,54,1211.00760104282,1.18518558681121
19834,522964.229,5330065.319,178,93,85,48.745,1,2006,1,108,325,176,0.837451913108585,82.6,18.867032967033,68,1211.00760104282,1.18518558681121
19834,522964.229,5330065.319,160,148,12,40.881,0,2007,1,102,295,162,0.856813225466285,317.9,17.0824175824176,60,1211.00760104282,1.18518558681121
19834,522964.229,5330065.319,73,49,24,24.635,0,2008,1,121,301,177,0.865373942949225,40.8,17.6131868131868,56,1211.00760104282,1.18518558681121
19834,522964.229,5330065.319,173,64,109,43.036,0,2009,2,102,300,160,0.869570358252884,41,18.5230769230769,58,1211.00760104282,1.18518558681121
19834,522964.229,5330065.319,149,70,79,27.331,0,2010,2,121,301,176,0.83326009724,122,18.3626373626374,55,1211.00760104282,1.18518558681121
19834,522964.229,5330065.319,139,64,75,35.725,1,2011,2,98,322,160,0.805947082324432,127.1,17.5,62,1211.00760104282,1.18518558681121
19834,522964.229,5330065.319,163,98,65,26.282,0,2012,1,126,307,177,0.856702492204647,82.8,18.7043956043956,51,1211.00760104282,1.18518558681121
19834,522964.229,5330065.319,196,70,126,13.554,0,2013,3,141,291,185,0.855300998164672,-163.1,19.2582417582418,44,1211.00760104282,1.18518558681121
19834,522964.229,5330065.319,150,60,90,44.602,3,2014,3,94,321,217,0.851781116522008,176.9,17.856043956044,123,1211.00760104282,1.18518558681121
19834,522964.229,5330065.319,171,111,60,43.592,0,2015,1,105,327,168,0.859528427675095,-158.6,20.9142857142857,63,1211.00760104282,1.18518558681121
19834,522964.229,5330065.319,171,143,28,44.478,6,2016,1,111,324,170,0.87329743550406,45.5,18.8857142857143,59,1211.00760104282,1.18518558681121
19834,522964.229,5330065.319,148,98,50,34.029,3,2017,2,112,298,225,0.823686983082052,-10.8,19.7879120879121,113,1211.00760104282,1.18518558681121
19834,522964.229,5330065.319,146,49,97,36.816,0,2018,2,109,301,169,0.82692916086759,-154,20.578021978022,60,1211.00760104282,1.18518558681121
19834,522964.229,5330065.319,155,93,62,31.712,4,2019,1,118,331,169,0.830895847437159,-79.8,20.6626373626374,51,1211.00760104282,1.18518558681121
19834,522964.229,5330065.319,107,93,14,26.508,1,2020,2,111,307,184,0.795904898545076,-19.2,19.0648351648352,73,1211.00760104282,1.18518558681121
19835,522964.229,5329833.663,86,83,3,39.272,1,2001,2,113,290,184,0.855525430163845,103.5,18.1120879120879,71,1209.30213491019,-1.35165507277256
19835,522964.229,5329833.663,86,66,20,31.469,0,2002,1,118,296,177,0.850033935592988,46.4,18.2428571428571,59,1209.30213491019,-1.35165507277256
19835,522964.229,5329833.663,173,53,120,35.12,0,2003,2,112,320,168,0.844988339898,-203.8,22.9692307692308,56,1209.30213491019,-1.35165507277256
19835,522964.229,5329833.663,170,104,66,37.822,0,2004,1,112,324,185,0.85234960358833,196.1,17.7461538461538,73,1209.30213491019,-1.35165507277256
19835,522964.229,5329833.663,157,100,57,41.8,0,2005,1,113,312,170,0.858251569496006,38.9,17.9032967032967,57,1209.30213491019,-1.35165507277256
19835,522964.229,5329833.663,182,66,116,38.802,1,2006,2,116,325,177,0.842976299890592,82.6,18.867032967033,61,1209.30213491019,-1.35165507277256
19835,522964.229,5329833.663,86,78,8,46.331,0,2007,1,96,299,202,0.803214973843187,317.9,17.0824175824176,106,1209.30213491019,-1.35165507277256
19835,522964.229,5329833.663,176,68,108,31.216,0,2008,2,115,310,170,0.851355369527199,40.8,17.6131868131868,55,1209.30213491019,-1.35165507277256
19835,522964.229,5329833.663,175,62,113,40.743,0,2009,2,104,299,162,0.883435586682264,41,18.5230769230769,58,1209.30213491019,-1.35165507277256
19835,522964.229,5329833.663,158,70,88,32.534,0,2010,3,115,302,184,0.841861983356086,122,18.3626373626374,69,1209.30213491019,-1.35165507277256
19835,522964.229,5329833.663,146,98,48,37.588,1,2011,1,96,321,169,0.831471862408313,127.1,17.5,73,1209.30213491019,-1.35165507277256
19835,522964.229,5329833.663,150,103,47,39.884,0,2012,1,113,305,170,0.853143021278416,82.8,18.7043956043956,57,1209.30213491019,-1.35165507277256
19835,522964.229,5329833.663,169,106,63,25.819,0,2013,1,129,298,177,0.891261580193703,-163.1,19.2582417582418,48,1209.30213491019,-1.35165507277256
19835,522964.229,5329833.663,157,62,95,38.673,3,2014,2,102,320,176,0.837974133293122,176.9,17.856043956044,74,1209.30213491019,-1.35165507277256
19835,522964.229,5329833.663,175,94,81,51.845,1,2015,1,97,324,169,0.813306256647315,-158.6,20.9142857142857,72,1209.30213491019,-1.35165507277256
19835,522964.229,5329833.663,166,100,66,39.103,5,2016,1,116,325,176,0.880966814755492,45.5,18.8857142857143,60,1209.30213491019,-1.35165507277256
19835,522964.229,5329833.663,152,93,59,32.535,3,2017,1,114,308,169,0.820053590497888,-10.8,19.7879120879121,55,1209.30213491019,-1.35165507277256
19835,522964.229,5329833.663,162,57,105,42.191,0,2018,2,104,319,178,0.785819786777325,-154,20.578021978022,74,1209.30213491019,-1.35165507277256
19835,522964.229,5329833.663,157,93,64,31.712,4,2019,1,118,316,169,0.826073637862605,-79.8,20.6626373626374,51,1209.30213491019,-1.35165507277256
19835,522964.229,5329833.663,0,0,0,26.508,0,2020,0,111,309,185,0.772165085899151,-19.2,19.0648351648352,74,1209.30213491019,-1.35165507277256
19836,522964.229,5329602.006,86,82,4,39.272,1,2001,2,113,293,184,0.840597359371397,103.5,18.1120879120879,71,1220.6174797529,-1.43099028444041
19836,522964.229,5329602.006,86,67,19,27.076,0,2002,1,123,297,184,0.805582163218808,46.4,18.2428571428571,61,1220.6174797529,-1.43099028444041
19836,522964.229,5329602.006,170,53,117,37.678,1,2003,2,109,314,168,0.824708908877929,-203.8,22.9692307692308,59,1220.6174797529,-1.43099028444041
19836,522964.229,5329602.006,170,100,70,33.829,0,2004,2,116,325,192,0.829725110605452,196.1,17.7461538461538,76,1220.6174797529,-1.43099028444041
19836,522964.229,5329602.006,156,105,51,40.722,0,2005,1,114,310,169,0.822765947634474,38.9,17.9032967032967,55,1220.6174797529,-1.43099028444041
19836,522964.229,5329602.006,186,65,121,21.947,0,2006,3,132,324,185,0.834068951727058,82.6,18.867032967033,53,1220.6174797529,-1.43099028444041
19836,522964.229,5329602.006,86,77,9,45.373,0,2007,1,97,299,216,0.762636766992352,317.9,17.0824175824176,119,1220.6174797529,-1.43099028444041
19836,522964.229,5329602.006,178,68,110,27.767,0,2008,2,118,311,177,0.843000475629332,40.8,17.6131868131868,59,1220.6174797529,-1.43099028444041
19836,522964.229,5329602.006,184,62,122,26.89,0,2009,3,118,298,162,0.870616054544839,41,18.5230769230769,44,1220.6174797529,-1.43099028444041
19836,522964.229,5329602.006,162,70,92,28.975,0,2010,2,119,302,177,0.831361827623028,122,18.3626373626374,58,1220.6174797529,-1.43099028444041
19836,522964.229,5329602.006,148,98,50,33.111,1,2011,1,101,320,169,0.820462185043313,127.1,17.5,68,1220.6174797529,-1.43099028444041
19836,522964.229,5329602.006,154,106,48,36.671,0,2012,1,116,300,168,0.859305271946615,82.8,18.7043956043956,52,1220.6174797529,-1.43099028444041
19836,522964.229,5329602.006,168,80,88,25.819,0,2013,2,129,297,176,0.817996457107081,-163.1,19.2582417582418,47,1220.6174797529,-1.43099028444041
19836,522964.229,5329602.006,157,61,96,35.971,2,2014,2,106,318,170,0.834776282295587,176.9,17.856043956044,64,1220.6174797529,-1.43099028444041
19836,522964.229,5329602.006,175,93,82,50.709,0,2015,1,98,324,168,0.81246428994754,-158.6,20.9142857142857,70,1220.6174797529,-1.43099028444041
19836,522964.229,5329602.006,168,93,75,34.845,1,2016,1,120,325,170,0.875453554336366,45.5,18.8857142857143,50,1220.6174797529,-1.43099028444041
19836,522964.229,5329602.006,152,99,53,31.805,3,2017,1,115,307,176,0.814886903713725,-10.8,19.7879120879121,61,1220.6174797529,-1.43099028444041
19836,522964.229,5329602.006,164,57,107,38.886,0,2018,2,107,307,161,0.82516360872605,-154,20.578021978022,54,1220.6174797529,-1.43099028444041
19836,522964.229,5329602.006,159,95,64,29.899,4,2019,1,120,313,169,0.809427395901683,-79.8,20.6626373626374,49,1220.6174797529,-1.43099028444041
19836,522964.229,5329602.006,0,0,0,25.318,0,2020,0,113,277,185,0.778024751013911,-19.2,19.0648351648352,72,1220.6174797529,-1.43099028444041
19837,522964.229,5329370.35,86,84,2,37.114,0,2001,2,115,298,168,0.763656819887178,103.5,18.1120879120879,53,1237.65238375546,-1.4504710116036
19837,522964.229,5329370.35,86,64,22,23.03,0,2002,1,127,292,184,0.810363346359554,46.4,18.2428571428571,57,1237.65238375546,-1.4504710116036
19837,522964.229,5329370.35,169,52,117,30.907,0,2003,2,117,294,168,0.792620461148132,-203.8,22.9692307692308,51,1237.65238375546,-1.4504710116036
19837,522964.229,5329370.35,174,93,81,26.664,0,2004,2,124,327,186,0.819804895914613,196.1,17.7461538461538,62,1237.65238375546,-1.4504710116036
19837,522964.229,5329370.35,166,93,73,33.058,0,2005,2,121,300,177,0.778184541475125,38.9,17.9032967032967,56,1237.65238375546,-1.4504710116036
19837,522964.229,5329370.35,193,55,138,22.965,0,2006,2,131,323,177,0.785986222189866,82.6,18.867032967033,46,1237.65238375546,-1.4504710116036
19837,522964.229,5329370.35,86,77,9,37.648,0,2007,1,106,299,209,0.763519943182181,317.9,17.0824175824176,103,1237.65238375546,-1.4504710116036
19837,522964.229,5329370.35,81,52,29,16.445,0,2008,1,130,308,177,0.806010887088282,40.8,17.6131868131868,47,1237.65238375546,-1.4504710116036
19837,522964.229,5329370.35,184,71,113,26.043,0,2009,3,119,303,170,0.839331214271503,41,18.5230769230769,51,1237.65238375546,-1.4504710116036
19837,522964.229,5329370.35,171,74,97,24.072,0,2010,2,125,305,185,0.814636684507989,122,18.3626373626374,60,1237.65238375546,-1.4504710116036
19837,522964.229,5329370.35,93,66,27,32.287,1,2011,2,102,318,169,0.803737598000772,127.1,17.5,67,1237.65238375546,-1.4504710116036
19837,522964.229,5329370.35,156,80,76,27.277,0,2012,2,125,293,169,0.82856280205678,82.8,18.7043956043956,44,1237.65238375546,-1.4504710116036
19837,522964.229,5329370.35,182,47,135,42.434,0,2013,2,114,292,176,0.819607790599038,-163.1,19.2582417582418,62,1237.65238375546,-1.4504710116036
19837,522964.229,5329370.35,158,40,118,37.981,3,2014,2,103,316,169,0.811303272948211,176.9,17.856043956044,66,1237.65238375546,-1.4504710116036
19837,522964.229,5329370.35,163,93,70,36.458,0,2015,1,113,313,170,0.790358377222668,-158.6,20.9142857142857,57,1237.65238375546,-1.4504710116036
19837,522964.229,5329370.35,174,140,34,29.319,0,2016,1,125,329,168,0.823400144896206,45.5,18.8857142857143,43,1237.65238375546,-1.4504710116036
19837,522964.229,5329370.35,138,94,44,30.32,2,2017,1,117,309,170,0.811884662829993,-10.8,19.7879120879121,53,1237.65238375546,-1.4504710116036
19837,522964.229,5329370.35,166,93,73,46.757,0,2018,1,100,305,161,0.764158502611811,-154,20.578021978022,61,1237.65238375546,-1.4504710116036
19837,522964.229,5329370.35,172,78,94,24.54,2,2019,2,126,318,169,0.819585032037868,-79.8,20.6626373626374,43,1237.65238375546,-1.4504710116036
19837,522964.229,5329370.35,93,93,0,19.703,1,2020,1,123,286,178,0.773175780452876,-19.2,19.0648351648352,55,1237.65238375546,-1.4504710116036
19838,522964.229,5329138.694,86,85,1,56.555,9,2001,2,98,297,170,0.808063213035845,103.5,18.1120879120879,72,1241.67055541866,-1.09128875628604
19838,522964.229,5329138.694,86,64,22,26.098,0,2002,1,124,293,185,0.815669608954253,46.4,18.2428571428571,61,1241.67055541866,-1.09128875628604
19838,522964.229,5329138.694,168,52,116,28.402,0,2003,2,120,323,176,0.777869099868966,-203.8,22.9692307692308,56,1241.67055541866,-1.09128875628604
19838,522964.229,5329138.694,173,94,79,29.278,0,2004,2,121,330,186,0.804987748830686,196.1,17.7461538461538,65,1241.67055541866,-1.09128875628604
19838,522964.229,5329138.694,158,112,46,40.722,0,2005,1,114,302,169,0.803192182678951,38.9,17.9032967032967,55,1241.67055541866,-1.09128875628604
19838,522964.229,5329138.694,188,55,133,38.802,1,2006,2,116,325,170,0.787025108941213,82.6,18.867032967033,54,1241.67055541866,-1.09128875628604
19838,522964.229,5329138.694,86,77,9,46.331,0,2007,1,96,297,176,0.803077921088317,317.9,17.0824175824176,80,1241.67055541866,-1.09128875628604
19838,522964.229,5329138.694,81,52,29,12.125,0,2008,1,136,306,194,0.78964918171127,40.8,17.6131868131868,58,1241.67055541866,-1.09128875628604
19838,522964.229,5329138.694,184,69,115,26.043,0,2009,3,119,305,160,0.774015288961622,41,18.5230769230769,41,1241.67055541866,-1.09128875628604
19838,522964.229,5329138.694,170,74,96,25.687,0,2010,3,123,304,185,0.822439156116705,122,18.3626373626374,62,1241.67055541866,-1.09128875628604
19838,522964.229,5329138.694,93,64,29,35.725,1,2011,2,98,320,176,0.788475824797146,127.1,17.5,78,1241.67055541866,-1.09128875628604
19838,522964.229,5329138.694,150,80,70,30.335,0,2012,2,122,292,169,0.842633851946646,82.8,18.7043956043956,47,1241.67055541866,-1.09128875628604
19838,522964.229,5329138.694,184,47,137,32.431,0,2013,2,123,293,177,0.84002789780256,-163.1,19.2582417582418,54,1241.67055541866,-1.09128875628604
19838,522964.229,5329138.694,162,44,118,38.673,3,2014,2,102,316,176,0.825631165294261,176.9,17.856043956044,74,1241.67055541866,-1.09128875628604
19838,522964.229,5329138.694,169,141,28,34.844,0,2015,1,115,321,168,0.80732231742509,-158.6,20.9142857142857,53,1241.67055541866,-1.09128875628604
19838,522964.229,5329138.694,169,110,59,40.162,6,2016,1,115,327,169,0.851841171130353,45.5,18.8857142857143,54,1241.67055541866,-1.09128875628604
19838,522964.229,5329138.694,138,99,39,33.279,3,2017,1,113,309,170,0.803540036615685,-10.8,19.7879120879121,57,1241.67055541866,-1.09128875628604
19838,522964.229,5329138.694,165,93,72,46.757,0,2018,1,100,310,170,0.798836719374261,-154,20.578021978022,70,1241.67055541866,-1.09128875628604
19838,522964.229,5329138.694,170,80,90,30.808,4,2019,2,119,328,169,0.821211448147327,-79.8,20.6626373626374,50,1241.67055541866,-1.09128875628604
19838,522964.229,5329138.694,0,0,0,23.643,0,2020,0,116,305,185,0.756940897348369,-19.2,19.0648351648352,69,1241.67055541866,-1.09128875628604
20004,523195.885,5341416.481,0,0,0,51.891,0,2001,2,102,290,186,0.84879382590527,116.8,17.4,84,1224.1671555045,0.703303616433439
20004,523195.885,5341416.481,161,72,89,26.209,0,2002,3,124,325,208,0.838570998677377,52.7,17.567032967033,84,1224.1671555045,0.703303616433439
20004,523195.885,5341416.481,163,99,64,35.425,0,2003,1,112,319,162,0.830177469966728,-198,22.3252747252747,50,1224.1671555045,0.703303616433439
20004,523195.885,5341416.481,170,100,70,23.018,0,2004,2,128,309,218,0.835075153537062,209.7,17.0835164835165,90,1224.1671555045,0.703303616433439
20004,523195.885,5341416.481,153,95,58,32.157,0,2005,2,122,306,184,0.878700165001054,44.2,17.3054945054945,62,1224.1671555045,0.703303616433439
20004,523195.885,5341416.481,183,64,119,44.551,2,2006,3,110,331,200,0.859047844734229,92.3,18.2626373626374,90,1224.1671555045,0.703303616433439
20004,523195.885,5341416.481,0,0,0,38.738,0,2007,0,105,287,209,0.828279244379988,332.6,16.5076923076923,104,1224.1671555045,0.703303616433439
20004,523195.885,5341416.481,86,57,29,15.641,0,2008,1,131,295,201,0.855993607445903,50.1,16.9747252747253,70,1224.1671555045,0.703303616433439
20004,523195.885,5341416.481,177,59,118,43.877,0,2009,2,101,290,169,0.854778282687773,55,17.8153846153846,68,1224.1671555045,0.703303616433439
20004,523195.885,5341416.481,179,64,115,21.716,0,2010,2,127,300,185,0.867273462479229,133.1,17.7351648351648,58,1224.1671555045,0.703303616433439
20004,523195.885,5341416.481,135,70,65,30.511,1,2011,2,103,316,168,0.848301712454453,136.1,17.0351648351648,65,1224.1671555045,0.703303616433439
20004,523195.885,5341416.481,167,93,74,48.817,1,2012,1,103,298,177,0.875865408541419,88.9,18.4296703296703,74,1224.1671555045,0.703303616433439
20004,523195.885,5341416.481,187,58,129,19.732,1,2013,3,135,292,194,0.855556408085774,-156.9,18.6175824175824,59,1224.1671555045,0.703303616433439
20004,523195.885,5341416.481,157,42,115,41.649,3,2014,3,98,317,217,0.865668030786233,191.6,17.4516483516484,119,1224.1671555045,0.703303616433439
20004,523195.885,5341416.481,163,93,70,38.112,0,2015,1,111,326,176,0.870649897329905,-154.6,20.4153846153846,65,1224.1671555045,0.703303616433439
20004,523195.885,5341416.481,176,93,83,15.425,0,2016,2,139,327,186,0.862559243354189,50.9,18.5681318681319,47,1224.1671555045,0.703303616433439
20004,523195.885,5341416.481,151,93,58,29.025,0,2017,1,119,305,178,0.855409220294246,-2.3,19.1582417582418,59,1224.1671555045,0.703303616433439
20004,523195.885,5341416.481,181,93,88,29.987,0,2018,1,116,322,169,0.868353816375719,-151.3,19.9417582417582,53,1224.1671555045,0.703303616433439
20004,523195.885,5341416.481,172,97,75,20.006,0,2019,1,131,303,176,0.849252063475441,-73.4,20.0571428571429,45,1224.1671555045,0.703303616433439
20004,523195.885,5341416.481,86,85,1,23.757,1,2020,1,116,281,177,0.815526313198438,-13.6,18.3758241758242,61,1224.1671555045,0.703303616433439
20005,523195.885,5341184.824,0,0,0,72.977,0,2001,3,84,293,177,0.840532337934262,116.8,17.4,93,1233.16338207539,-0.0978163833594901
20005,523195.885,5341184.824,156,70,86,34.788,0,2002,3,114,328,192,0.829504988815485,52.7,17.567032967033,78,1233.16338207539,-0.0978163833594901
20005,523195.885,5341184.824,168,126,42,34.588,0,2003,1,113,323,161,0.821895902357817,-198,22.3252747252747,48,1233.16338207539,-0.0978163833594901
20005,523195.885,5341184.824,168,109,59,29.894,0,2004,2,120,331,209,0.821538084310396,209.7,17.0835164835165,89,1233.16338207539,-0.0978163833594901
20005,523195.885,5341184.824,152,95,57,38.543,0,2005,2,116,302,209,0.812484633359585,44.2,17.3054945054945,93,1233.16338207539,-0.0978163833594901
20005,523195.885,5341184.824,182,63,119,51.316,2,2006,3,105,333,185,0.840747168560295,92.3,18.2626373626374,80,1233.16338207539,-0.0978163833594901
20005,523195.885,5341184.824,0,0,0,48.656,0,2007,0,94,293,200,0.801142427544199,332.6,16.5076923076923,106,1233.16338207539,-0.0978163833594901
20005,523195.885,5341184.824,86,59,27,21.639,0,2008,1,124,293,202,0.836455389626536,50.1,16.9747252747253,78,1233.16338207539,-0.0978163833594901
20005,523195.885,5341184.824,186,60,126,27.362,0,2009,2,118,290,170,0.881315346187807,55,17.8153846153846,52,1233.16338207539,-0.0978163833594901
20005,523195.885,5341184.824,178,64,114,23.195,0,2010,2,125,301,184,0.860201054052208,133.1,17.7351648351648,59,1233.16338207539,-0.0978163833594901
20005,523195.885,5341184.824,125,69,56,35.44,1,2011,2,97,317,170,0.829771925483493,136.1,17.0351648351648,73,1233.16338207539,-0.0978163833594901
20005,523195.885,5341184.824,180,126,54,30.389,0,2012,1,122,297,177,0.856389475631006,88.9,18.4296703296703,55,1233.16338207539,-0.0978163833594901
20005,523195.885,5341184.824,190,62,128,18.745,1,2013,2,136,301,201,0.802904034003082,-156.9,18.6175824175824,65,1233.16338207539,-0.0978163833594901
20005,523195.885,5341184.824,155,45,110,48.517,3,2014,3,89,319,185,0.81785295012148,191.6,17.4516483516484,96,1233.16338207539,-0.0978163833594901
20005,523195.885,5341184.824,165,100,65,38.991,0,2015,1,110,326,168,0.850352445078136,-154.6,20.4153846153846,58,1233.16338207539,-0.0978163833594901
20005,523195.885,5341184.824,175,99,76,20.433,0,2016,2,134,333,192,0.856297310289259,50.9,18.5681318681319,58,1233.16338207539,-0.0978163833594901
20005,523195.885,5341184.824,153,93,60,29.833,1,2017,1,118,303,176,0.819583955587711,-2.3,19.1582417582418,58,1233.16338207539,-0.0978163833594901
20005,523195.885,5341184.824,173,93,80,44.029,0,2018,1,101,310,161,0.869272717184588,-151.3,19.9417582417582,60,1233.16338207539,-0.0978163833594901
20005,523195.885,5341184.824,164,118,46,25.763,3,2019,1,125,300,176,0.797285948269902,-73.4,20.0571428571429,51,1233.16338207539,-0.0978163833594901
20005,523195.885,5341184.824,86,82,4,24.854,1,2020,1,114,295,192,0.792030528886713,-13.6,18.3758241758242,78,1233.16338207539,-0.0978163833594901
20006,523195.885,5340953.168,0,0,0,126.128,0,2001,3,39,299,177,0.823036126614783,116.8,17.4,138,1183.09179424935,1.39284297109278
20006,523195.885,5340953.168,114,50,64,42.454,1,2002,3,105,321,225,0.83428839338161,52.7,17.567032967033,120,1183.09179424935,1.39284297109278
20006,523195.885,5340953.168,165,98,67,34.588,0,2003,1,113,333,161,0.816363735334864,-198,22.3252747252747,48,1183.09179424935,1.39284297109278
20006,523195.885,5340953.168,152,96,56,38.062,0,2004,1,111,333,184,0.832691918359519,209.7,17.0835164835165,73,1183.09179424935,1.39284297109278
20006,523195.885,5340953.168,0,0,0,56.127,0,2005,0,100,311,161,0.813460541078463,44.2,17.3054945054945,61,1183.09179424935,1.39284297109278
20006,523195.885,5340953.168,195,63,132,28.664,1,2006,3,125,343,178,0.843064963807793,92.3,18.2626373626374,53,1183.09179424935,1.39284297109278
20006,523195.885,5340953.168,113,93,20,43.851,0,2007,1,99,306,176,0.826240256234191,332.6,16.5076923076923,77,1183.09179424935,1.39284297109278
20006,523195.885,5340953.168,86,60,26,41.549,3,2008,1,106,308,192,0.83289895573449,50.1,16.9747252747253,86,1183.09179424935,1.39284297109278
20006,523195.885,5340953.168,170,93,77,51.68,0,2009,1,95,306,176,0.881384909978762,55,17.8153846153846,81,1183.09179424935,1.39284297109278
20006,523195.885,5340953.168,137,82,55,26.78,0,2010,3,120,306,185,0.852768418428302,133.1,17.7351648351648,65,1183.09179424935,1.39284297109278
20006,523195.885,5340953.168,94,71,23,43.467,1,2011,2,88,319,170,0.826981150223792,136.1,17.0351648351648,82,1183.09179424935,1.39284297109278
20006,523195.885,5340953.168,153,82,71,47.142,1,2012,2,105,315,177,0.853036246954345,88.9,18.4296703296703,72,1183.09179424935,1.39284297109278
20006,523195.885,5340953.168,176,85,91,20.729,1,2013,3,134,298,192,0.855113075389161,-156.9,18.6175824175824,58,1183.09179424935,1.39284297109278
20006,523195.885,5340953.168,0,0,0,45.36,0,2014,0,93,322,169,0.813912632839372,191.6,17.4516483516484,76,1183.09179424935,1.39284297109278
20006,523195.885,5340953.168,158,114,44,48.377,0,2015,1,100,330,168,0.849412275537029,-154.6,20.4153846153846,68,1183.09179424935,1.39284297109278
20006,523195.885,5340953.168,173,93,80,39.241,6,2016,2,116,338,186,0.854878442349339,50.9,18.5681318681319,70,1183.09179424935,1.39284297109278
20006,523195.885,5340953.168,0,0,0,34.306,0,2017,0,112,318,176,0.8225185425118,-2.3,19.1582417582418,64,1183.09179424935,1.39284297109278
20006,523195.885,5340953.168,126,103,23,52.976,0,2018,1,93,311,177,0.834627504346006,-151.3,19.9417582417582,84,1183.09179424935,1.39284297109278
20006,523195.885,5340953.168,142,102,40,37.086,4,2019,1,112,326,169,0.812341726136977,-73.4,20.0571428571429,57,1183.09179424935,1.39284297109278
20006,523195.885,5340953.168,0,0,0,36.352,0,2020,0,97,320,185,0.821511297852175,-13.6,18.3758241758242,88,1183.09179424935,1.39284297109278
20007,523195.885,5340721.512,0,0,0,72.977,0,2001,2,84,300,248,0.849581277942315,116.8,17.4,164,1121.52500572144,0.492679103186079
20007,523195.885,5340721.512,112,51,61,43.302,2,2002,3,104,316,225,0.842871691296883,52.7,17.567032967033,121,1121.52500572144,0.492679103186079
20007,523195.885,5340721.512,163,93,70,37.087,0,2003,1,110,328,160,0.808367078435932,-198,22.3252747252747,50,1121.52500572144,0.492679103186079
20007,523195.885,5340721.512,152,96,56,37.105,0,2004,2,112,334,192,0.830394427777828,209.7,17.0835164835165,80,1121.52500572144,0.492679103186079
20007,523195.885,5340721.512,0,0,0,67.655,0,2005,0,90,309,170,0.838107832544571,44.2,17.3054945054945,80,1121.52500572144,0.492679103186079
20007,523195.885,5340721.512,190,62,128,36.569,2,2006,3,117,343,185,0.83998482886982,92.3,18.2626373626374,68,1121.52500572144,0.492679103186079
20007,523195.885,5340721.512,95,93,2,43.851,0,2007,2,99,306,193,0.827554258530979,332.6,16.5076923076923,94,1121.52500572144,0.492679103186079
20007,523195.885,5340721.512,86,60,26,36.924,0,2008,1,110,312,216,0.860529998809957,50.1,16.9747252747253,106,1121.52500572144,0.492679103186079
20007,523195.885,5340721.512,170,93,77,53.082,0,2009,1,94,315,178,0.900074115157333,55,17.8153846153846,84,1121.52500572144,0.492679103186079
20007,523195.885,5340721.512,125,83,42,30.576,0,2010,3,115,308,193,0.849878810218193,133.1,17.7351648351648,78,1121.52500572144,0.492679103186079
20007,523195.885,5340721.512,86,72,14,43.467,1,2011,1,88,320,200,0.828603667966487,136.1,17.0351648351648,112,1121.52500572144,0.492679103186079
20007,523195.885,5340721.512,153,82,71,47.977,1,2012,2,104,318,177,0.857194314885391,88.9,18.4296703296703,73,1121.52500572144,0.492679103186079
20007,523195.885,5340721.512,178,85,93,14.64,1,2013,3,140,312,193,0.859317344800429,-156.9,18.6175824175824,53,1121.52500572144,0.492679103186079
20007,523195.885,5340721.512,0,0,0,46.128,0,2014,0,92,320,185,0.833930564365968,191.6,17.4516483516484,93,1121.52500572144,0.492679103186079
20007,523195.885,5340721.512,155,93,62,47.355,0,2015,1,101,337,169,0.850567886503363,-154.6,20.4153846153846,68,1121.52500572144,0.492679103186079
20007,523195.885,5340721.512,174,93,81,40.298,7,2016,2,115,339,208,0.857910636878117,50.9,18.5681318681319,93,1121.52500572144,0.492679103186079
20007,523195.885,5340721.512,0,0,0,41.733,0,2017,0,102,316,176,0.842269908055553,-2.3,19.1582417582418,74,1121.52500572144,0.492679103186079
20007,523195.885,5340721.512,150,96,54,46.134,0,2018,1,99,309,178,0.838964486391005,-151.3,19.9417582417582,79,1121.52500572144,0.492679103186079
20007,523195.885,5340721.512,139,94,45,40.576,4,2019,1,108,327,177,0.827843922539565,-73.4,20.0571428571429,69,1121.52500572144,0.492679103186079
20007,523195.885,5340721.512,94,94,0,38.003,3,2020,2,95,317,186,0.825698497724275,-13.6,18.3758241758242,91,1121.52500572144,0.492679103186079
20008,523195.885,5340489.855,0,0,0,139.86,0,2001,2,27,316,177,0.851567096853243,116.8,17.4,150,1097.17887060302,0.442919756570687
20008,523195.885,5340489.855,86,84,2,36.461,0,2002,1,112,340,217,0.850701823908556,52.7,17.567032967033,105,1097.17887060302,0.442919756570687
20008,523195.885,5340489.855,152,93,59,37.912,1,2003,1,109,331,154,0.828155007276936,-198,22.3252747252747,45,1097.17887060302,0.442919756570687
20008,523195.885,5340489.855,147,83,64,46.002,0,2004,2,103,312,169,0.83282568253061,209.7,17.0835164835165,66,1097.17887060302,0.442919756570687
20008,523195.885,5340489.855,0,0,0,58.59,0,2005,0,98,316,162,0.845689306208799,44.2,17.3054945054945,64,1097.17887060302,0.442919756570687
20008,523195.885,5340489.855,195,93,102,32.448,1,2006,1,121,343,177,0.845968917959613,92.3,18.2626373626374,56,1097.17887060302,0.442919756570687
20008,523195.885,5340489.855,0,0,0,48.656,0,2007,0,94,309,225,0.852053136180254,332.6,16.5076923076923,131,1097.17887060302,0.442919756570687
20008,523195.885,5340489.855,0,0,0,48.668,0,2008,0,100,313,233,0.861926778883154,50.1,16.9747252747253,133,1097.17887060302,0.442919756570687
20008,523195.885,5340489.855,169,63,106,46.255,0,2009,3,99,311,184,0.898685882483664,55,17.8153846153846,85,1097.17887060302,0.442919756570687
20008,523195.885,5340489.855,161,70,91,32.234,0,2010,3,113,307,217,0.854289572960145,133.1,17.7351648351648,104,1097.17887060302,0.442919756570687
20008,523195.885,5340489.855,82,67,15,42.586,1,2011,1,89,324,153,0.848791591621978,136.1,17.0351648351648,64,1097.17887060302,0.442919756570687
20008,523195.885,5340489.855,147,93,54,42.757,0,2012,1,110,318,169,0.904476505881417,88.9,18.4296703296703,59,1097.17887060302,0.442919756570687
20008,523195.885,5340489.855,185,94,91,10.218,1,2013,2,144,304,201,0.86085394958567,-156.9,18.6175824175824,57,1097.17887060302,0.442919756570687
20008,523195.885,5340489.855,86,75,11,47.707,3,2014,1,90,339,210,0.852070889258427,191.6,17.4516483516484,120,1097.17887060302,0.442919756570687
20008,523195.885,5340489.855,146,93,53,55.266,4,2015,1,94,343,161,0.853270468481132,-154.6,20.4153846153846,67,1097.17887060302,0.442919756570687
20008,523195.885,5340489.855,157,93,64,51.435,7,2016,1,105,337,178,0.878060416402649,50.9,18.5681318681319,73,1097.17887060302,0.442919756570687
20008,523195.885,5340489.855,124,93,31,47.287,7,2017,1,95,315,170,0.855754156154058,-2.3,19.1582417582418,75,1097.17887060302,0.442919756570687
20008,523195.885,5340489.855,155,81,74,39.924,0,2018,2,105,339,161,0.864758082434034,-151.3,19.9417582417582,56,1097.17887060302,0.442919756570687
20008,523195.885,5340489.855,153,93,60,38.788,4,2019,1,110,325,161,0.839139528331129,-73.4,20.0571428571429,51,1097.17887060302,0.442919756570687
20008,523195.885,5340489.855,138,104,34,45.016,10,2020,1,87,322,176,0.821457843043172,-13.6,18.3758241758242,89,1097.17887060302,0.442919756570687
20047,523195.885,5331455.257,86,86,0,40.363,2,2001,2,112,289,193,0.878620727725029,103.5,18.1120879120879,81,1272.03976676675,-1.16194049570631
20047,523195.885,5331455.257,86,52,34,23.03,0,2002,1,127,285,240,0.865949821212981,46.4,18.2428571428571,113,1272.03976676675,-1.16194049570631
20047,523195.885,5331455.257,161,62,99,31.737,0,2003,2,116,324,162,0.846716280181585,-203.8,22.9692307692308,46,1272.03976676675,-1.16194049570631
20047,523195.885,5331455.257,178,93,85,18.935,0,2004,2,132,287,217,0.866481864177701,196.1,17.7461538461538,85,1272.03976676675,-1.16194049570631
20047,523195.885,5331455.257,165,95,70,31.108,0,2005,2,123,306,185,0.903926781297581,38.9,17.9032967032967,62,1272.03976676675,-1.16194049570631
20047,523195.885,5331455.257,191,93,98,25.082,0,2006,2,129,332,193,0.859845266409464,82.6,18.867032967033,64,1272.03976676675,-1.16194049570631
20047,523195.885,5331455.257,0,0,0,40.881,0,2007,0,102,289,217,0.84987486397003,317.9,17.0824175824176,115,1272.03976676675,-1.16194049570631
20047,523195.885,5331455.257,136,59,77,13.486,0,2008,2,134,289,178,0.864744501524445,40.8,17.6131868131868,44,1272.03976676675,-1.16194049570631
20047,523195.885,5331455.257,179,93,86,39.629,0,2009,1,105,295,170,0.894560377322035,41,18.5230769230769,65,1272.03976676675,-1.16194049570631
20047,523195.885,5331455.257,174,66,108,22.432,0,2010,3,127,288,194,0.868071175204856,122,18.3626373626374,67,1272.03976676675,-1.16194049570631
20047,523195.885,5331455.257,140,65,75,28.237,0,2011,3,107,307,208,0.855056105021515,127.1,17.5,101,1272.03976676675,-1.16194049570631
20047,523195.885,5331455.257,169,93,76,15.497,0,2012,2,137,302,248,0.968449615945151,82.8,18.7043956043956,111,1272.03976676675,-1.16194049570631
20047,523195.885,5331455.257,182,63,119,21.732,0,2013,3,133,296,185,0.901255304659298,-163.1,19.2582417582418,52,1272.03976676675,-1.16194049570631
20047,523195.885,5331455.257,159,46,113,30.288,0,2014,3,115,315,185,0.856102629613321,176.9,17.856043956044,70,1272.03976676675,-1.16194049570631
20047,523195.885,5331455.257,162,94,68,32.407,0,2015,1,118,296,177,0.901408108479678,-158.6,20.9142857142857,59,1272.03976676675,-1.16194049570631
20047,523195.885,5331455.257,180,99,81,26.131,0,2016,1,128,327,184,0.911914526331524,45.5,18.8857142857143,56,1272.03976676675,-1.16194049570631
20047,523195.885,5331455.257,144,98,46,24.767,0,2017,1,124,305,185,0.887837660582017,-10.8,19.7879120879121,61,1272.03976676675,-1.16194049570631
20047,523195.885,5331455.257,175,93,82,31.36,0,2018,2,115,317,186,0.886172117796158,-154,20.578021978022,71,1272.03976676675,-1.16194049570631
20047,523195.885,5331455.257,172,93,79,23.635,1,2019,2,127,302,185,0.878024537842814,-79.8,20.6626373626374,58,1272.03976676675,-1.16194049570631
20047,523195.885,5331455.257,0,0,0,22.584,0,2020,0,118,310,240,0.839166371725692,-19.2,19.0648351648352,122,1272.03976676675,-1.16194049570631
20049,523195.885,5330991.945,86,83,3,24.188,0,2001,2,127,294,178,0.867567484462456,103.5,18.1120879120879,51,1229.13127844119,1.38413961885425
20049,523195.885,5330991.945,93,54,39,34.043,0,2002,3,115,290,184,0.84859015477768,46.4,18.2428571428571,69,1229.13127844119,1.38413961885425
20049,523195.885,5330991.945,173,52,121,30.069,0,2003,2,118,321,168,0.838957438921644,-203.8,22.9692307692308,50,1229.13127844119,1.38413961885425
20049,523195.885,5330991.945,178,94,84,23.99,0,2004,2,127,295,186,0.855286121189555,196.1,17.7461538461538,59,1229.13127844119,1.38413961885425
20049,523195.885,5330991.945,166,94,72,40.722,0,2005,1,114,308,176,0.874641787662892,38.9,17.9032967032967,62,1229.13127844119,1.38413961885425
20049,523195.885,5330991.945,200,65,135,19.984,0,2006,2,134,333,177,0.853319513913023,82.6,18.867032967033,43,1229.13127844119,1.38413961885425
20049,523195.885,5330991.945,93,93,0,40.881,0,2007,1,102,301,162,0.873463556278665,317.9,17.0824175824176,60,1229.13127844119,1.38413961885425
20049,523195.885,5330991.945,107,52,55,20.737,0,2008,2,125,301,177,0.87291025869885,40.8,17.6131868131868,52,1229.13127844119,1.38413961885425
20049,523195.885,5330991.945,174,59,115,39.629,0,2009,2,105,307,168,0.87725718574599,41,18.5230769230769,63,1229.13127844119,1.38413961885425
20049,523195.885,5330991.945,166,75,91,27.331,0,2010,2,121,303,177,0.864482300350658,122,18.3626373626374,56,1229.13127844119,1.38413961885425
20049,523195.885,5330991.945,141,93,48,31.455,1,2011,2,103,318,249,0.813721595410283,127.1,17.5,146,1229.13127844119,1.38413961885425
20049,523195.885,5330991.945,156,104,52,25.279,0,2012,1,127,310,184,0.888045495186707,82.8,18.7043956043956,57,1229.13127844119,1.38413961885425
20049,523195.885,5330991.945,176,64,112,28.996,0,2013,3,126,298,218,0.813361387140993,-163.1,19.2582417582418,92,1229.13127844119,1.38413961885425
20049,523195.885,5330991.945,155,64,91,31.519,0,2014,2,113,318,178,0.849513116903862,176.9,17.856043956044,65,1229.13127844119,1.38413961885425
20049,523195.885,5330991.945,162,104,58,36.458,0,2015,1,113,330,169,0.872801830350823,-158.6,20.9142857142857,56,1229.13127844119,1.38413961885425
20049,523195.885,5330991.945,170,103,67,35.915,2,2016,1,119,327,177,0.905644728473835,45.5,18.8857142857143,58,1229.13127844119,1.38413961885425
20049,523195.885,5330991.945,145,94,51,28.745,0,2017,2,119,290,224,0.872544366962312,-10.8,19.7879120879121,105,1229.13127844119,1.38413961885425
20049,523195.885,5330991.945,174,47,127,29.593,0,2018,3,117,315,186,0.848561895279482,-154,20.578021978022,69,1229.13127844119,1.38413961885425
20049,523195.885,5330991.945,166,94,72,29.899,4,2019,1,120,322,169,0.830941596874661,-79.8,20.6626373626374,49,1229.13127844119,1.38413961885425
20049,523195.885,5330991.945,94,94,0,25.318,1,2020,2,113,309,201,0.79035582648452,-19.2,19.0648351648352,88,1229.13127844119,1.38413961885425
20050,523195.885,5330760.288,86,83,3,23.163,0,2001,2,128,300,176,0.820474795278039,103.5,18.1120879120879,48,1218.75874678314,1.34454754948527
20050,523195.885,5330760.288,93,52,41,38.443,0,2002,3,110,298,242,0.847729244787532,46.4,18.2428571428571,132,1218.75874678314,1.34454754948527
20050,523195.885,5330760.288,162,56,106,34.263,0,2003,2,113,324,161,0.819301017682826,-203.8,22.9692307692308,48,1218.75874678314,1.34454754948527
20050,523195.885,5330760.288,178,105,73,31.063,0,2004,1,119,328,178,0.852630514709798,196.1,17.7461538461538,59,1218.75874678314,1.34454754948527
20050,523195.885,5330760.288,157,93,64,50.776,0,2005,1,105,311,169,0.865207164427158,38.9,17.9032967032967,64,1218.75874678314,1.34454754948527
20050,523195.885,5330760.288,194,65,129,33.054,0,2006,2,121,337,177,0.852128428511216,82.6,18.867032967033,56,1218.75874678314,1.34454754948527
20050,523195.885,5330760.288,0,0,0,45.373,0,2007,0,97,302,170,0.891280121706033,317.9,17.0824175824176,73,1218.75874678314,1.34454754948527
20050,523195.885,5330760.288,84,59,25,33.632,0,2008,1,113,304,168,0.838605185140289,40.8,17.6131868131868,55,1218.75874678314,1.34454754948527
20050,523195.885,5330760.288,186,64,122,26.89,0,2009,3,118,299,177,0.927975370239534,41,18.5230769230769,59,1218.75874678314,1.34454754948527
20050,523195.885,5330760.288,168,71,97,29.831,0,2010,2,118,309,176,0.860641422635226,122,18.3626373626374,58,1218.75874678314,1.34454754948527
20050,523195.885,5330760.288,144,96,48,37.588,1,2011,2,96,321,249,0.82365874965963,127.1,17.5,153,1218.75874678314,1.34454754948527
20050,523195.885,5330760.288,153,81,72,30.335,0,2012,2,122,311,176,0.860668511303978,82.8,18.7043956043956,54,1218.75874678314,1.34454754948527
20050,523195.885,5330760.288,178,99,79,34.654,0,2013,1,121,292,177,0.877205433448985,-163.1,19.2582417582418,56,1218.75874678314,1.34454754948527
20050,523195.885,5330760.288,156,41,115,39.378,3,2014,2,101,336,161,0.828743620329839,176.9,17.856043956044,60,1218.75874678314,1.34454754948527
20050,523195.885,5330760.288,162,93,69,41.8,0,2015,1,107,331,161,0.864237789758858,-158.6,20.9142857142857,54,1218.75874678314,1.34454754948527
20050,523195.885,5330760.288,173,141,32,43.353,6,2016,1,112,331,168,0.892566781483978,45.5,18.8857142857143,56,1218.75874678314,1.34454754948527
20050,523195.885,5330760.288,146,107,39,37.111,7,2017,2,108,294,232,0.857132357469897,-10.8,19.7879120879121,124,1218.75874678314,1.34454754948527
20050,523195.885,5330760.288,172,56,116,38.886,0,2018,3,107,310,264,0.778182715111918,-154,20.578021978022,157,1218.75874678314,1.34454754948527
20050,523195.885,5330760.288,169,95,74,34.292,4,2019,1,115,330,169,0.845686494163963,-79.8,20.6626373626374,54,1218.75874678314,1.34454754948527
20050,523195.885,5330760.288,0,0,0,27.122,0,2020,0,110,310,177,0.809925416352162,-19.2,19.0648351648352,67,1218.75874678314,1.34454754948527
20051,523195.885,5330528.632,86,83,3,18.387,0,2001,2,133,300,170,0.828705388595348,103.5,18.1120879120879,37,1212.34273992579,-1.10591231827878
20051,523195.885,5330528.632,93,51,42,42.041,0,2002,2,106,299,176,0.857765237941002,46.4,18.2428571428571,70,1212.34273992579,-1.10591231827878
20051,523195.885,5330528.632,161,56,105,38.54,1,2003,2,108,325,154,0.820746391651533,-203.8,22.9692307692308,46,1212.34273992579,-1.10591231827878
20051,523195.885,5330528.632,170,100,70,45.215,0,2004,1,105,330,176,0.843002652001634,196.1,17.7461538461538,71,1212.34273992579,-1.10591231827878
20051,523195.885,5330528.632,156,95,61,55.388,0,2005,1,101,315,169,0.872885136030795,38.9,17.9032967032967,68,1212.34273992579,-1.10591231827878
20051,523195.885,5330528.632,190,66,124,50.111,1,2006,2,107,340,169,0.859295744313949,82.6,18.867032967033,62,1212.34273992579,-1.10591231827878
20051,523195.885,5330528.632,93,93,0,53.537,3,2007,1,89,305,153,0.831133690227739,317.9,17.0824175824176,64,1212.34273992579,-1.10591231827878
20051,523195.885,5330528.632,86,60,26,42.813,2,2008,1,105,311,169,0.856499026584077,40.8,17.6131868131868,64,1212.34273992579,-1.10591231827878
20051,523195.885,5330528.632,174,65,109,54.021,0,2009,2,93,300,168,0.896888053220003,41,18.5230769230769,75,1212.34273992579,-1.10591231827878
20051,523195.885,5330528.632,162,71,91,36.466,0,2010,2,111,311,176,0.867104234463445,122,18.3626373626374,65,1212.34273992579,-1.10591231827878
20051,523195.885,5330528.632,143,96,47,40.497,1,2011,2,93,323,248,0.827160303648492,127.1,17.5,155,1212.34273992579,-1.10591231827878
20051,523195.885,5330528.632,155,81,74,31.344,0,2012,2,121,313,170,0.859171029151125,82.8,18.7043956043956,49,1212.34273992579,-1.10591231827878
20051,523195.885,5330528.632,178,106,72,38.115,0,2013,1,118,294,176,0.866534857581104,-163.1,19.2582417582418,58,1212.34273992579,-1.10591231827878
20051,523195.885,5330528.632,153,41,112,46.172,3,2014,2,92,339,154,0.846257841831607,176.9,17.856043956044,62,1212.34273992579,-1.10591231827878
20051,523195.885,5330528.632,162,96,66,42.684,0,2015,1,106,337,161,0.863335586746368,-158.6,20.9142857142857,55,1212.34273992579,-1.10591231827878
20051,523195.885,5330528.632,170,128,42,52.424,6,2016,1,104,330,168,0.887258291600369,45.5,18.8857142857143,64,1212.34273992579,-1.10591231827878
20051,523195.885,5330528.632,146,108,38,41.583,7,2017,2,102,304,232,0.852601436482593,-10.8,19.7879120879121,130,1212.34273992579,-1.10591231827878
20051,523195.885,5330528.632,169,60,109,54.009,1,2018,2,94,306,145,0.798631608194861,-154,20.578021978022,51,1212.34273992579,-1.10591231827878
20051,523195.885,5330528.632,166,93,73,37.578,4,2019,1,111,332,161,0.833097163691433,-79.8,20.6626373626374,50,1212.34273992579,-1.10591231827878
20051,523195.885,5330528.632,0,0,0,28.381,0,2020,0,108,311,169,0.828943059347759,-19.2,19.0648351648352,61,1212.34273992579,-1.10591231827878
20052,523195.885,5330296.975,86,82,4,48.234,7,2001,3,105,296,170,0.848594519557496,103.5,18.1120879120879,65,1210.4964305161,0.144750462345265
20052,523195.885,5330296.975,135,60,75,42.942,1,2002,2,105,297,170,0.840510631972082,46.4,18.2428571428571,65,1210.4964305161,0.144750462345265
20052,523195.885,5330296.975,168,56,112,42.224,1,2003,2,104,305,153,0.820826579114931,-203.8,22.9692307692308,49,1210.4964305161,0.144750462345265
20052,523195.885,5330296.975,169,61,108,44.129,0,2004,2,106,331,176,0.829572242851758,196.1,17.7461538461538,70,1210.4964305161,0.144750462345265
20052,523195.885,5330296.975,156,99,57,59.166,2,2005,1,98,313,162,0.874778678978603,38.9,17.9032967032967,64,1210.4964305161,0.144750462345265
20052,523195.885,5330296.975,199,65,134,34.152,1,2006,2,120,327,170,0.854995193420192,82.6,18.867032967033,50,1210.4964305161,0.144750462345265
20052,523195.885,5330296.975,93,78,15,52.484,3,2007,2,90,312,160,0.845570002868578,317.9,17.0824175824176,70,1210.4964305161,0.144750462345265
20052,523195.885,5330296.975,86,59,27,33.632,0,2008,1,113,310,170,0.868201312765505,40.8,17.6131868131868,57,1210.4964305161,0.144750462345265
20052,523195.885,5330296.975,185,161,24,30.375,0,2009,1,114,299,160,0.894440935034349,41,18.5230769230769,46,1210.4964305161,0.144750462345265
20052,523195.885,5330296.975,167,74,93,28.975,0,2010,2,119,311,169,0.856104919436305,122,18.3626373626374,50,1210.4964305161,0.144750462345265
20052,523195.885,5330296.975,139,79,60,37.588,1,2011,3,96,323,250,0.839889095492994,127.1,17.5,154,1210.4964305161,0.144750462345265
20052,523195.885,5330296.975,156,81,75,46.235,1,2012,3,106,317,242,0.836732889858163,82.8,18.7043956043956,136,1210.4964305161,0.144750462345265
20052,523195.885,5330296.975,177,79,98,28.996,0,2013,2,126,301,177,0.857047277258297,-163.1,19.2582417582418,51,1210.4964305161,0.144750462345265
20052,523195.885,5330296.975,154,45,109,40.828,3,2014,3,99,338,240,0.841324283310354,176.9,17.856043956044,141,1210.4964305161,0.144750462345265
20052,523195.885,5330296.975,169,122,47,39.952,0,2015,1,109,332,161,0.86574567662349,-158.6,20.9142857142857,52,1210.4964305161,0.144750462345265
20052,523195.885,5330296.975,172,136,36,48.082,6,2016,1,108,328,169,0.871345800397403,45.5,18.8857142857143,61,1210.4964305161,0.144750462345265
20052,523195.885,5330296.975,155,94,61,43.923,7,2017,1,99,301,168,0.839168553072445,-10.8,19.7879120879121,69,1210.4964305161,0.144750462345265
20052,523195.885,5330296.975,169,57,112,49.14,0,2018,2,98,306,161,0.817254078264165,-154,20.578021978022,63,1210.4964305161,0.144750462345265
20052,523195.885,5330296.975,164,81,83,40.236,4,2019,2,108,333,161,0.833763622918423,-79.8,20.6626373626374,53,1210.4964305161,0.144750462345265
20052,523195.885,5330296.975,93,93,0,29.029,1,2020,1,107,312,170,0.8257399070454,-19.2,19.0648351648352,63,1210.4964305161,0.144750462345265
20053,523195.885,5330065.319,86,82,4,36.006,0,2001,3,116,292,177,0.847708750307219,103.5,18.1120879120879,61,1198.87736348932,0.432274714819675
20053,523195.885,5330065.319,135,59,76,34.899,0,2002,2,114,297,170,0.8382994556111,46.4,18.2428571428571,56,1198.87736348932,0.432274714819675
20053,523195.885,5330065.319,169,56,113,37.678,1,2003,2,109,301,160,0.80683069756189,-203.8,22.9692307692308,51,1198.87736348932,0.432274714819675
20053,523195.885,5330065.319,171,60,111,35.791,0,2004,2,114,333,177,0.82233786779292,196.1,17.7461538461538,63,1198.87736348932,0.432274714819675
20053,523195.885,5330065.319,157,98,59,50.776,0,2005,1,105,310,161,0.838695323642455,38.9,17.9032967032967,56,1198.87736348932,0.432274714819675
20053,523195.885,5330065.319,200,65,135,30.925,0,2006,2,123,325,170,0.828806939196356,82.6,18.867032967033,47,1198.87736348932,0.432274714819675
20053,523195.885,5330065.319,86,77,9,44.437,0,2007,1,98,311,154,0.800110658500988,317.9,17.0824175824176,56,1198.87736348932,0.432274714819675
20053,523195.885,5330065.319,86,58,28,24.635,0,2008,1,121,309,170,0.854960016181281,40.8,17.6131868131868,49,1198.87736348932,0.432274714819675
20053,523195.885,5330065.319,185,93,92,30.375,0,2009,2,114,298,154,0.850996607352047,41,18.5230769230769,40,1198.87736348932,0.432274714819675
20053,523195.885,5330065.319,164,74,90,27.331,0,2010,2,121,313,176,0.833899661251019,122,18.3626373626374,55,1198.87736348932,0.432274714819675
20053,523195.885,5330065.319,144,79,65,34.83,1,2011,5,99,323,250,0.818410660976461,127.1,17.5,151,1198.87736348932,0.432274714819675
20053,523195.885,5330065.319,156,81,75,44.47,1,2012,2,108,314,177,0.862246459187497,82.8,18.7043956043956,69,1198.87736348932,0.432274714819675
20053,523195.885,5330065.319,178,78,100,32.431,0,2013,2,123,292,177,0.86009476382749,-163.1,19.2582417582418,54,1198.87736348932,0.432274714819675
20053,523195.885,5330065.319,155,40,115,36.632,3,2014,3,105,335,226,0.834551221835805,176.9,17.856043956044,121,1198.87736348932,0.432274714819675
20053,523195.885,5330065.319,168,127,41,39.952,0,2015,1,109,322,161,0.847503134949965,-158.6,20.9142857142857,52,1198.87736348932,0.432274714819675
20053,523195.885,5330065.319,172,134,38,46.858,6,2016,1,109,327,177,0.861011772878686,45.5,18.8857142857143,68,1198.87736348932,0.432274714819675
20053,523195.885,5330065.319,157,93,64,40.098,7,2017,2,104,301,233,0.802980812726645,-10.8,19.7879120879121,129,1198.87736348932,0.432274714819675
20053,523195.885,5330065.319,170,57,113,49.14,0,2018,2,98,306,176,0.790706090011157,-154,20.578021978022,78,1198.87736348932,0.432274714819675
20053,523195.885,5330065.319,171,81,90,33.457,4,2019,2,116,331,162,0.811488787874666,-79.8,20.6626373626374,46,1198.87736348932,0.432274714819675
20053,523195.885,5330065.319,93,93,0,27.122,1,2020,1,110,311,177,0.787732389159275,-19.2,19.0648351648352,67,1198.87736348932,0.432274714819675
20057,523195.885,5329138.694,0,0,0,43.705,0,2001,2,109,298,177,0.804838662684718,103.5,18.1120879120879,68,1235.67698035814,-1.46949868441309
20057,523195.885,5329138.694,86,78,8,20.103,0,2002,1,130,292,193,0.817068956491982,46.4,18.2428571428571,63,1235.67698035814,-1.46949868441309
20057,523195.885,5329138.694,169,52,117,29.244,0,2003,2,119,298,178,0.778413838151239,-203.8,22.9692307692308,59,1235.67698035814,-1.46949868441309
20057,523195.885,5329138.694,177,119,58,20.038,0,2004,1,131,331,186,0.792608035130328,196.1,17.7461538461538,55,1235.67698035814,-1.46949868441309
20057,523195.885,5329138.694,165,140,25,35.156,0,2005,1,119,311,177,0.796511125961866,38.9,17.9032967032967,58,1235.67698035814,-1.46949868441309
20057,523195.885,5329138.694,198,62,136,19,0,2006,2,135,325,184,0.769864721398462,82.6,18.867032967033,49,1235.67698035814,-1.46949868441309
20057,523195.885,5329138.694,149,76,73,36.897,0,2007,2,107,299,162,0.782919122918771,317.9,17.0824175824176,55,1235.67698035814,-1.46949868441309
20057,523195.885,5329138.694,85,56,29,6.781,0,2008,1,161,309,202,0.751153777357124,40.8,17.6131868131868,41,1235.67698035814,-1.46949868441309
20057,523195.885,5329138.694,188,72,116,26.043,0,2009,2,119,296,162,0.81267449408481,41,18.5230769230769,43,1235.67698035814,-1.46949868441309
20057,523195.885,5329138.694,166,72,94,25.687,0,2010,2,123,306,186,0.804027613565022,122,18.3626373626374,63,1235.67698035814,-1.46949868441309
20057,523195.885,5329138.694,149,60,89,30.631,0,2011,3,104,316,170,0.792832288794144,127.1,17.5,66,1235.67698035814,-1.46949868441309
20057,523195.885,5329138.694,153,79,74,21.266,0,2012,3,131,311,185,0.876027463711431,82.8,18.7043956043956,54,1235.67698035814,-1.46949868441309
20057,523195.885,5329138.694,189,70,119,22.765,0,2013,2,132,286,178,0.821525395850482,-163.1,19.2582417582418,46,1235.67698035814,-1.46949868441309
20057,523195.885,5329138.694,160,48,112,35.319,1,2014,3,107,316,185,0.82277592931605,176.9,17.856043956044,78,1235.67698035814,-1.46949868441309
20057,523195.885,5329138.694,169,135,34,35.641,0,2015,1,114,294,169,0.782970994867049,-158.6,20.9142857142857,55,1235.67698035814,-1.46949868441309
20057,523195.885,5329138.694,172,111,61,38.05,4,2016,1,117,324,178,0.845341821824327,45.5,18.8857142857143,61,1235.67698035814,-1.46949868441309
20057,523195.885,5329138.694,143,94,49,30.32,2,2017,1,117,307,176,0.777239646124476,-10.8,19.7879120879121,59,1235.67698035814,-1.46949868441309
20057,523195.885,5329138.694,170,64,106,46.757,0,2018,2,100,312,177,0.779863572126401,-154,20.578021978022,77,1235.67698035814,-1.46949868441309
20057,523195.885,5329138.694,165,93,72,27.244,4,2019,1,123,329,170,0.783995896991786,-79.8,20.6626373626374,47,1235.67698035814,-1.46949868441309
20057,523195.885,5329138.694,93,93,0,22.584,1,2020,2,118,306,192,0.741632376402287,-19.2,19.0648351648352,74,1235.67698035814,-1.46949868441309
20103,523195.885,5318482.501,0,0,0,55.545,0,2001,1,98,326,176,0.867343324034573,-26.7,20.3989010989011,78,1072.68252626634,1.3324206708341
20103,523195.885,5318482.501,108,85,23,39.028,0,2002,2,109,328,177,0.84807481548503,-5.6,20.2901098901099,68,1072.68252626634,1.3324206708341
20103,523195.885,5318482.501,153,97,56,36.329,0,2003,1,106,299,152,0.831480512079946,-214.1,25.0835164835165,46,1072.68252626634,1.3324206708341
20103,523195.885,5318482.501,156,93,63,34.944,0,2004,1,113,328,170,0.841619265196736,90.8,19.910989010989,57,1072.68252626634,1.3324206708341
20103,523195.885,5318482.501,145,100,45,58.607,1,2005,1,95,309,160,0.84279561865576,-56.5,19.9923076923077,65,1072.68252626634,1.3324206708341
20103,523195.885,5318482.501,184,93,91,29.192,0,2006,2,122,336,177,0.857975345516356,16.2,20.9538461538462,55,1072.68252626634,1.3324206708341
20103,523195.885,5318482.501,0,0,0,44.305,0,2007,0,96,306,186,0.840565285720752,213,19.1032967032967,90,1072.68252626634,1.3324206708341
20103,523195.885,5318482.501,164,83,81,38.737,0,2008,2,109,305,178,0.842505897194403,-1.79999999999999,19.6,69,1072.68252626634,1.3324206708341
20103,523195.885,5318482.501,171,62,109,49.75,0,2009,2,91,310,170,0.870448380790653,-2.8,20.5450549450549,79,1072.68252626634,1.3324206708341
20103,523195.885,5318482.501,168,97,71,25.439,0,2010,1,121,307,177,0.811802924052281,50.5,20.2241758241758,56,1072.68252626634,1.3324206708341
20103,523195.885,5318482.501,0,0,0,36.229,0,2011,0,94,326,248,0.786913531139808,90.7,19.4164835164835,154,1072.68252626634,1.3324206708341
20103,523195.885,5318482.501,86,86,0,45.911,1,2012,1,106,306,169,0.876397036805665,-6,20.743956043956,63,1072.68252626634,1.3324206708341
20103,523195.885,5318482.501,166,62,104,35.767,0,2013,2,118,293,178,0.843979492589331,-200.2,21.3494505494505,60,1072.68252626634,1.3324206708341
20103,523195.885,5318482.501,142,86,56,40.97,0,2014,3,96,321,194,0.843761553047665,51.4,19.8307692307692,98,1072.68252626634,1.3324206708341
20103,523195.885,5318482.501,158,78,80,44.951,0,2015,2,103,328,153,0.829289487009295,-218.4,23.0318681318681,50,1072.68252626634,1.3324206708341
20103,523195.885,5318482.501,166,104,62,51.923,1,2016,1,103,328,177,0.843096884481304,-39.8,20.9813186813187,74,1072.68252626634,1.3324206708341
20103,523195.885,5318482.501,141,94,47,38.033,3,2017,1,104,300,161,0.785283727891787,-77.9,22.0516483516484,57,1072.68252626634,1.3324206708341
20103,523195.885,5318482.501,166,64,102,46.252,0,2018,2,98,306,144,0.823998382139767,-139.3,22.7065934065934,46,1072.68252626634,1.3324206708341
20103,523195.885,5318482.501,128,93,35,32.488,1,2019,1,116,319,162,0.772166335196893,-118.9,22.7472527472527,46,1072.68252626634,1.3324206708341
20103,523195.885,5318482.501,0,0,0,38.515,0,2020,0,93,311,185,0.770791224030821,-119,21.1252747252747,92,1072.68252626634,1.3324206708341
20105,523195.885,5318019.188,0,0,0,37.319,0,2001,1,114,329,184,0.885901669315611,-26.7,20.3989010989011,70,1140.86164647901,-0.0815659834976631
20105,523195.885,5318019.188,86,84,2,34.801,0,2002,1,114,323,185,0.872508554983106,-5.6,20.2901098901099,71,1140.86164647901,-0.0815659834976631
20105,523195.885,5318019.188,95,94,1,33.287,0,2003,1,110,316,161,0.866807678559891,-214.1,25.0835164835165,51,1140.86164647901,-0.0815659834976631
20105,523195.885,5318019.188,150,98,52,33.12,0,2004,1,115,324,177,0.866160606289373,90.8,19.910989010989,62,1140.86164647901,-0.0815659834976631
20105,523195.885,5318019.188,155,102,53,51.201,0,2005,1,102,303,161,0.860749436925521,-56.5,19.9923076923077,59,1140.86164647901,-0.0815659834976631
20105,523195.885,5318019.188,176,62,114,46.039,0,2006,3,105,320,185,0.870030869193343,16.2,20.9538461538462,80,1140.86164647901,-0.0815659834976631
20105,523195.885,5318019.188,167,93,74,54.467,0,2007,1,86,307,169,0.870662431941439,213,19.1032967032967,83,1140.86164647901,-0.0815659834976631
20105,523195.885,5318019.188,0,0,0,36.518,0,2008,0,111,302,217,0.862685197369088,-1.79999999999999,19.6,106,1140.86164647901,-0.0815659834976631
20105,523195.885,5318019.188,165,62,103,33.727,0,2009,2,108,305,177,0.893845704758638,-2.8,20.5450549450549,69,1140.86164647901,-0.0815659834976631
20105,523195.885,5318019.188,166,84,82,28.28,0,2010,2,117,294,177,0.853114141200978,50.5,20.2241758241758,60,1140.86164647901,-0.0815659834976631
20105,523195.885,5318019.188,83,57,26,32.877,0,2011,1,98,329,161,0.833195561204758,90.7,19.4164835164835,63,1140.86164647901,-0.0815659834976631
20105,523195.885,5318019.188,0,0,0,43.436,0,2012,0,109,303,168,0.851929770354184,-6,20.743956043956,59,1140.86164647901,-0.0815659834976631
20105,523195.885,5318019.188,179,63,116,29.525,0,2013,3,124,302,185,0.858649032856268,-200.2,21.3494505494505,61,1140.86164647901,-0.0815659834976631
20105,523195.885,5318019.188,142,93,49,41.713,0,2014,1,95,318,161,0.835731084588419,51.4,19.8307692307692,66,1140.86164647901,-0.0815659834976631
20105,523195.885,5318019.188,158,93,65,40.397,0,2015,1,108,339,153,0.859364079993867,-218.4,23.0318681318681,45,1140.86164647901,-0.0815659834976631
20105,523195.885,5318019.188,165,95,70,50.947,1,2016,1,104,324,184,0.825979675544341,-39.8,20.9813186813187,80,1140.86164647901,-0.0815659834976631
20105,523195.885,5318019.188,142,95,47,31.5,0,2017,1,113,295,162,0.820025052536823,-77.9,22.0516483516484,49,1140.86164647901,-0.0815659834976631
20105,523195.885,5318019.188,162,60,102,58.162,1,2018,2,87,329,145,0.845643510730345,-139.3,22.7065934065934,58,1140.86164647901,-0.0815659834976631
20105,523195.885,5318019.188,0,0,0,31.612,0,2019,0,117,331,162,0.808565628335213,-118.9,22.7472527472527,45,1140.86164647901,-0.0815659834976631
20105,523195.885,5318019.188,0,0,0,32.909,0,2020,0,100,307,162,0.78762032488767,-119,21.1252747252747,62,1140.86164647901,-0.0815659834976631
20106,523195.885,5317787.532,0,0,0,50.897,0,2001,1,102,322,176,0.859046412476003,-26.7,20.3989010989011,74,1148.98829786257,0.819964646906671
20106,523195.885,5317787.532,93,84,9,33.979,0,2002,2,115,330,170,0.835474231255241,-5.6,20.2901098901099,55,1148.98829786257,0.819964646906671
20106,523195.885,5317787.532,153,94,59,35.542,0,2003,1,107,322,162,0.859097440706519,-214.1,25.0835164835165,55,1148.98829786257,0.819964646906671
20106,523195.885,5317787.532,147,93,54,37.746,0,2004,1,110,320,177,0.858200569461696,90.8,19.910989010989,67,1148.98829786257,0.819964646906671
20106,523195.885,5317787.532,0,0,0,61.495,0,2005,0,92,310,162,0.865397865073294,-56.5,19.9923076923077,70,1148.98829786257,0.819964646906671
20106,523195.885,5317787.532,177,93,84,31.919,0,2006,1,119,320,169,0.856611581372777,16.2,20.9538461538462,50,1148.98829786257,0.819964646906671
20106,523195.885,5317787.532,111,76,35,49.245,0,2007,2,91,304,162,0.841359417047505,213,19.1032967032967,71,1148.98829786257,0.819964646906671
20106,523195.885,5317787.532,168,93,75,35.43,0,2008,1,112,305,176,0.850361850278647,-1.79999999999999,19.6,64,1148.98829786257,0.819964646906671
20106,523195.885,5317787.532,155,58,97,39.697,0,2009,2,101,308,154,0.847662015380324,-2.8,20.5450549450549,53,1148.98829786257,0.819964646906671
20106,523195.885,5317787.532,168,124,44,27.543,0,2010,1,118,302,209,0.862622796478099,50.5,20.2241758241758,91,1148.98829786257,0.819964646906671
20106,523195.885,5317787.532,86,86,0,33.693,0,2011,1,97,325,162,0.81035002647111,90.7,19.4164835164835,65,1148.98829786257,0.819964646906671
20106,523195.885,5317787.532,141,98,43,45.911,1,2012,1,106,306,169,0.885133558254988,-6,20.743956043956,63,1148.98829786257,0.819964646906671
20106,523195.885,5317787.532,176,63,113,36.779,0,2013,2,117,302,176,0.840833013929303,-200.2,21.3494505494505,59,1148.98829786257,0.819964646906671
20106,523195.885,5317787.532,142,93,49,43.979,0,2014,2,92,323,202,0.851496073041544,51.4,19.8307692307692,110,1148.98829786257,0.819964646906671
20106,523195.885,5317787.532,0,0,0,46.919,0,2015,0,101,330,153,0.853975908192253,-218.4,23.0318681318681,52,1148.98829786257,0.819964646906671
20106,523195.885,5317787.532,167,97,70,51.923,1,2016,2,103,328,202,0.837089456677873,-39.8,20.9813186813187,99,1148.98829786257,0.819964646906671
20106,523195.885,5317787.532,139,94,45,45.954,3,2017,1,94,316,154,0.799817424272373,-77.9,22.0516483516484,60,1148.98829786257,0.819964646906671
20106,523195.885,5317787.532,158,76,82,47.326,0,2018,3,97,337,193,0.738379089190773,-139.3,22.7065934065934,96,1148.98829786257,0.819964646906671
20106,523195.885,5317787.532,93,93,0,35.875,1,2019,1,112,331,160,0.788034272637357,-118.9,22.7472527472527,48,1148.98829786257,0.819964646906671
20106,523195.885,5317787.532,0,0,0,36.834,0,2020,0,95,308,161,0.772089899403575,-119,21.1252747252747,66,1148.98829786257,0.819964646906671
20107,523195.885,5317555.876,0,0,0,38.408,0,2001,1,113,315,177,0.886451109083365,-26.7,20.3989010989011,64,1163.75982465476,-1.33696119496764
20107,523195.885,5317555.876,93,85,8,29.804,0,2002,2,120,326,177,0.846040158029246,-5.6,20.2901098901099,57,1163.75982465476,-1.33696119496764
20107,523195.885,5317555.876,151,93,58,33.287,0,2003,1,110,321,161,0.853563922176287,-214.1,25.0835164835165,51,1163.75982465476,-1.33696119496764
20107,523195.885,5317555.876,151,107,44,38.687,0,2004,2,109,315,217,0.827135118643896,90.8,19.910989010989,108,1163.75982465476,-1.33696119496764
20107,523195.885,5317555.876,134,133,1,51.201,0,2005,1,102,314,169,0.88340779926106,-56.5,19.9923076923077,67,1163.75982465476,-1.33696119496764
20107,523195.885,5317555.876,177,93,84,30.995,0,2006,1,120,326,170,0.861598438486168,16.2,20.9538461538462,50,1163.75982465476,-1.33696119496764
20107,523195.885,5317555.876,113,80,33,46.235,0,2007,2,94,325,162,0.862200600211637,213,19.1032967032967,68,1163.75982465476,-1.33696119496764
20107,523195.885,5317555.876,164,93,71,29.743,0,2008,2,117,300,186,0.859445392379152,-1.79999999999999,19.6,69,1163.75982465476,-1.33696119496764
20107,523195.885,5317555.876,156,55,101,31.151,0,2009,2,111,314,161,0.849936008071319,-2.8,20.5450549450549,50,1163.75982465476,-1.33696119496764
20107,523195.885,5317555.876,168,124,44,26.13,0,2010,1,120,302,192,0.848381428997311,50.5,20.2241758241758,72,1163.75982465476,-1.33696119496764
20107,523195.885,5317555.876,86,86,0,36.229,0,2011,1,94,325,248,0.801967770919201,90.7,19.4164835164835,154,1163.75982465476,-1.33696119496764
20107,523195.885,5317555.876,138,95,43,45.105,1,2012,1,107,301,169,0.873956120335168,-6,20.743956043956,62,1163.75982465476,-1.33696119496764
20107,523195.885,5317555.876,176,59,117,36.779,0,2013,2,117,302,177,0.83954554709407,-200.2,21.3494505494505,60,1163.75982465476,-1.33696119496764
20107,523195.885,5317555.876,145,93,52,43.216,0,2014,1,93,324,170,0.84441331476473,51.4,19.8307692307692,77,1163.75982465476,-1.33696119496764
20107,523195.885,5317555.876,0,0,0,44.951,0,2015,0,103,330,160,0.8512590025006,-218.4,23.0318681318681,57,1163.75982465476,-1.33696119496764
20107,523195.885,5317555.876,167,94,73,48.928,1,2016,2,106,332,185,0.85725867729254,-39.8,20.9813186813187,79,1163.75982465476,-1.33696119496764
20107,523195.885,5317555.876,140,97,43,35.879,3,2017,1,107,315,162,0.807586348902909,-77.9,22.0516483516484,55,1163.75982465476,-1.33696119496764
20107,523195.885,5317555.876,157,75,82,48.427,0,2018,3,96,324,192,0.758653895231991,-139.3,22.7065934065934,96,1163.75982465476,-1.33696119496764
20107,523195.885,5317555.876,93,93,0,37.628,1,2019,1,110,332,168,0.820393655066383,-118.9,22.7472527472527,58,1163.75982465476,-1.33696119496764
20107,523195.885,5317555.876,0,0,0,36.014,0,2020,0,96,310,170,0.781473041979998,-119,21.1252747252747,74,1163.75982465476,-1.33696119496764
20108,523195.885,5317324.219,0,0,0,40.624,0,2001,2,111,320,170,0.900443142162738,-26.7,20.3989010989011,59,1170.55920131769,-1.44336531715865
20108,523195.885,5317324.219,120,81,39,39.028,0,2002,2,109,312,177,0.86862068645207,-5.6,20.2901098901099,68,1170.55920131769,-1.44336531715865
20108,523195.885,5317324.219,86,82,4,32.544,0,2003,1,111,326,160,0.855345140674529,-214.1,25.0835164835165,49,1170.55920131769,-1.44336531715865
20108,523195.885,5317324.219,146,102,44,34.944,0,2004,1,113,322,177,0.867298377430886,90.8,19.910989010989,64,1170.55920131769,-1.44336531715865
20108,523195.885,5317324.219,0,0,0,49.079,0,2005,0,104,311,168,0.893562220530912,-56.5,19.9923076923077,64,1170.55920131769,-1.44336531715865
20108,523195.885,5317324.219,170,66,104,34.734,0,2006,2,116,335,169,0.867756057500174,16.2,20.9538461538462,53,1170.55920131769,-1.44336531715865
20108,523195.885,5317324.219,162,93,69,53.401,0,2007,1,87,305,177,0.87646412539083,213,19.1032967032967,90,1170.55920131769,-1.44336531715865
20108,523195.885,5317324.219,0,0,0,36.518,0,2008,0,111,303,192,0.866510937221167,-1.79999999999999,19.6,81,1170.55920131769,-1.44336531715865
20108,523195.885,5317324.219,168,62,106,32.859,0,2009,2,109,304,152,0.83325863110051,-2.8,20.5450549450549,43,1170.55920131769,-1.44336531715865
20108,523195.885,5317324.219,158,94,64,28.28,0,2010,2,117,299,216,0.867421032267176,50.5,20.2241758241758,99,1170.55920131769,-1.44336531715865
20108,523195.885,5317324.219,86,57,29,37.066,0,2011,1,93,323,256,0.799097995099496,90.7,19.4164835164835,163,1170.55920131769,-1.44336531715865
20108,523195.885,5317324.219,93,93,0,47.418,1,2012,1,104,302,160,0.842581574805734,-6,20.743956043956,56,1170.55920131769,-1.44336531715865
20108,523195.885,5317324.219,176,98,78,30.562,0,2013,1,123,301,184,0.849088005997168,-200.2,21.3494505494505,61,1170.55920131769,-1.44336531715865
20108,523195.885,5317324.219,93,62,31,46.341,0,2014,2,89,317,176,0.863980708704249,51.4,19.8307692307692,87,1170.55920131769,-1.44336531715865
20108,523195.885,5317324.219,93,93,0,44.951,0,2015,1,103,329,161,0.928094468028032,-218.4,23.0318681318681,58,1170.55920131769,-1.44336531715865
20108,523195.885,5317324.219,155,93,62,46.75,1,2016,2,108,328,194,0.833510769615916,-39.8,20.9813186813187,86,1170.55920131769,-1.44336531715865
20108,523195.885,5317324.219,138,93,45,45.095,3,2017,2,95,299,194,0.850142231872458,-77.9,22.0516483516484,99,1170.55920131769,-1.44336531715865
20108,523195.885,5317324.219,159,67,92,43.16,0,2018,3,101,334,193,0.793805458078486,-139.3,22.7065934065934,92,1170.55920131769,-1.44336531715865
20108,523195.885,5317324.219,140,96,44,43.23,2,2019,1,104,334,162,0.812160901820813,-118.9,22.7472527472527,58,1170.55920131769,-1.44336531715865
20108,523195.885,5317324.219,0,0,0,45.634,0,2020,0,85,315,177,0.80543343330461,-119,21.1252747252747,92,1170.55920131769,-1.44336531715865
20202,523427.541,5346281.264,0,0,0,27.919,0,2001,2,123,304,201,0.851971425815862,118,17.3307692307692,78,1276.53412251499,1.38656656704322
20202,523427.541,5346281.264,86,69,17,47.339,3,2002,1,98,324,186,0.822189287181412,53.4,17.5120879120879,88,1276.53412251499,1.38656656704322
20202,523427.541,5346281.264,166,93,73,30.761,0,2003,2,117,293,200,0.845601183628516,-198.1,22.256043956044,83,1276.53412251499,1.38656656704322
20202,523427.541,5346281.264,155,30,125,23.575,0,2004,3,127,332,201,0.826529402785114,210.8,17.0318681318681,74,1276.53412251499,1.38656656704322
20202,523427.541,5346281.264,159,93,66,31.593,0,2005,2,122,316,226,0.831974155925872,45.7,17.2395604395604,104,1276.53412251499,1.38656656704322
20202,523427.541,5346281.264,181,80,101,47.873,2,2006,3,107,333,208,0.853358164613825,93.4,18.2021978021978,101,1276.53412251499,1.38656656704322
20202,523427.541,5346281.264,0,0,0,41.455,0,2007,0,101,296,200,0.83888495694158,334.9,16.4472527472527,99,1276.53412251499,1.38656656704322
20202,523427.541,5346281.264,173,55,118,22.486,0,2008,3,123,304,225,0.843798956053156,51.4,16.9230769230769,102,1276.53412251499,1.38656656704322
20202,523427.541,5346281.264,181,84,97,31.455,0,2009,3,113,290,185,0.861542795937665,56.1,17.7604395604396,72,1276.53412251499,1.38656656704322
20202,523427.541,5346281.264,167,74,93,32.76,0,2010,3,112,299,208,0.860786186995406,134.3,17.6802197802198,96,1276.53412251499,1.38656656704322
20202,523427.541,5346281.264,85,85,0,28.077,0,2011,1,106,322,208,0.807288801272571,136.8,16.9703296703297,102,1276.53412251499,1.38656656704322
20202,523427.541,5346281.264,165,94,71,30.867,0,2012,2,121,315,194,0.83838448810385,90.5,18.343956043956,73,1276.53412251499,1.38656656704322
20202,523427.541,5346281.264,173,93,80,25.348,1,2013,2,129,303,210,0.857800389419757,-155.5,18.543956043956,81,1276.53412251499,1.38656656704322
20202,523427.541,5346281.264,150,45,105,44.579,3,2014,3,93,345,208,0.870848239197711,192.7,17.3769230769231,115,1276.53412251499,1.38656656704322
20202,523427.541,5346281.264,166,93,73,33.522,0,2015,2,116,346,210,0.850874427948295,-153.6,20.3384615384615,94,1276.53412251499,1.38656656704322
20202,523427.541,5346281.264,174,93,81,22.943,0,2016,2,131,347,240,0.833805031380345,52.4,18.4901098901099,109,1276.53412251499,1.38656656704322
20202,523427.541,5346281.264,162,93,69,43.229,7,2017,2,99,297,185,0.846456087796464,-1.7,19.1,86,1276.53412251499,1.38656656704322
20202,523427.541,5346281.264,169,62,107,40.498,0,2018,3,104,314,209,0.863545806552153,-150.7,19.8846153846154,105,1276.53412251499,1.38656656704322
20202,523427.541,5346281.264,169,80,89,30.625,4,2019,3,119,301,233,0.812580116665594,-73,20.0010989010989,114,1276.53412251499,1.38656656704322
20202,523427.541,5346281.264,86,65,21,32.308,3,2020,1,102,333,233,0.829194961844639,-12.8,18.3098901098901,131,1276.53412251499,1.38656656704322
20222,523427.541,5341648.137,0,0,0,69.222,0,2001,2,87,323,177,0.855151996076453,116.8,17.4,90,1087.98172986456,-0.119583299802853
20222,523427.541,5341648.137,93,84,9,46.545,3,2002,3,100,336,185,0.862762640368266,52.7,17.567032967033,85,1087.98172986456,-0.119583299802853
20222,523427.541,5341648.137,158,93,65,37.912,1,2003,1,109,330,170,0.840828258223029,-198,22.3252747252747,61,1087.98172986456,-0.119583299802853
20222,523427.541,5341648.137,153,48,105,39.026,0,2004,2,110,331,178,0.836915319859971,209.7,17.0835164835165,68,1087.98172986456,-0.119583299802853
20222,523427.541,5341648.137,156,111,45,53.765,0,2005,1,102,309,169,0.860315397073134,44.2,17.3054945054945,67,1087.98172986456,-0.119583299802853
20222,523427.541,5341648.137,189,65,124,35.519,2,2006,3,118,333,218,0.887955245553952,92.3,18.2626373626374,100,1087.98172986456,-0.119583299802853
20222,523427.541,5341648.137,110,94,16,57.267,2,2007,2,86,315,224,0.824138592931125,332.6,16.5076923076923,138,1087.98172986456,-0.119583299802853
20222,523427.541,5341648.137,0,0,0,39.194,0,2008,0,108,308,217,0.830849835992502,50.1,16.9747252747253,109,1087.98172986456,-0.119583299802853
20222,523427.541,5341648.137,179,59,120,37.626,0,2009,3,107,291,234,0.837905564720755,55,17.8153846153846,127,1087.98172986456,-0.119583299802853
20222,523427.541,5341648.137,164,62,102,31.393,0,2010,3,114,309,184,0.837603408592434,133.1,17.7351648351648,70,1087.98172986456,-0.119583299802853
20222,523427.541,5341648.137,86,64,22,46.047,1,2011,1,85,325,193,0.834031007328685,136.1,17.0351648351648,108,1087.98172986456,-0.119583299802853
20222,523427.541,5341648.137,166,93,73,41.854,0,2012,1,111,307,170,0.869979365051048,88.9,18.4296703296703,59,1087.98172986456,-0.119583299802853
20222,523427.541,5341648.137,175,63,112,31.134,1,2013,2,124,308,170,0.819538655485775,-156.9,18.6175824175824,46,1087.98172986456,-0.119583299802853
20222,523427.541,5341648.137,153,64,89,43.111,3,2014,2,96,340,170,0.807364206130778,191.6,17.4516483516484,74,1087.98172986456,-0.119583299802853
20222,523427.541,5341648.137,161,93,68,40.807,0,2015,1,108,347,161,0.870027531656971,-154.6,20.4153846153846,53,1087.98172986456,-0.119583299802853
20222,523427.541,5341648.137,167,93,74,52.453,7,2016,1,104,343,170,0.874804448015216,50.9,18.5681318681319,66,1087.98172986456,-0.119583299802853
20222,523427.541,5341648.137,0,0,0,49.878,0,2017,0,92,306,170,0.857729583233024,-2.3,19.1582417582418,78,1087.98172986456,-0.119583299802853
20222,523427.541,5341648.137,169,68,101,43.003,0,2018,2,102,322,169,0.857782601310334,-151.3,19.9417582417582,67,1087.98172986456,-0.119583299802853
20222,523427.541,5341648.137,125,95,30,44.23,6,2019,1,104,331,169,0.847195381214634,-73.4,20.0571428571429,65,1087.98172986456,-0.119583299802853
20222,523427.541,5341648.137,124,95,29,43.221,9,2020,1,89,309,161,0.814148707304567,-13.6,18.3758241758242,72,1087.98172986456,-0.119583299802853
20224,523427.541,5341184.824,0,0,0,71.692,0,2001,2,85,289,178,0.850299790550183,116.8,17.4,93,1149.61144601747,0.211605637490071
20224,523427.541,5341184.824,156,71,85,33.158,0,2002,3,116,330,200,0.840217941232183,52.7,17.567032967033,84,1149.61144601747,0.211605637490071
20224,523427.541,5341184.824,164,104,60,38.746,1,2003,1,108,322,169,0.83972394835707,-198,22.3252747252747,61,1149.61144601747,0.211605637490071
20224,523427.541,5341184.824,169,126,43,30.751,0,2004,1,119,329,210,0.841236344236879,209.7,17.0835164835165,91,1149.61144601747,0.211605637490071
20224,523427.541,5341184.824,151,95,56,41.777,0,2005,2,113,308,184,0.854530724199707,44.2,17.3054945054945,71,1149.61144601747,0.211605637490071
20224,523427.541,5341184.824,184,66,118,40.893,2,2006,2,113,338,186,0.84425825850188,92.3,18.2626373626374,73,1149.61144601747,0.211605637490071
20224,523427.541,5341184.824,93,93,0,42.066,0,2007,2,101,289,193,0.812763832191631,332.6,16.5076923076923,92,1149.61144601747,0.211605637490071
20224,523427.541,5341184.824,86,58,28,26.659,0,2008,1,119,293,209,0.853572956904526,50.1,16.9747252747253,90,1149.61144601747,0.211605637490071
20224,523427.541,5341184.824,187,60,127,27.362,0,2009,3,118,293,176,0.884396398929899,55,17.8153846153846,58,1149.61144601747,0.211605637490071
20224,523427.541,5341184.824,173,66,107,24.628,0,2010,3,123,306,185,0.867930809294492,133.1,17.7351648351648,62,1149.61144601747,0.211605637490071
20224,523427.541,5341184.824,133,71,62,35.44,1,2011,2,97,316,169,0.830550878728057,136.1,17.0351648351648,72,1149.61144601747,0.211605637490071
20224,523427.541,5341184.824,178,93,85,28.345,0,2012,1,124,255,177,0.864860333996162,88.9,18.4296703296703,53,1149.61144601747,0.211605637490071
20224,523427.541,5341184.824,190,62,128,30.012,1,2013,3,125,300,200,0.840736729234995,-156.9,18.6175824175824,75,1149.61144601747,0.211605637490071
20224,523427.541,5341184.824,155,45,110,42.374,3,2014,3,97,318,186,0.829910441962011,191.6,17.4516483516484,89,1149.61144601747,0.211605637490071
20224,523427.541,5341184.824,166,103,63,38.991,0,2015,1,110,330,169,0.848169457198087,-154.6,20.4153846153846,59,1149.61144601747,0.211605637490071
20224,523427.541,5341184.824,177,123,54,27.214,0,2016,1,127,331,185,0.866098474868641,50.9,18.5681318681319,58,1149.61144601747,0.211605637490071
20224,523427.541,5341184.824,151,93,58,35.057,4,2017,1,111,302,178,0.830851987627548,-2.3,19.1582417582418,67,1149.61144601747,0.211605637490071
20224,523427.541,5341184.824,181,93,88,29.987,0,2018,1,116,317,176,0.850801678448577,-151.3,19.9417582417582,60,1149.61144601747,0.211605637490071
20224,523427.541,5341184.824,165,99,66,23.027,0,2019,1,128,300,184,0.839221000648899,-73.4,20.0571428571429,56,1149.61144601747,0.211605637490071
20224,523427.541,5341184.824,93,93,0,28.469,1,2020,2,108,299,194,0.800576145459981,-13.6,18.3758241758242,86,1149.61144601747,0.211605637490071
20261,523427.541,5332613.539,86,85,1,93.374,11,2001,2,69,298,170,0.868281627006371,103.5,18.1120879120879,101,1153.6271609419,1.27619846757262
20261,523427.541,5332613.539,152,52,100,19.15,0,2002,3,131,297,201,0.860541417637428,46.4,18.2428571428571,70,1153.6271609419,1.27619846757262
20261,523427.541,5332613.539,169,60,109,34.263,0,2003,2,113,300,154,0.817850491175586,-203.8,22.9692307692308,41,1153.6271609419,1.27619846757262
20261,523427.541,5332613.539,151,93,58,25.797,0,2004,2,125,304,232,0.841978856511811,196.1,17.7461538461538,107,1153.6271609419,1.27619846757262
20261,523427.541,5332613.539,158,94,64,48.62,0,2005,1,107,311,177,0.876974900763048,38.9,17.9032967032967,70,1153.6271609419,1.27619846757262
20261,523427.541,5332613.539,182,67,115,38.802,1,2006,2,116,332,185,0.841848172023671,82.6,18.867032967033,69,1153.6271609419,1.27619846757262
20261,523427.541,5332613.539,162,93,69,41.74,0,2007,3,101,295,216,0.840887236117298,317.9,17.0824175824176,115,1153.6271609419,1.27619846757262
20261,523427.541,5332613.539,162,56,106,39.294,1,2008,3,108,305,216,0.85192652563928,40.8,17.6131868131868,108,1153.6271609419,1.27619846757262
20261,523427.541,5332613.539,176,59,117,47.816,0,2009,2,98,295,177,0.923634356950745,41,18.5230769230769,79,1153.6271609419,1.27619846757262
20261,523427.541,5332613.539,166,72,94,32.534,0,2010,2,115,304,177,0.880118829611203,122,18.3626373626374,62,1153.6271609419,1.27619846757262
20261,523427.541,5332613.539,142,63,79,44.433,1,2011,5,89,317,225,0.840727313628553,127.1,17.5,136,1153.6271609419,1.27619846757262
20261,523427.541,5332613.539,163,136,27,35.543,0,2012,1,117,310,177,0.900971886667007,82.8,18.7043956043956,60,1153.6271609419,1.27619846757262
20261,523427.541,5332613.539,173,64,109,24.797,0,2013,3,130,301,186,0.873693251237864,-163.1,19.2582417582418,56,1153.6271609419,1.27619846757262
20261,523427.541,5332613.539,156,65,91,37.981,3,2014,3,103,319,241,0.839005029157593,176.9,17.856043956044,138,1153.6271609419,1.27619846757262
20261,523427.541,5332613.539,159,94,65,37.296,0,2015,1,112,319,161,0.857896535626886,-158.6,20.9142857142857,49,1153.6271609419,1.27619846757262
20261,523427.541,5332613.539,165,93,72,40.162,6,2016,1,115,336,161,0.855874012171533,45.5,18.8857142857143,46,1153.6271609419,1.27619846757262
20261,523427.541,5332613.539,143,98,45,33.279,3,2017,2,113,307,217,0.847991198558922,-10.8,19.7879120879121,104,1153.6271609419,1.27619846757262
20261,523427.541,5332613.539,175,93,82,38.886,0,2018,1,107,311,178,0.853208022617369,-154,20.578021978022,71,1153.6271609419,1.27619846757262
20261,523427.541,5332613.539,173,93,80,30.808,4,2019,1,119,309,169,0.818669072358417,-79.8,20.6626373626374,50,1153.6271609419,1.27619846757262
20261,523427.541,5332613.539,93,93,0,29.029,1,2020,2,107,298,185,0.791996892557702,-19.2,19.0648351648352,78,1153.6271609419,1.27619846757262
20262,523427.541,5332381.883,86,85,1,74.534,9,2001,2,83,296,178,0.845775779388447,103.5,18.1120879120879,95,1158.30780956879,-0.961093311741739
20262,523427.541,5332381.883,151,51,100,19.15,0,2002,3,131,296,234,0.854036045437861,46.4,18.2428571428571,103,1158.30780956879,-0.961093311741739
20262,523427.541,5332381.883,168,60,108,33.403,0,2003,2,114,304,162,0.812874865201622,-203.8,22.9692307692308,48,1158.30780956879,-0.961093311741739
20262,523427.541,5332381.883,151,93,58,28.399,0,2004,2,122,307,226,0.840227969236387,196.1,17.7461538461538,104,1158.30780956879,-0.961093311741739
20262,523427.541,5332381.883,159,93,66,46.32,0,2005,1,109,312,178,0.880360200282327,38.9,17.9032967032967,69,1158.30780956879,-0.961093311741739
20262,523427.541,5332381.883,182,68,114,34.152,1,2006,2,120,334,178,0.843751245316337,82.6,18.867032967033,58,1158.30780956879,-0.961093311741739
20262,523427.541,5332381.883,158,153,5,40.881,0,2007,1,102,295,225,0.878918627814736,317.9,17.0824175824176,123,1158.30780956879,-0.961093311741739
20262,523427.541,5332381.883,161,56,105,46.478,2,2008,3,102,303,224,0.86750062553007,40.8,17.6131868131868,122,1158.30780956879,-0.961093311741739
20262,523427.541,5332381.883,175,59,116,50.306,0,2009,2,96,295,170,0.896582687159562,41,18.5230769230769,74,1158.30780956879,-0.961093311741739
20262,523427.541,5332381.883,169,72,97,27.331,0,2010,3,121,308,184,0.871076712689284,122,18.3626373626374,63,1158.30780956879,-0.961093311741739
20262,523427.541,5332381.883,144,67,77,35.725,1,2011,2,98,316,153,0.829948082054815,127.1,17.5,55,1158.30780956879,-0.961093311741739
20262,523427.541,5332381.883,160,93,67,28.294,0,2012,2,124,309,185,0.885851474409088,82.8,18.7043956043956,61,1158.30780956879,-0.961093311741739
20262,523427.541,5332381.883,174,64,110,24.797,0,2013,3,130,301,192,0.869423943247413,-163.1,19.2582417582418,62,1158.30780956879,-0.961093311741739
20262,523427.541,5332381.883,156,65,91,35.319,1,2014,3,107,318,249,0.832279689820305,176.9,17.856043956044,142,1158.30780956879,-0.961093311741739
20262,523427.541,5332381.883,160,99,61,37.296,0,2015,1,112,316,161,0.863610660110479,-158.6,20.9142857142857,49,1158.30780956879,-0.961093311741739
20262,523427.541,5332381.883,167,104,63,35.915,2,2016,1,119,331,176,0.90986446959381,45.5,18.8857142857143,57,1158.30780956879,-0.961093311741739
20262,523427.541,5332381.883,141,94,47,29.541,1,2017,2,118,306,210,0.858938961875625,-10.8,19.7879120879121,92,1158.30780956879,-0.961093311741739
20262,523427.541,5332381.883,176,93,83,34.908,0,2018,1,111,311,169,0.867094993651093,-154,20.578021978022,58,1158.30780956879,-0.961093311741739
20262,523427.541,5332381.883,173,93,80,28.119,4,2019,1,122,309,177,0.851328286114631,-79.8,20.6626373626374,55,1158.30780956879,-0.961093311741739
20262,523427.541,5332381.883,93,93,0,27.747,1,2020,2,109,274,201,0.798404827559612,-19.2,19.0648351648352,92,1158.30780956879,-0.961093311741739
20265,523427.541,5331686.914,86,85,1,29.356,0,2001,2,122,289,185,0.868290356262038,103.5,18.1120879120879,63,1272.86268248071,-1.35407882634781
20265,523427.541,5331686.914,86,49,37,22.032,0,2002,1,128,296,233,0.834846988894938,46.4,18.2428571428571,105,1272.86268248071,-1.35407882634781
20265,523427.541,5331686.914,164,66,98,28.402,0,2003,3,120,325,217,0.782877875833111,-203.8,22.9692307692308,97,1272.86268248071,-1.35407882634781
20265,523427.541,5331686.914,178,93,85,16.794,0,2004,2,134,294,192,0.853382954835159,196.1,17.7461538461538,58,1272.86268248071,-1.35407882634781
20265,523427.541,5331686.914,161,96,65,33.058,0,2005,1,121,310,177,0.900605102698635,38.9,17.9032967032967,56,1272.86268248071,-1.35407882634781
20265,523427.541,5331686.914,187,93,94,37.621,1,2006,2,117,333,186,0.846375635424278,82.6,18.867032967033,69,1272.86268248071,-1.35407882634781
20265,523427.541,5331686.914,93,93,0,50.369,1,2007,2,92,294,225,0.815384089608944,317.9,17.0824175824176,133,1272.86268248071,-1.35407882634781
20265,523427.541,5331686.914,137,58,79,20.737,0,2008,2,125,295,169,0.866303579532784,40.8,17.6131868131868,44,1272.86268248071,-1.35407882634781
20265,523427.541,5331686.914,177,93,84,47.816,0,2009,1,98,296,168,0.89524901706395,41,18.5230769230769,70,1272.86268248071,-1.35407882634781
20265,523427.541,5331686.914,173,66,107,25.687,0,2010,2,123,303,177,0.877388042228385,122,18.3626373626374,54,1272.86268248071,-1.35407882634781
20265,523427.541,5331686.914,86,69,17,32.287,1,2011,1,102,316,232,0.835381452729955,127.1,17.5,130,1272.86268248071,-1.35407882634781
20265,523427.541,5331686.914,167,93,74,20.278,0,2012,2,132,305,186,0.875664711995977,82.8,18.7043956043956,54,1272.86268248071,-1.35407882634781
20265,523427.541,5331686.914,186,64,122,25.819,0,2013,2,129,296,178,0.894442888925279,-163.1,19.2582417582418,49,1272.86268248071,-1.35407882634781
20265,523427.541,5331686.914,161,46,115,32.15,0,2014,2,112,316,178,0.852498576360785,176.9,17.856043956044,66,1272.86268248071,-1.35407882634781
20265,523427.541,5331686.914,161,95,66,34.05,0,2015,1,116,317,170,0.883289200906822,-158.6,20.9142857142857,54,1272.86268248071,-1.35407882634781
20265,523427.541,5331686.914,177,104,73,26.131,0,2016,1,128,328,178,0.905024478847941,45.5,18.8857142857143,50,1272.86268248071,-1.35407882634781
20265,523427.541,5331686.914,143,94,49,22.307,0,2017,2,127,307,208,0.868923885403205,-10.8,19.7879120879121,81,1272.86268248071,-1.35407882634781
20265,523427.541,5331686.914,176,93,83,30.481,0,2018,1,116,297,178,0.86862148911085,-154,20.578021978022,62,1272.86268248071,-1.35407882634781
20265,523427.541,5331686.914,175,93,82,22.743,0,2019,1,128,298,177,0.868889189950342,-79.8,20.6626373626374,49,1272.86268248071,-1.35407882634781
20265,523427.541,5331686.914,93,93,0,22.062,1,2020,2,119,301,218,0.819289532092941,-19.2,19.0648351648352,99,1272.86268248071,-1.35407882634781
20268,523427.541,5330991.945,99,83,16,39.272,1,2001,3,113,294,177,0.874231187065453,103.5,18.1120879120879,64,1207.05506342323,0.810521918491865
20268,523427.541,5330991.945,93,52,41,28.89,0,2002,3,121,294,241,0.87459920841383,46.4,18.2428571428571,120,1207.05506342323,0.810521918491865
20268,523427.541,5330991.945,167,55,112,32.562,0,2003,2,115,325,168,0.84857278914907,-203.8,22.9692307692308,53,1207.05506342323,0.810521918491865
20268,523427.541,5330991.945,177,93,84,25.797,0,2004,2,125,297,233,0.861454949926443,196.1,17.7461538461538,108,1207.05506342323,0.810521918491865
20268,523427.541,5330991.945,164,93,71,40.722,0,2005,1,114,308,169,0.863877292320347,38.9,17.9032967032967,55,1207.05506342323,0.810521918491865
20268,523427.541,5330991.945,199,65,134,21.947,0,2006,3,132,327,256,0.872963570594013,82.6,18.867032967033,124,1207.05506342323,0.810521918491865
20268,523427.541,5330991.945,93,93,0,44.437,0,2007,1,98,297,169,0.894422240606251,317.9,17.0824175824176,71,1207.05506342323,0.810521918491865
20268,523427.541,5330991.945,111,48,63,20.737,0,2008,2,125,304,176,0.870318595391662,40.8,17.6131868131868,51,1207.05506342323,0.810521918491865
20268,523427.541,5330991.945,173,61,112,41.881,0,2009,2,103,308,162,0.891005986817899,41,18.5230769230769,59,1207.05506342323,0.810521918491865
20268,523427.541,5330991.945,166,75,91,27.331,0,2010,2,121,304,178,0.873559604679553,122,18.3626373626374,57,1207.05506342323,0.810521918491865
20268,523427.541,5330991.945,142,93,49,31.455,1,2011,2,103,319,249,0.829007362388955,127.1,17.5,146,1207.05506342323,0.810521918491865
20268,523427.541,5330991.945,155,98,57,25.279,0,2012,1,127,313,177,0.879653115195085,82.8,18.7043956043956,50,1207.05506342323,0.810521918491865
20268,523427.541,5330991.945,180,64,116,26.848,0,2013,2,128,297,178,0.856336407455015,-163.1,19.2582417582418,50,1207.05506342323,0.810521918491865
20268,523427.541,5330991.945,155,64,91,34.042,1,2014,3,109,318,240,0.860462808968167,176.9,17.856043956044,131,1207.05506342323,0.810521918491865
20268,523427.541,5330991.945,162,93,69,38.159,0,2015,1,111,333,169,0.879347313901324,-158.6,20.9142857142857,58,1207.05506342323,0.810521918491865
20268,523427.541,5330991.945,173,119,54,34.845,1,2016,1,120,326,177,0.908769881356212,45.5,18.8857142857143,57,1207.05506342323,0.810521918491865
20268,523427.541,5330991.945,140,94,46,36.335,6,2017,1,109,290,176,0.865177931218356,-10.8,19.7879120879121,67,1207.05506342323,0.810521918491865
20268,523427.541,5330991.945,168,47,121,33.134,0,2018,3,113,322,186,0.847011059333019,-154,20.578021978022,73,1207.05506342323,0.810521918491865
20268,523427.541,5330991.945,166,94,72,30.808,4,2019,1,119,323,169,0.856152644200487,-79.8,20.6626373626374,50,1207.05506342323,0.810521918491865
20268,523427.541,5330991.945,94,94,0,25.906,1,2020,2,112,315,241,0.822663653311442,-19.2,19.0648351648352,129,1207.05506342323,0.810521918491865
20269,523427.541,5330760.288,86,83,3,52.981,9,2001,2,101,301,162,0.830697826437491,103.5,18.1120879120879,61,1198.21037839162,-0.0293931289577393
20269,523427.541,5330760.288,93,51,42,35.766,0,2002,3,113,296,242,0.883453070898053,46.4,18.2428571428571,129,1198.21037839162,-0.0293931289577393
20269,523427.541,5330760.288,164,55,109,35.971,0,2003,2,111,323,154,0.833484202836951,-203.8,22.9692307692308,43,1198.21037839162,-0.0293931289577393
20269,523427.541,5330760.288,170,99,71,45.215,0,2004,2,105,332,240,0.860235652769407,196.1,17.7461538461538,135,1198.21037839162,-0.0293931289577393
20269,523427.541,5330760.288,156,98,58,53.016,0,2005,1,103,312,161,0.88284528777167,38.9,17.9032967032967,58,1198.21037839162,-0.0293931289577393
20269,523427.541,5330760.288,198,66,132,27.01,0,2006,2,127,335,170,0.859328727058818,82.6,18.867032967033,43,1198.21037839162,-0.0293931289577393
20269,523427.541,5330760.288,93,93,0,50.369,1,2007,1,92,307,169,0.89698421297469,317.9,17.0824175824176,77,1198.21037839162,-0.0293931289577393
20269,523427.541,5330760.288,86,61,25,27.767,0,2008,1,118,308,241,0.841166324528435,40.8,17.6131868131868,123,1198.21037839162,-0.0293931289577393
20269,523427.541,5330760.288,175,65,110,50.306,0,2009,2,96,300,168,0.911191285492719,41,18.5230769230769,72,1198.21037839162,-0.0293931289577393
20269,523427.541,5330760.288,168,72,96,30.712,0,2010,2,117,311,170,0.8835467443156,122,18.3626373626374,53,1198.21037839162,-0.0293931289577393
20269,523427.541,5330760.288,144,96,48,35.725,1,2011,2,98,322,249,0.848445100548136,127.1,17.5,151,1198.21037839162,-0.0293931289577393
20269,523427.541,5330760.288,155,81,74,29.335,0,2012,2,123,310,177,0.878651812112311,82.8,18.7043956043956,54,1198.21037839162,-0.0293931289577393
20269,523427.541,5330760.288,177,93,84,34.654,0,2013,1,121,298,177,0.878299705238079,-163.1,19.2582417582418,56,1198.21037839162,-0.0293931289577393
20269,523427.541,5330760.288,154,44,110,43.069,3,2014,3,96,334,258,0.838827242588279,176.9,17.856043956044,162,1198.21037839162,-0.0293931289577393
20269,523427.541,5330760.288,160,93,67,50.709,0,2015,1,98,334,160,0.852768750779047,-158.6,20.9142857142857,62,1198.21037839162,-0.0293931289577393
20269,523427.541,5330760.288,167,93,74,49.248,6,2016,1,107,326,170,0.900970890369421,45.5,18.8857142857143,63,1198.21037839162,-0.0293931289577393
20269,523427.541,5330760.288,143,93,50,43.923,7,2017,1,99,294,162,0.853698164599905,-10.8,19.7879120879121,63,1198.21037839162,-0.0293931289577393
20269,523427.541,5330760.288,175,55,120,38.886,0,2018,2,107,309,160,0.851783934366183,-154,20.578021978022,53,1198.21037839162,-0.0293931289577393
20269,523427.541,5330760.288,165,93,72,36.738,4,2019,1,112,329,161,0.849168006867902,-79.8,20.6626373626374,49,1198.21037839162,-0.0293931289577393
20269,523427.541,5330760.288,0,0,0,29.029,0,2020,0,107,311,169,0.841821788120147,-19.2,19.0648351648352,62,1198.21037839162,-0.0293931289577393
20270,523427.541,5330528.632,86,83,3,22.158,0,2001,3,129,303,169,0.816606726011388,103.5,18.1120879120879,40,1200.10847976649,-0.609313335112401
20270,523427.541,5330528.632,93,51,42,42.942,1,2002,2,105,299,169,0.862740759573239,46.4,18.2428571428571,64,1200.10847976649,-0.609313335112401
20270,523427.541,5330528.632,162,56,106,38.54,1,2003,2,108,323,152,0.85404011620828,-203.8,22.9692307692308,44,1200.10847976649,-0.609313335112401
20270,523427.541,5330528.632,169,99,70,50.945,2,2004,2,100,334,249,0.84502161317894,196.1,17.7461538461538,149,1200.10847976649,-0.609313335112401
20270,523427.541,5330528.632,156,99,57,60.386,2,2005,1,97,310,161,0.882073559181158,38.9,17.9032967032967,64,1200.10847976649,-0.609313335112401
20270,523427.541,5330528.632,198,64,134,28.905,0,2006,2,125,337,169,0.860395202294092,82.6,18.867032967033,44,1200.10847976649,-0.609313335112401
20270,523427.541,5330528.632,0,0,0,52.484,0,2007,0,90,304,240,0.844149458908976,317.9,17.0824175824176,150,1200.10847976649,-0.609313335112401
20270,523427.541,5330528.632,78,57,21,31.216,0,2008,1,115,305,168,0.851260513073744,40.8,17.6131868131868,53,1200.10847976649,-0.609313335112401
20270,523427.541,5330528.632,173,61,112,58.767,1,2009,2,89,302,162,0.900284127778345,41,18.5230769230769,73,1200.10847976649,-0.609313335112401
20270,523427.541,5330528.632,165,71,94,33.48,0,2010,2,114,313,169,0.873104484819261,122,18.3626373626374,55,1200.10847976649,-0.609313335112401
20270,523427.541,5330528.632,144,96,48,38.555,1,2011,1,95,323,161,0.842882599029035,127.1,17.5,66,1200.10847976649,-0.609313335112401
20270,523427.541,5330528.632,154,81,73,49.606,1,2012,2,102,314,168,0.864259737279838,82.8,18.7043956043956,66,1200.10847976649,-0.609313335112401
20270,523427.541,5330528.632,177,98,79,40.309,0,2013,1,116,284,170,0.856942163655477,-163.1,19.2582417582418,54,1200.10847976649,-0.609313335112401
20270,523427.541,5330528.632,161,37,124,40.828,3,2014,2,99,338,154,0.844558223823269,176.9,17.856043956044,55,1200.10847976649,-0.609313335112401
20270,523427.541,5330528.632,160,96,64,53.012,2,2015,1,96,333,153,0.874037343255378,-158.6,20.9142857142857,57,1200.10847976649,-0.609313335112401
20270,523427.541,5330528.632,174,142,32,43.353,6,2016,1,112,329,162,0.870024204168644,45.5,18.8857142857143,50,1200.10847976649,-0.609313335112401
20270,523427.541,5330528.632,142,94,48,47.282,7,2017,1,95,304,161,0.841174377519786,-10.8,19.7879120879121,66,1200.10847976649,-0.609313335112401
20270,523427.541,5330528.632,169,60,109,54.009,1,2018,3,94,311,265,0.757865533113451,-154,20.578021978022,171,1200.10847976649,-0.609313335112401
20270,523427.541,5330528.632,165,93,72,41.159,4,2019,1,107,332,160,0.84272978274954,-79.8,20.6626373626374,53,1200.10847976649,-0.609313335112401
20270,523427.541,5330528.632,0,0,0,32.478,0,2020,0,102,311,169,0.837920678170552,-19.2,19.0648351648352,67,1200.10847976649,-0.609313335112401
20271,523427.541,5330296.975,86,81,5,38.195,0,2001,3,114,299,177,0.825478658862573,103.5,18.1120879120879,63,1187.59393881865,-0.953198266499305
20271,523427.541,5330296.975,136,61,75,38.443,0,2002,2,110,298,169,0.826079550020511,46.4,18.2428571428571,59,1187.59393881865,-0.953198266499305
20271,523427.541,5330296.975,168,56,112,43.196,1,2003,2,103,300,153,0.805175511445409,-203.8,22.9692307692308,50,1187.59393881865,-0.953198266499305
20271,523427.541,5330296.975,170,60,110,40.964,0,2004,2,109,332,169,0.821316293446638,196.1,17.7461538461538,60,1187.59393881865,-0.953198266499305
20271,523427.541,5330296.975,158,99,59,54.184,0,2005,1,102,310,161,0.869091801616636,38.9,17.9032967032967,59,1187.59393881865,-0.953198266499305
20271,523427.541,5330296.975,198,64,134,36.445,1,2006,2,118,326,169,0.844282817881338,82.6,18.867032967033,51,1187.59393881865,-0.953198266499305
20271,523427.541,5330296.975,86,77,9,45.373,0,2007,1,97,306,233,0.82448523769877,317.9,17.0824175824176,136,1187.59393881865,-0.953198266499305
20271,523427.541,5330296.975,78,54,24,24.635,0,2008,1,121,311,169,0.851233039720792,40.8,17.6131868131868,48,1187.59393881865,-0.953198266499305
20271,523427.541,5330296.975,185,162,23,30.375,0,2009,1,114,299,161,0.90279446371169,41,18.5230769230769,47,1187.59393881865,-0.953198266499305
20271,523427.541,5330296.975,165,75,90,28.975,0,2010,2,119,314,170,0.843148125951863,122,18.3626373626374,51,1187.59393881865,-0.953198266499305
20271,523427.541,5330296.975,139,79,60,36.643,1,2011,3,97,324,256,0.818438521366846,127.1,17.5,159,1187.59393881865,-0.953198266499305
20271,523427.541,5330296.975,156,81,75,44.47,1,2012,2,108,316,162,0.83688965713712,82.8,18.7043956043956,54,1187.59393881865,-0.953198266499305
20271,523427.541,5330296.975,178,78,100,30.119,0,2013,2,125,301,177,0.832475638720558,-163.1,19.2582417582418,52,1187.59393881865,-0.953198266499305
20271,523427.541,5330296.975,154,45,109,42.312,3,2014,3,97,338,241,0.840957678863079,176.9,17.856043956044,144,1187.59393881865,-0.953198266499305
20271,523427.541,5330296.975,163,93,70,45.493,0,2015,1,103,327,160,0.843672502256141,-158.6,20.9142857142857,57,1187.59393881865,-0.953198266499305
20271,523427.541,5330296.975,169,100,69,49.248,6,2016,1,107,328,170,0.862377687400747,45.5,18.8857142857143,63,1187.59393881865,-0.953198266499305
20271,523427.541,5330296.975,156,93,63,41.583,7,2017,2,102,304,233,0.810770629162765,-10.8,19.7879120879121,131,1187.59393881865,-0.953198266499305
20271,523427.541,5330296.975,168,59,109,56.31,2,2018,2,92,305,160,0.810839336944096,-154,20.578021978022,68,1187.59393881865,-0.953198266499305
20271,523427.541,5330296.975,165,81,84,38.444,4,2019,2,110,331,161,0.810779311830212,-79.8,20.6626373626374,51,1187.59393881865,-0.953198266499305
20271,523427.541,5330296.975,93,93,0,29.692,2,2020,1,106,311,170,0.797966177613091,-19.2,19.0648351648352,64,1187.59393881865,-0.953198266499305
20272,523427.541,5330065.319,86,81,5,40.363,2,2001,3,112,297,178,0.828504370740868,103.5,18.1120879120879,66,1157.22841540993,0.510686718276507
20272,523427.541,5330065.319,135,59,76,40.238,0,2002,2,108,297,170,0.819790667205345,46.4,18.2428571428571,62,1157.22841540993,0.510686718276507
20272,523427.541,5330065.319,169,55,114,40.336,1,2003,2,106,301,154,0.792259623638467,-203.8,22.9692307692308,48,1157.22841540993,0.510686718276507
20272,523427.541,5330065.319,170,60,110,44.129,0,2004,2,106,333,170,0.811595798749162,196.1,17.7461538461538,64,1157.22841540993,0.510686718276507
20272,523427.541,5330065.319,159,103,56,50.776,0,2005,1,105,310,168,0.858926539826574,38.9,17.9032967032967,63,1157.22841540993,0.510686718276507
20272,523427.541,5330065.319,200,64,136,29.895,0,2006,3,124,326,176,0.823302337399392,82.6,18.867032967033,52,1157.22841540993,0.510686718276507
20272,523427.541,5330065.319,86,77,9,45.373,0,2007,1,97,310,233,0.818820552977214,317.9,17.0824175824176,136,1157.22841540993,0.510686718276507
20272,523427.541,5330065.319,86,58,28,30.024,0,2008,1,116,312,176,0.807962744986302,40.8,17.6131868131868,60,1157.22841540993,0.510686718276507
20272,523427.541,5330065.319,185,93,92,29.472,0,2009,2,115,299,162,0.890591332519978,41,18.5230769230769,47,1157.22841540993,0.510686718276507
20272,523427.541,5330065.319,162,75,87,32.534,0,2010,2,115,312,176,0.803048421354495,122,18.3626373626374,61,1157.22841540993,0.510686718276507
20272,523427.541,5330065.319,144,78,66,36.643,1,2011,5,97,326,257,0.79980505754117,127.1,17.5,160,1157.22841540993,0.510686718276507
20272,523427.541,5330065.319,155,81,74,47.913,1,2012,2,104,314,176,0.856989273382649,82.8,18.7043956043956,72,1157.22841540993,0.510686718276507
20272,523427.541,5330065.319,183,78,105,34.654,0,2013,2,121,296,176,0.846572242582017,-163.1,19.2582417582418,55,1157.22841540993,0.510686718276507
20272,523427.541,5330065.319,155,43,112,40.097,3,2014,3,100,340,241,0.816859397214273,176.9,17.856043956044,141,1157.22841540993,0.510686718276507
20272,523427.541,5330065.319,162,93,69,44.529,0,2015,1,104,330,162,0.821061981079993,-158.6,20.9142857142857,58,1157.22841540993,0.510686718276507
20272,523427.541,5330065.319,172,110,62,44.478,6,2016,1,111,328,178,0.858805466417826,45.5,18.8857142857143,67,1157.22841540993,0.510686718276507
20272,523427.541,5330065.319,162,108,54,34.029,3,2017,2,112,294,233,0.796588877288813,-10.8,19.7879120879121,121,1157.22841540993,0.510686718276507
20272,523427.541,5330065.319,176,53,123,37.829,0,2018,2,108,315,170,0.772994168612021,-154,20.578021978022,62,1157.22841540993,0.510686718276507
20272,523427.541,5330065.319,171,82,89,34.292,4,2019,2,115,330,161,0.800508686966694,-79.8,20.6626373626374,46,1157.22841540993,0.510686718276507
20272,523427.541,5330065.319,93,93,0,31.059,3,2020,1,104,308,170,0.777874935912455,-19.2,19.0648351648352,66,1157.22841540993,0.510686718276507
20276,523427.541,5329138.694,0,0,0,39.272,0,2001,3,113,277,192,0.804528934327516,103.5,18.1120879120879,79,1248.16995098767,-1.39962462934081
20276,523427.541,5329138.694,62,52,10,23.03,0,2002,1,127,292,193,0.813620442016191,46.4,18.2428571428571,66,1248.16995098767,-1.39962462934081
20276,523427.541,5329138.694,166,50,116,29.244,0,2003,2,119,301,178,0.78335373512722,-203.8,22.9692307692308,59,1248.16995098767,-1.39962462934081
20276,523427.541,5329138.694,179,139,40,21.135,0,2004,1,130,334,185,0.785381763098387,196.1,17.7461538461538,55,1248.16995098767,-1.39962462934081
20276,523427.541,5329138.694,165,139,26,37.383,0,2005,1,117,312,177,0.803854410750035,38.9,17.9032967032967,60,1248.16995098767,-1.39962462934081
20276,523427.541,5329138.694,199,62,137,21.947,0,2006,2,132,325,177,0.783349438808136,82.6,18.867032967033,45,1248.16995098767,-1.39962462934081
20276,523427.541,5329138.694,149,75,74,37.648,0,2007,2,106,302,162,0.785563802579108,317.9,17.0824175824176,56,1248.16995098767,-1.39962462934081
20276,523427.541,5329138.694,86,58,28,3.498,0,2008,1,149,304,200,0.748291791291574,40.8,17.6131868131868,51,1248.16995098767,-1.39962462934081
20276,523427.541,5329138.694,187,71,116,27.734,0,2009,2,117,292,169,0.826283567164707,41,18.5230769230769,52,1248.16995098767,-1.39962462934081
20276,523427.541,5329138.694,165,72,93,23.268,0,2010,3,126,298,192,0.785950019493328,122,18.3626373626374,66,1248.16995098767,-1.39962462934081
20276,523427.541,5329138.694,149,58,91,31.455,1,2011,2,103,316,176,0.77312580212156,127.1,17.5,73,1248.16995098767,-1.39962462934081
20276,523427.541,5329138.694,154,79,75,19.317,0,2012,3,133,304,185,0.813829890281897,82.8,18.7043956043956,52,1248.16995098767,-1.39962462934081
20276,523427.541,5329138.694,188,68,120,21.732,0,2013,2,133,291,192,0.777886004833636,-163.1,19.2582417582418,59,1248.16995098767,-1.39962462934081
20276,523427.541,5329138.694,160,50,110,34.679,1,2014,2,108,312,177,0.785822166090433,176.9,17.856043956044,69,1248.16995098767,-1.39962462934081
20276,523427.541,5329138.694,165,93,72,34.05,0,2015,1,116,289,169,0.758067013631029,-158.6,20.9142857142857,53,1248.16995098767,-1.39962462934081
20276,523427.541,5329138.694,177,147,30,31.57,0,2016,1,123,311,176,0.814800221001047,45.5,18.8857142857143,53,1248.16995098767,-1.39962462934081
20276,523427.541,5329138.694,145,93,52,26.361,0,2017,1,122,306,177,0.760262057982813,-10.8,19.7879120879121,55,1248.16995098767,-1.39962462934081
20276,523427.541,5329138.694,170,64,106,49.14,0,2018,2,98,312,177,0.770655777252967,-154,20.578021978022,79,1248.16995098767,-1.39962462934081
20276,523427.541,5329138.694,166,93,73,23.635,1,2019,1,127,306,177,0.759208898411777,-79.8,20.6626373626374,50,1248.16995098767,-1.39962462934081
20276,523427.541,5329138.694,93,93,0,23.11,1,2020,2,117,305,193,0.728346210595561,-19.2,19.0648351648352,76,1248.16995098767,-1.39962462934081
20321,523427.541,5318714.158,0,0,0,38.229,0,2001,0,113,332,177,0.879500738983143,-27.4,20.4835164835165,64,1018.26910703753,-1.28567627955154
20321,523427.541,5318714.158,107,86,21,48.995,1,2002,2,97,327,169,0.872812895345603,-6.4,20.3582417582418,72,1018.26910703753,-1.28567627955154
20321,523427.541,5318714.158,151,100,51,43.747,5,2003,1,97,314,153,0.858566054541839,-214,25.1549450549451,56,1018.26910703753,-1.28567627955154
20321,523427.541,5318714.158,155,93,62,38.489,0,2004,1,109,323,162,0.848614576795624,89.5,19.9813186813187,53,1018.26910703753,-1.28567627955154
20321,523427.541,5318714.158,140,93,47,66.361,1,2005,1,87,308,154,0.859954606222543,-56.9,20.0681318681319,67,1018.26910703753,-1.28567627955154
20321,523427.541,5318714.158,184,93,91,32.708,0,2006,2,118,335,208,0.84981680571112,14.9,21.0197802197802,90,1018.26910703753,-1.28567627955154
20321,523427.541,5318714.158,0,0,0,46.978,0,2007,0,93,301,217,0.844820996293707,211.1,19.1692307692308,124,1018.26910703753,-1.28567627955154
20321,523427.541,5318714.158,166,83,83,27.419,0,2008,2,119,307,176,0.852016811659016,-2.3,19.6692307692308,57,1018.26910703753,-1.28567627955154
20321,523427.541,5318714.158,177,63,114,34.345,0,2009,2,107,315,161,0.895407926928682,-3.7,20.6208791208791,54,1018.26910703753,-1.28567627955154
20321,523427.541,5318714.158,165,94,71,29.617,0,2010,1,115,311,178,0.830236940274657,49.3,20.289010989011,63,1018.26910703753,-1.28567627955154
20321,523427.541,5318714.158,0,0,0,42.768,0,2011,0,86,345,161,0.853268522213767,90,19.4703296703297,75,1018.26910703753,-1.28567627955154
20321,523427.541,5318714.158,0,0,0,48.761,0,2012,0,102,306,169,0.881665512503216,-6.9,20.7978021978022,67,1018.26910703753,-1.28567627955154
20321,523427.541,5318714.158,167,62,105,37.524,0,2013,2,116,296,177,0.862014940618893,-200.4,21.4142857142857,61,1018.26910703753,-1.28567627955154
20321,523427.541,5318714.158,141,98,43,40.761,0,2014,2,96,318,218,0.91637671857464,49.7,19.8813186813187,122,1018.26910703753,-1.28567627955154
20321,523427.541,5318714.158,150,77,73,48.767,0,2015,2,99,332,168,0.819632496161196,-218.5,23.0923076923077,69,1018.26910703753,-1.28567627955154
20321,523427.541,5318714.158,163,94,69,58.709,1,2016,2,96,329,192,0.870595591436022,-40.7,21.0384615384615,96,1018.26910703753,-1.28567627955154
20321,523427.541,5318714.158,137,98,39,42.356,3,2017,2,98,299,224,0.823496077055255,-78.7,22.1241758241758,126,1018.26910703753,-1.28567627955154
20321,523427.541,5318714.158,150,64,86,75.593,8,2018,2,71,327,160,0.893570384178608,-139.1,22.778021978022,89,1018.26910703753,-1.28567627955154
20321,523427.541,5318714.158,123,93,30,38.38,1,2019,1,109,302,176,0.821810771475274,-119,22.8142857142857,67,1018.26910703753,-1.28567627955154
20321,523427.541,5318714.158,0,0,0,41.75,0,2020,0,89,309,170,0.811168038788387,-119.1,21.1978021978022,81,1018.26910703753,-1.28567627955154
20322,523427.541,5318482.501,0,0,0,55.545,0,2001,1,98,328,185,0.865224838584353,-26.7,20.3989010989011,87,1003.73451752797,-0.825058586988849
20322,523427.541,5318482.501,108,85,23,43.332,0,2002,2,104,331,169,0.843534457545428,-5.6,20.2901098901099,65,1003.73451752797,-0.825058586988849
20322,523427.541,5318482.501,151,97,54,40.507,1,2003,1,101,300,152,0.823326939873288,-214.1,25.0835164835165,51,1003.73451752797,-0.825058586988849
20322,523427.541,5318482.501,158,97,61,35.871,0,2004,1,112,326,169,0.866667408259972,90.8,19.910989010989,57,1003.73451752797,-0.825058586988849
20322,523427.541,5318482.501,143,95,48,58.607,1,2005,1,95,308,161,0.837285817873949,-56.5,19.9923076923077,66,1003.73451752797,-0.825058586988849
20322,523427.541,5318482.501,181,102,79,30.086,0,2006,1,121,335,177,0.822047874221226,16.2,20.9538461538462,56,1003.73451752797,-0.825058586988849
20322,523427.541,5318482.501,0,0,0,48.223,0,2007,0,92,299,201,0.843822205117598,213,19.1032967032967,109,1003.73451752797,-0.825058586988849
20322,523427.541,5318482.501,166,81,85,27.601,0,2008,3,119,303,185,0.853270343064557,-1.79999999999999,19.6,66,1003.73451752797,-0.825058586988849
20322,523427.541,5318482.501,173,62,111,37.93,0,2009,2,103,304,168,0.865881624308882,-2.8,20.5450549450549,65,1003.73451752797,-0.825058586988849
20322,523427.541,5318482.501,167,94,73,25.439,0,2010,2,121,305,194,0.837961998687698,50.5,20.2241758241758,73,1003.73451752797,-0.825058586988849
20322,523427.541,5318482.501,93,86,7,38.773,0,2011,3,91,331,233,0.796996601403237,90.7,19.4164835164835,142,1003.73451752797,-0.825058586988849
20322,523427.541,5318482.501,93,93,0,46.664,1,2012,1,105,303,170,0.890216720766838,-6,20.743956043956,65,1003.73451752797,-0.825058586988849
20322,523427.541,5318482.501,165,60,105,42.419,0,2013,2,111,288,177,0.850876390093699,-200.2,21.3494505494505,66,1003.73451752797,-0.825058586988849
20322,523427.541,5318482.501,141,86,55,38.801,0,2014,3,99,319,225,0.876185831300451,51.4,19.8307692307692,126,1003.73451752797,-0.825058586988849
20322,523427.541,5318482.501,153,77,76,50.047,0,2015,2,98,323,153,0.825399653028375,-218.4,23.0318681318681,55,1003.73451752797,-0.825058586988849
20322,523427.541,5318482.501,164,93,71,52.886,1,2016,2,102,329,185,0.860613596113901,-39.8,20.9813186813187,83,1003.73451752797,-0.825058586988849
20322,523427.541,5318482.501,140,98,42,45.095,3,2017,2,95,308,216,0.83693728922825,-77.9,22.0516483516484,121,1003.73451752797,-0.825058586988849
20322,523427.541,5318482.501,162,67,95,48.427,0,2018,3,96,309,192,0.819862821447918,-139.3,22.7065934065934,96,1003.73451752797,-0.825058586988849
20322,523427.541,5318482.501,128,94,34,37.628,1,2019,1,110,307,169,0.836913294460492,-118.9,22.7472527472527,59,1003.73451752797,-0.825058586988849
20322,523427.541,5318482.501,0,0,0,36.834,0,2020,0,95,309,186,0.800943798334472,-119,21.1252747252747,91,1003.73451752797,-0.825058586988849
20326,523427.541,5317555.876,0,0,0,44.008,0,2001,1,108,313,177,0.867764368026508,-26.7,20.3989010989011,69,1169.34956164461,-1.40520926623059
20326,523427.541,5317555.876,93,83,10,32.356,0,2002,3,117,326,185,0.837922260927677,-5.6,20.2901098901099,68,1169.34956164461,-1.40520926623059
20326,523427.541,5317555.876,156,93,63,33.287,0,2003,1,110,313,161,0.853474300912081,-214.1,25.0835164835165,51,1169.34956164461,-1.40520926623059
20326,523427.541,5317555.876,150,99,51,33.12,0,2004,2,115,318,210,0.799473582542112,90.8,19.910989010989,95,1169.34956164461,-1.40520926623059
20326,523427.541,5317555.876,151,111,40,50.128,0,2005,1,103,310,169,0.864869886511266,-56.5,19.9923076923077,66,1169.34956164461,-1.40520926623059
20326,523427.541,5317555.876,178,93,85,29.192,0,2006,1,122,332,170,0.84712940892514,16.2,20.9538461538462,48,1169.34956164461,-1.40520926623059
20326,523427.541,5317555.876,112,93,19,44.305,0,2007,1,96,301,162,0.853286732653995,213,19.1032967032967,66,1169.34956164461,-1.40520926623059
20326,523427.541,5317555.876,170,93,77,27.601,0,2008,2,119,300,192,0.847601626358003,-1.79999999999999,19.6,73,1169.34956164461,-1.40520926623059
20326,523427.541,5317555.876,154,55,99,36.228,0,2009,2,105,301,161,0.846354264264793,-2.8,20.5450549450549,56,1169.34956164461,-1.40520926623059
20326,523427.541,5317555.876,168,124,44,26.13,0,2010,1,120,303,185,0.834617784874879,50.5,20.2241758241758,65,1169.34956164461,-1.40520926623059
20326,523427.541,5317555.876,86,85,1,33.693,0,2011,1,97,322,161,0.814234684858216,90.7,19.4164835164835,64,1169.34956164461,-1.40520926623059
20326,523427.541,5317555.876,141,93,48,45.105,1,2012,1,107,304,169,0.870024146841271,-6,20.743956043956,62,1169.34956164461,-1.40520926623059
20326,523427.541,5317555.876,173,62,111,36.779,0,2013,2,117,298,178,0.835636689908658,-200.2,21.3494505494505,61,1169.34956164461,-1.40520926623059
20326,523427.541,5317555.876,142,93,49,40.97,0,2014,1,96,325,170,0.833684149834336,51.4,19.8307692307692,74,1169.34956164461,-1.40520926623059
20326,523427.541,5317555.876,0,0,0,44,0,2015,0,104,329,160,0.854084337864865,-218.4,23.0318681318681,56,1169.34956164461,-1.40520926623059
20326,523427.541,5317555.876,167,96,71,51.923,1,2016,2,103,323,186,0.839713862826561,-39.8,20.9813186813187,83,1169.34956164461,-1.40520926623059
20326,523427.541,5317555.876,142,108,34,32.21,0,2017,1,112,311,162,0.79072622242451,-77.9,22.0516483516484,50,1169.34956164461,-1.40520926623059
20326,523427.541,5317555.876,155,74,81,53.804,0,2018,2,91,318,170,0.766901667287534,-139.3,22.7065934065934,79,1169.34956164461,-1.40520926623059
20326,523427.541,5317555.876,0,0,0,34.21,0,2019,0,114,330,160,0.762295273075388,-118.9,22.7472527472527,46,1169.34956164461,-1.40520926623059
20326,523427.541,5317555.876,93,93,0,31.468,0,2020,1,102,308,169,0.779975467821454,-119,21.1252747252747,67,1169.34956164461,-1.40520926623059
20420,523659.198,5346512.921,0,0,0,56.864,0,2001,2,97,293,208,0.84578655310831,118,17.3307692307692,111,1260.15868180468,1.13163857308889
20420,523659.198,5346512.921,93,67,26,25.772,0,2002,3,124,309,250,0.797488962142998,53.4,17.5120879120879,126,1260.15868180468,1.13163857308889
20420,523659.198,5346512.921,168,61,107,30.761,0,2003,3,117,291,186,0.85817992953932,-198.1,22.256043956044,69,1260.15868180468,1.13163857308889
20420,523659.198,5346512.921,168,28,140,21.802,0,2004,3,129,328,210,0.855793587870428,210.8,17.0318681318681,81,1260.15868180468,1.13163857308889
20420,523659.198,5346512.921,160,93,67,28.707,0,2005,2,125,310,184,0.860828279126145,45.7,17.2395604395604,59,1260.15868180468,1.13163857308889
20420,523659.198,5346512.921,195,65,130,24.668,1,2006,4,129,335,193,0.84442154991947,93.4,18.2021978021978,64,1260.15868180468,1.13163857308889
20420,523659.198,5346512.921,0,0,0,36.683,0,2007,0,107,293,186,0.858583802988813,334.9,16.4472527472527,79,1260.15868180468,1.13163857308889
20420,523659.198,5346512.921,175,58,117,6.131,0,2008,3,145,292,224,0.856772561019012,51.4,16.9230769230769,79,1260.15868180468,1.13163857308889
20420,523659.198,5346512.921,186,51,135,22.238,0,2009,3,124,283,178,0.867734421985197,56.1,17.7604395604396,54,1260.15868180468,1.13163857308889
20420,523659.198,5346512.921,173,102,71,26.499,0,2010,2,120,294,209,0.868038982468828,134.3,17.6802197802198,89,1260.15868180468,1.13163857308889
20420,523659.198,5346512.921,93,62,31,28.831,0,2011,3,105,322,193,0.829067799872649,136.8,16.9703296703297,88,1260.15868180468,1.13163857308889
20420,523659.198,5346512.921,163,93,70,27.873,0,2012,2,124,307,185,0.852005017547092,90.5,18.343956043956,61,1260.15868180468,1.13163857308889
20420,523659.198,5346512.921,177,62,115,22.374,1,2013,3,132,306,224,0.870894113098492,-155.5,18.543956043956,92,1260.15868180468,1.13163857308889
20420,523659.198,5346512.921,152,48,104,31.269,0,2014,3,113,336,185,0.833392345818218,192.7,17.3769230769231,72,1260.15868180468,1.13163857308889
20420,523659.198,5346512.921,176,93,83,24.707,0,2015,2,125,340,201,0.868524070962842,-153.6,20.3384615384615,76,1260.15868180468,1.13163857308889
20420,523659.198,5346512.921,167,96,71,23.86,0,2016,1,130,344,185,0.845129086256414,52.4,18.4901098901099,55,1260.15868180468,1.13163857308889
20420,523659.198,5346512.921,150,100,50,30.85,3,2017,2,116,299,216,0.845678786511343,-1.7,19.1,100,1260.15868180468,1.13163857308889
20420,523659.198,5346512.921,179,46,133,30.526,0,2018,3,115,302,232,0.836139826898553,-150.7,19.8846153846154,117,1260.15868180468,1.13163857308889
20420,523659.198,5346512.921,172,93,79,20.724,0,2019,2,130,297,186,0.810629468218156,-73,20.0010989010989,56,1260.15868180468,1.13163857308889
20420,523659.198,5346512.921,0,0,0,29.59,0,2020,0,106,327,241,0.813184303942964,-12.8,18.3098901098901,135,1260.15868180468,1.13163857308889
20421,523659.198,5346281.264,0,0,0,52.251,0,2001,2,101,306,210,0.810481559135777,118,17.3307692307692,109,1262.63485764094,1.43951501711479
20421,523659.198,5346281.264,93,70,23,38.343,0,2002,3,109,312,249,0.794081458782443,53.4,17.5120879120879,140,1262.63485764094,1.43951501711479
20421,523659.198,5346281.264,174,62,112,28.32,0,2003,2,120,291,185,0.846675335391684,-198.1,22.256043956044,65,1262.63485764094,1.43951501711479
20421,523659.198,5346281.264,167,27,140,23.575,0,2004,3,127,332,216,0.838079343203027,210.8,17.0318681318681,89,1262.63485764094,1.43951501711479
20421,523659.198,5346281.264,158,93,65,30.654,0,2005,2,123,312,185,0.826518566364572,45.7,17.2395604395604,62,1262.63485764094,1.43951501711479
20421,523659.198,5346281.264,195,65,130,24.668,1,2006,4,129,338,201,0.831560210634007,93.4,18.2021978021978,72,1262.63485764094,1.43951501711479
20421,523659.198,5346281.264,93,93,0,46.935,0,2007,2,95,297,216,0.847153500434122,334.9,16.4472527472527,121,1262.63485764094,1.43951501711479
20421,523659.198,5346281.264,175,59,116,18.001,0,2008,3,128,302,232,0.840734288109132,51.4,16.9230769230769,104,1262.63485764094,1.43951501711479
20421,523659.198,5346281.264,179,53,126,27.978,0,2009,3,117,290,193,0.861141784443314,56.1,17.7604395604396,76,1262.63485764094,1.43951501711479
20421,523659.198,5346281.264,176,126,50,29.48,0,2010,1,116,306,209,0.851517628002588,134.3,17.6802197802198,93,1262.63485764094,1.43951501711479
20421,523659.198,5346281.264,96,64,32,36.08,1,2011,3,96,323,208,0.803667283532368,136.8,16.9703296703297,112,1262.63485764094,1.43951501711479
20421,523659.198,5346281.264,162,93,69,29.877,0,2012,2,122,310,185,0.836474027194828,90.5,18.343956043956,63,1262.63485764094,1.43951501711479
20421,523659.198,5346281.264,171,62,109,35.869,1,2013,3,119,300,209,0.855663660757881,-155.5,18.543956043956,90,1262.63485764094,1.43951501711479
20421,523659.198,5346281.264,157,45,112,38.172,3,2014,3,102,339,185,0.825862212441704,192.7,17.3769230769231,83,1262.63485764094,1.43951501711479
20421,523659.198,5346281.264,174,93,81,34.296,0,2015,2,115,340,201,0.844293802589449,-153.6,20.3384615384615,86,1262.63485764094,1.43951501711479
20421,523659.198,5346281.264,165,95,70,28.889,0,2016,2,125,346,185,0.820833931033108,52.4,18.4901098901099,60,1262.63485764094,1.43951501711479
20421,523659.198,5346281.264,151,93,58,38.872,7,2017,2,105,302,194,0.826712914825529,-1.7,19.1,89,1262.63485764094,1.43951501711479
20421,523659.198,5346281.264,180,47,133,33.854,0,2018,3,111,305,201,0.830892235768317,-150.7,19.8846153846154,90,1262.63485764094,1.43951501711479
20421,523659.198,5346281.264,165,93,72,36.444,4,2019,2,112,303,185,0.81257056195862,-73,20.0010989010989,73,1262.63485764094,1.43951501711479
20421,523659.198,5346281.264,95,94,1,36.054,3,2020,2,97,336,217,0.812259169192911,-12.8,18.3098901098901,120,1262.63485764094,1.43951501711479
20424,523659.198,5345586.295,0,0,0,141.582,0,2001,2,23,334,225,0.83304546410041,118,17.3307692307692,202,1078.57553801657,-0.559027336010769
20424,523659.198,5345586.295,139,82,57,55.569,5,2002,2,89,313,162,0.83459218363789,53.4,17.5120879120879,73,1078.57553801657,-0.559027336010769
20424,523659.198,5345586.295,149,100,49,53.372,11,2003,1,92,340,145,0.804116124105926,-198.1,22.256043956044,53,1078.57553801657,-0.559027336010769
20424,523659.198,5345586.295,177,93,84,49.7,3,2004,2,99,338,273,0.881825099934056,210.8,17.0318681318681,174,1078.57553801657,-0.559027336010769
20424,523659.198,5345586.295,144,139,5,72.642,2,2005,1,85,316,146,0.849525554659369,45.7,17.2395604395604,61,1078.57553801657,-0.559027336010769
20424,523659.198,5345586.295,161,64,97,39.178,2,2006,2,114,346,178,0.86129521677821,93.4,18.2021978021978,64,1078.57553801657,-0.559027336010769
20424,523659.198,5345586.295,0,0,0,104.869,0,2007,0,42,312,153,0.848637680415867,334.9,16.4472527472527,111,1078.57553801657,-0.559027336010769
20424,523659.198,5345586.295,86,67,19,53.355,6,2008,1,95,321,176,0.862784653889705,51.4,16.9230769230769,81,1078.57553801657,-0.559027336010769
20424,523659.198,5345586.295,172,77,95,36.292,0,2009,2,108,307,169,0.891117942546564,56.1,17.7604395604396,61,1078.57553801657,-0.559027336010769
20424,523659.198,5345586.295,154,93,61,57.276,7,2010,1,90,323,177,0.847845565743298,134.3,17.6802197802198,87,1078.57553801657,-0.559027336010769
20424,523659.198,5345586.295,0,0,0,57.947,0,2011,0,71,327,192,0.843546189190056,136.8,16.9703296703297,121,1078.57553801657,-0.559027336010769
20424,523659.198,5345586.295,146,96,50,59.98,4,2012,2,88,318,216,0.842516974447683,90.5,18.343956043956,128,1078.57553801657,-0.559027336010769
20424,523659.198,5345586.295,159,93,66,57.14,1,2013,1,100,309,178,0.86323642549028,-155.5,18.543956043956,78,1078.57553801657,-0.559027336010769
20424,523659.198,5345586.295,0,0,0,112.812,0,2014,0,22,349,249,0.858068678048312,192.7,17.3769230769231,227,1078.57553801657,-0.559027336010769
20424,523659.198,5345586.295,145,94,51,59.106,7,2015,1,90,348,169,0.838988870226109,-153.6,20.3384615384615,79,1078.57553801657,-0.559027336010769
20424,523659.198,5345586.295,168,93,75,57.344,8,2016,2,98,346,193,0.872547048789733,52.4,18.4901098901099,95,1078.57553801657,-0.559027336010769
20424,523659.198,5345586.295,96,93,3,87.002,13,2017,2,57,306,201,0.849283706346842,-1.7,19.1,144,1078.57553801657,-0.559027336010769
20424,523659.198,5345586.295,162,77,85,50.137,0,2018,2,95,324,153,0.863075421605457,-150.7,19.8846153846154,58,1078.57553801657,-0.559027336010769
20424,523659.198,5345586.295,138,81,57,55.917,11,2019,3,90,322,273,0.797036922684058,-73,20.0010989010989,183,1078.57553801657,-0.559027336010769
20424,523659.198,5345586.295,0,0,0,63.675,0,2020,0,69,331,170,0.839779302866584,-12.8,18.3098901098901,101,1078.57553801657,-0.559027336010769
20475,523659.198,5333771.821,86,82,4,50.525,9,2001,2,103,300,185,0.861992734867243,103.5,18.1120879120879,82,1180.26910810832,-0.526325875047188
20475,523659.198,5333771.821,86,73,13,23.03,0,2002,1,127,305,241,0.851456175912291,46.4,18.2428571428571,114,1180.26910810832,-0.526325875047188
20475,523659.198,5333771.821,165,118,47,38.54,1,2003,1,108,299,161,0.844742252403266,-203.8,22.9692307692308,53,1180.26910810832,-0.526325875047188
20475,523659.198,5333771.821,154,107,47,28.399,0,2004,1,122,323,170,0.842609910516292,196.1,17.7461538461538,48,1180.26910810832,-0.526325875047188
20475,523659.198,5333771.821,146,97,49,44.038,0,2005,1,111,305,169,0.844696193186312,38.9,17.9032967032967,58,1180.26910810832,-0.526325875047188
20475,523659.198,5333771.821,184,58,126,43.612,1,2006,2,112,329,178,0.857986075869956,82.6,18.867032967033,66,1180.26910810832,-0.526325875047188
20475,523659.198,5333771.821,168,102,66,38.424,0,2007,1,105,299,160,0.873482978939693,317.9,17.0824175824176,55,1180.26910810832,-0.526325875047188
20475,523659.198,5333771.821,0,0,0,26.701,0,2008,0,119,305,177,0.87129394628711,40.8,17.6131868131868,58,1180.26910810832,-0.526325875047188
20475,523659.198,5333771.821,161,81,80,50.306,0,2009,2,96,311,154,0.853252796360283,41,18.5230769230769,58,1180.26910810832,-0.526325875047188
20475,523659.198,5333771.821,166,75,91,28.975,0,2010,2,119,301,176,0.868905281985074,122,18.3626373626374,57,1180.26910810832,-0.526325875047188
20475,523659.198,5333771.821,96,95,1,34.83,1,2011,1,99,317,154,0.853388932500565,127.1,17.5,55,1180.26910810832,-0.526325875047188
20475,523659.198,5333771.821,160,111,49,34.445,0,2012,1,118,312,177,0.862244588216907,82.8,18.7043956043956,59,1180.26910810832,-0.526325875047188
20475,523659.198,5333771.821,167,96,71,54.68,0,2013,1,104,301,177,0.835345392089358,-163.1,19.2582417582418,73,1180.26910810832,-0.526325875047188
20475,523659.198,5333771.821,151,60,91,37.981,3,2014,2,103,320,161,0.862231273119924,176.9,17.856043956044,58,1180.26910810832,-0.526325875047188
20475,523659.198,5333771.821,157,93,64,40.878,0,2015,1,108,329,162,0.83454174902036,-158.6,20.9142857142857,54,1180.26910810832,-0.526325875047188
20475,523659.198,5333771.821,169,93,76,43.353,6,2016,1,112,324,154,0.917525208616574,45.5,18.8857142857143,42,1180.26910810832,-0.526325875047188
20475,523659.198,5333771.821,0,0,0,35.559,0,2017,0,110,299,168,0.848288495630076,-10.8,19.7879120879121,58,1180.26910810832,-0.526325875047188
20475,523659.198,5333771.821,167,64,103,39.97,0,2018,2,106,301,168,0.793919855659425,-154,20.578021978022,62,1180.26910810832,-0.526325875047188
20475,523659.198,5333771.821,163,113,50,33.457,4,2019,1,116,292,162,0.821667873879524,-79.8,20.6626373626374,46,1180.26910810832,-0.526325875047188
20475,523659.198,5333771.821,93,93,0,31.059,3,2020,1,104,300,170,0.804606206052629,-19.2,19.0648351648352,66,1180.26910810832,-0.526325875047188
20480,523659.198,5332613.539,86,85,1,42.576,4,2001,2,110,297,185,0.873344656370575,103.5,18.1120879120879,75,1192.11123165999,-1.30189324455333
20480,523659.198,5332613.539,158,50,108,28.013,0,2002,3,122,294,233,0.854374693184083,46.4,18.2428571428571,111,1192.11123165999,-1.30189324455333
20480,523659.198,5332613.539,164,57,107,31.737,0,2003,2,116,300,161,0.794594282414051,-203.8,22.9692307692308,45,1192.11123165999,-1.30189324455333
20480,523659.198,5332613.539,168,32,136,22.146,0,2004,3,129,325,240,0.802329002822613,196.1,17.7461538461538,111,1192.11123165999,-1.30189324455333
20480,523659.198,5332613.539,155,93,62,41.8,0,2005,1,113,303,177,0.869240826347457,38.9,17.9032967032967,64,1192.11123165999,-1.30189324455333
20480,523659.198,5332613.539,184,83,101,56.553,2,2006,3,102,332,193,0.841132004731492,82.6,18.867032967033,91,1192.11123165999,-1.30189324455333
20480,523659.198,5332613.539,134,95,39,38.424,0,2007,2,105,299,208,0.838100106968069,317.9,17.0824175824176,103,1192.11123165999,-1.30189324455333
20480,523659.198,5332613.539,173,58,115,20.737,0,2008,5,125,302,225,0.871761570042438,40.8,17.6131868131868,100,1192.11123165999,-1.30189324455333
20480,523659.198,5332613.539,174,65,109,51.564,0,2009,2,95,300,176,0.913274802332935,41,18.5230769230769,81,1192.11123165999,-1.30189324455333
20480,523659.198,5332613.539,180,65,115,25.687,0,2010,3,123,305,209,0.893476866705544,122,18.3626373626374,86,1192.11123165999,-1.30189324455333
20480,523659.198,5332613.539,149,69,80,35.725,1,2011,2,98,317,176,0.855764457137775,127.1,17.5,78,1192.11123165999,-1.30189324455333
20480,523659.198,5332613.539,167,93,74,23.266,0,2012,1,129,313,177,0.914781597853575,82.8,18.7043956043956,48,1192.11123165999,-1.30189324455333
20480,523659.198,5332613.539,179,96,83,23.773,0,2013,2,131,303,186,0.86705536799363,-163.1,19.2582417582418,55,1192.11123165999,-1.30189324455333
20480,523659.198,5332613.539,160,57,103,36.632,3,2014,2,105,315,169,0.860672259674591,176.9,17.856043956044,64,1192.11123165999,-1.30189324455333
20480,523659.198,5332613.539,161,78,83,38.159,0,2015,2,111,320,170,0.876207673299924,-158.6,20.9142857142857,59,1192.11123165999,-1.30189324455333
20480,523659.198,5332613.539,171,102,69,38.05,4,2016,1,117,328,177,0.89234846823147,45.5,18.8857142857143,60,1192.11123165999,-1.30189324455333
20480,523659.198,5332613.539,138,93,45,30.32,2,2017,2,117,307,201,0.848079249836457,-10.8,19.7879120879121,84,1192.11123165999,-1.30189324455333
20480,523659.198,5332613.539,175,63,112,34.908,0,2018,2,111,303,177,0.859294342938265,-154,20.578021978022,66,1192.11123165999,-1.30189324455333
20480,523659.198,5332613.539,171,93,78,39.333,4,2019,1,109,315,168,0.827415088027186,-79.8,20.6626373626374,59,1192.11123165999,-1.30189324455333
20480,523659.198,5332613.539,0,0,0,27.747,0,2020,0,109,306,200,0.775574205846897,-19.2,19.0648351648352,91,1192.11123165999,-1.30189324455333
20481,523659.198,5332381.883,86,85,1,39.272,1,2001,2,113,298,178,0.842719521136348,103.5,18.1120879120879,65,1217.07448221697,0.248639097667138
20481,523659.198,5332381.883,159,49,110,21.06,0,2002,3,129,294,240,0.828946298938036,46.4,18.2428571428571,111,1217.07448221697,0.248639097667138
20481,523659.198,5332381.883,161,56,105,35.12,0,2003,2,112,285,154,0.789539142678122,-203.8,22.9692307692308,42,1217.07448221697,0.248639097667138
20481,523659.198,5332381.883,167,28,139,23.99,0,2004,3,127,328,234,0.801022591212706,196.1,17.7461538461538,107,1217.07448221697,0.248639097667138
20481,523659.198,5332381.883,156,93,63,41.8,0,2005,1,113,311,177,0.861693831268821,38.9,17.9032967032967,64,1217.07448221697,0.248639097667138
20481,523659.198,5332381.883,181,93,88,71.413,7,2006,1,91,336,153,0.840897842421994,82.6,18.867032967033,62,1217.07448221697,0.248639097667138
20481,523659.198,5332381.883,134,95,39,37.648,0,2007,2,106,292,209,0.824134387056325,317.9,17.0824175824176,103,1217.07448221697,0.248639097667138
20481,523659.198,5332381.883,181,54,127,17.249,0,2008,3,129,301,225,0.85399278670288,40.8,17.6131868131868,96,1217.07448221697,0.248639097667138
20481,523659.198,5332381.883,175,64,111,50.306,0,2009,2,96,290,169,0.903476874464036,41,18.5230769230769,73,1217.07448221697,0.248639097667138
20481,523659.198,5332381.883,178,62,116,26.507,0,2010,3,122,307,210,0.864196609796265,122,18.3626373626374,88,1217.07448221697,0.248639097667138
20481,523659.198,5332381.883,148,70,78,36.643,1,2011,2,97,317,169,0.839874697509478,127.1,17.5,72,1217.07448221697,0.248639097667138
20481,523659.198,5332381.883,167,120,47,20.278,0,2012,1,132,314,177,0.895900352871175,82.8,18.7043956043956,45,1217.07448221697,0.248639097667138
20481,523659.198,5332381.883,181,108,73,23.773,0,2013,1,131,303,186,0.85484251705809,-163.1,19.2582417582418,55,1217.07448221697,0.248639097667138
20481,523659.198,5332381.883,164,57,107,34.042,1,2014,2,109,311,168,0.83476859172709,176.9,17.856043956044,59,1217.07448221697,0.248639097667138
20481,523659.198,5332381.883,159,76,83,39.952,0,2015,2,109,319,162,0.863256087214347,-158.6,20.9142857142857,53,1217.07448221697,0.248639097667138
20481,523659.198,5332381.883,173,111,62,35.915,2,2016,1,119,323,177,0.919294395313765,45.5,18.8857142857143,58,1217.07448221697,0.248639097667138
20481,523659.198,5332381.883,134,94,40,28.745,0,2017,2,119,306,241,0.849884647078247,-10.8,19.7879120879121,122,1217.07448221697,0.248639097667138
20481,523659.198,5332381.883,175,62,113,37.829,0,2018,3,108,311,185,0.828803355156516,-154,20.578021978022,77,1217.07448221697,0.248639097667138
20481,523659.198,5332381.883,175,93,82,29.899,4,2019,1,120,311,169,0.829030716586105,-79.8,20.6626373626374,49,1217.07448221697,0.248639097667138
20481,523659.198,5332381.883,0,0,0,27.122,0,2020,0,110,306,184,0.791535968559398,-19.2,19.0648351648352,74,1217.07448221697,0.248639097667138
20488,523659.198,5330760.288,106,83,23,48.234,7,2001,3,105,294,176,0.861005040705889,103.5,18.1120879120879,71,1177.094863573,-1.16993158984095
20488,523659.198,5330760.288,93,51,42,35.766,0,2002,3,113,294,241,0.883074277274755,46.4,18.2428571428571,128,1177.094863573,-1.16993158984095
20488,523659.198,5330760.288,163,112,51,35.12,0,2003,1,112,299,161,0.886294762896771,-203.8,22.9692307692308,49,1177.094863573,-1.16993158984095
20488,523659.198,5330760.288,172,66,106,35.791,0,2004,3,114,332,225,0.874271914497507,196.1,17.7461538461538,111,1177.094863573,-1.16993158984095
20488,523659.198,5330760.288,160,118,42,47.472,0,2005,1,108,311,161,0.89310097712085,38.9,17.9032967032967,53,1177.094863573,-1.16993158984095
20488,523659.198,5330760.288,185,67,118,39.986,1,2006,2,115,323,169,0.857262859085435,82.6,18.867032967033,54,1177.094863573,-1.16993158984095
20488,523659.198,5330760.288,86,78,8,51.423,2,2007,1,91,299,240,0.869089616562153,317.9,17.0824175824176,149,1177.094863573,-1.16993158984095
20488,523659.198,5330760.288,95,52,43,28.874,0,2008,2,117,309,177,0.887483601688968,40.8,17.6131868131868,60,1177.094863573,-1.16993158984095
20488,523659.198,5330760.288,179,62,117,43.036,0,2009,2,102,310,152,0.863157869858072,41,18.5230769230769,50,1177.094863573,-1.16993158984095
20488,523659.198,5330760.288,165,93,72,31.615,0,2010,1,116,305,169,0.88992457478928,122,18.3626373626374,53,1177.094863573,-1.16993158984095
20488,523659.198,5330760.288,126,79,47,35.725,1,2011,2,98,321,170,0.858707801691332,127.1,17.5,72,1177.094863573,-1.16993158984095
20488,523659.198,5330760.288,163,93,70,30.335,0,2012,1,122,308,178,0.889318188552503,82.8,18.7043956043956,56,1177.094863573,-1.16993158984095
20488,523659.198,5330760.288,169,93,76,30.119,0,2013,2,125,302,185,0.902298362084152,-163.1,19.2582417582418,60,1177.094863573,-1.16993158984095
20488,523659.198,5330760.288,150,46,104,41.568,3,2014,2,98,332,161,0.843308848080838,176.9,17.856043956044,63,1177.094863573,-1.16993158984095
20488,523659.198,5330760.288,163,93,70,40.878,0,2015,1,108,338,154,0.890935316518218,-158.6,20.9142857142857,46,1177.094863573,-1.16993158984095
20488,523659.198,5330760.288,168,93,75,46.858,6,2016,1,109,334,169,0.880182249207918,45.5,18.8857142857143,60,1177.094863573,-1.16993158984095
20488,523659.198,5330760.288,153,96,57,36.335,6,2017,2,109,293,209,0.893262426670789,-10.8,19.7879120879121,100,1177.094863573,-1.16993158984095
20488,523659.198,5330760.288,164,51,113,39.97,0,2018,3,106,325,249,0.826947873072159,-154,20.578021978022,143,1177.094863573,-1.16993158984095
20488,523659.198,5330760.288,168,103,65,32.593,4,2019,1,117,324,168,0.871679042934388,-79.8,20.6626373626374,51,1177.094863573,-1.16993158984095
20488,523659.198,5330760.288,133,93,40,30.369,3,2020,1,105,311,170,0.843377370490091,-19.2,19.0648351648352,65,1177.094863573,-1.16993158984095
20489,523659.198,5330528.632,106,83,23,41.461,3,2001,3,111,296,170,0.865175394924367,103.5,18.1120879120879,59,1179.83113390678,-1.04334533351216
20489,523659.198,5330528.632,86,49,37,40.238,0,2002,1,108,299,249,0.866800233110163,46.4,18.2428571428571,141,1179.83113390678,-1.04334533351216
20489,523659.198,5330528.632,160,84,76,38.54,1,2003,2,108,301,161,0.835214410930274,-203.8,22.9692307692308,53,1179.83113390678,-1.04334533351216
20489,523659.198,5330528.632,175,66,109,39.911,0,2004,3,110,336,232,0.85399848850446,196.1,17.7461538461538,122,1179.83113390678,-1.04334533351216
20489,523659.198,5330528.632,154,93,61,53.016,0,2005,1,103,314,161,0.875874010298419,38.9,17.9032967032967,58,1179.83113390678,-1.04334533351216
20489,523659.198,5330528.632,190,67,123,34.152,1,2006,3,120,326,168,0.84416121451039,82.6,18.867032967033,48,1179.83113390678,-1.04334533351216
20489,523659.198,5330528.632,93,78,15,55.656,3,2007,3,87,306,240,0.862905693749284,317.9,17.0824175824176,153,1179.83113390678,-1.04334533351216
20489,523659.198,5330528.632,95,54,41,26.701,0,2008,2,119,312,170,0.866054565066978,40.8,17.6131868131868,51,1179.83113390678,-1.04334533351216
20489,523659.198,5330528.632,175,63,112,61.191,1,2009,2,87,313,161,0.890712390117703,41,18.5230769230769,74,1179.83113390678,-1.04334533351216
20489,523659.198,5330528.632,163,93,70,33.48,0,2010,1,114,312,162,0.872427835771282,122,18.3626373626374,48,1179.83113390678,-1.04334533351216
20489,523659.198,5330528.632,127,79,48,38.555,1,2011,3,95,323,241,0.824238261319514,127.1,17.5,146,1179.83113390678,-1.04334533351216
20489,523659.198,5330528.632,160,93,67,32.347,0,2012,1,120,313,176,0.864080739224837,82.8,18.7043956043956,56,1179.83113390678,-1.04334533351216
20489,523659.198,5330528.632,167,93,74,36.945,0,2013,1,119,296,177,0.871989213571303,-163.1,19.2582417582418,58,1179.83113390678,-1.04334533351216
20489,523659.198,5330528.632,150,42,108,46.172,3,2014,2,92,338,154,0.84392543268334,176.9,17.856043956044,62,1179.83113390678,-1.04334533351216
20489,523659.198,5330528.632,162,96,66,46.483,0,2015,1,102,333,153,0.852287117962145,-158.6,20.9142857142857,51,1179.83113390678,-1.04334533351216
20489,523659.198,5330528.632,172,129,43,46.858,6,2016,1,109,324,162,0.869639978393077,45.5,18.8857142857143,53,1179.83113390678,-1.04334533351216
20489,523659.198,5330528.632,155,104,51,38.645,7,2017,2,106,294,232,0.840633577238937,-10.8,19.7879120879121,126,1179.83113390678,-1.04334533351216
20489,523659.198,5330528.632,165,51,114,44.447,0,2018,2,102,331,162,0.799474152020204,-154,20.578021978022,60,1179.83113390678,-1.04334533351216
20489,523659.198,5330528.632,170,129,41,36.738,4,2019,1,112,331,160,0.837833385709998,-79.8,20.6626373626374,48,1179.83113390678,-1.04334533351216
20489,523659.198,5330528.632,129,93,36,31.059,3,2020,1,104,312,170,0.807024337546091,-19.2,19.0648351648352,66,1179.83113390678,-1.04334533351216
20490,523659.198,5330296.975,105,86,19,49.362,8,2001,4,104,296,185,0.830477009596673,103.5,18.1120879120879,81,1152.02497356951,-1.23772862857489
20490,523659.198,5330296.975,93,50,43,41.14,0,2002,2,107,299,162,0.804949400389715,46.4,18.2428571428571,55,1152.02497356951,-1.23772862857489
20490,523659.198,5330296.975,163,59,104,44.182,1,2003,2,102,320,153,0.791746672586293,-203.8,22.9692307692308,51,1152.02497356951,-1.23772862857489
20490,523659.198,5330296.975,170,93,77,43.061,0,2004,2,107,334,241,0.792428563033945,196.1,17.7461538461538,134,1152.02497356951,-1.23772862857489
20490,523659.198,5330296.975,157,120,37,55.388,0,2005,1,101,312,161,0.850191678932417,38.9,17.9032967032967,60,1152.02497356951,-1.23772862857489
20490,523659.198,5330296.975,188,65,123,62.959,5,2006,3,97,326,272,0.838635290549808,82.6,18.867032967033,175,1152.02497356951,-1.23772862857489
20490,523659.198,5330296.975,166,77,89,51.423,2,2007,3,91,304,241,0.81120385192083,317.9,17.0824175824176,150,1152.02497356951,-1.23772862857489
20490,523659.198,5330296.975,172,55,117,39.294,1,2008,3,108,312,242,0.832696413496908,40.8,17.6131868131868,134,1152.02497356951,-1.23772862857489
20490,523659.198,5330296.975,178,98,80,55.216,0,2009,1,92,301,160,0.85812652302101,41,18.5230769230769,68,1152.02497356951,-1.23772862857489
20490,523659.198,5330296.975,170,55,115,28.975,0,2010,2,119,313,170,0.840046045662225,122,18.3626373626374,51,1152.02497356951,-1.23772862857489
20490,523659.198,5330296.975,126,79,47,40.497,1,2011,3,93,324,256,0.794364907687838,127.1,17.5,163,1152.02497356951,-1.23772862857489
20490,523659.198,5330296.975,152,93,59,52.075,3,2012,1,99,322,169,0.877726169142595,82.8,18.7043956043956,70,1152.02497356951,-1.23772862857489
20490,523659.198,5330296.975,171,97,74,39.259,0,2013,1,117,299,177,0.825585765397777,-163.1,19.2582417582418,60,1152.02497356951,-1.23772862857489
20490,523659.198,5330296.975,157,44,113,46.172,3,2014,2,92,335,168,0.82178335180394,176.9,17.856043956044,76,1152.02497356951,-1.23772862857489
20490,523659.198,5330296.975,163,93,70,43.592,0,2015,1,105,335,153,0.82933548577157,-158.6,20.9142857142857,48,1152.02497356951,-1.23772862857489
20490,523659.198,5330296.975,168,99,69,50.334,6,2016,1,106,328,176,0.867033221739526,45.5,18.8857142857143,70,1152.02497356951,-1.23772862857489
20490,523659.198,5330296.975,155,94,61,41.583,7,2017,2,102,304,233,0.771411856412518,-10.8,19.7879120879121,131,1152.02497356951,-1.23772862857489
20490,523659.198,5330296.975,159,60,99,54.009,1,2018,2,94,334,153,0.881472659010901,-154,20.578021978022,59,1152.02497356951,-1.23772862857489
20490,523659.198,5330296.975,167,106,61,34.292,4,2019,1,115,331,160,0.810977790838379,-79.8,20.6626373626374,45,1152.02497356951,-1.23772862857489
20490,523659.198,5330296.975,130,93,37,29.692,2,2020,1,106,312,169,0.776934572630596,-19.2,19.0648351648352,63,1152.02497356951,-1.23772862857489
20491,523659.198,5330065.319,100,93,7,47.102,6,2001,3,106,296,176,0.872377538107102,103.5,18.1120879120879,70,1111.7986492654,-1.22709764426841
20491,523659.198,5330065.319,93,52,41,42.942,1,2002,3,105,296,240,0.842404676921053,46.4,18.2428571428571,135,1111.7986492654,-1.22709764426841
20491,523659.198,5330065.319,164,59,105,40.336,1,2003,2,106,329,161,0.838499231825314,-203.8,22.9692307692308,55,1111.7986492654,-1.22709764426841
20491,523659.198,5330065.319,177,93,84,36.795,0,2004,1,113,334,176,0.824327371345942,196.1,17.7461538461538,63,1111.7986492654,-1.22709764426841
20491,523659.198,5330065.319,156,115,41,56.627,1,2005,1,100,311,161,0.864697852052827,38.9,17.9032967032967,61,1111.7986492654,-1.22709764426841
20491,523659.198,5330065.319,193,66,127,39.986,1,2006,2,115,326,162,0.828816082868087,82.6,18.867032967033,47,1111.7986492654,-1.22709764426841
20491,523659.198,5330065.319,164,77,87,52.484,3,2007,2,90,302,234,0.815476972198198,317.9,17.0824175824176,144,1111.7986492654,-1.22709764426841
20491,523659.198,5330065.319,169,55,114,39.294,1,2008,3,108,310,233,0.853601265448783,40.8,17.6131868131868,125,1111.7986492654,-1.22709764426841
20491,523659.198,5330065.319,183,93,90,39.629,0,2009,1,105,299,161,0.886582466861426,41,18.5230769230769,56,1111.7986492654,-1.22709764426841
20491,523659.198,5330065.319,173,55,118,29.831,0,2010,3,118,311,185,0.849889893692708,122,18.3626373626374,67,1111.7986492654,-1.22709764426841
20491,523659.198,5330065.319,126,79,47,41.468,1,2011,3,92,322,257,0.830772963078308,127.1,17.5,165,1111.7986492654,-1.22709764426841
20491,523659.198,5330065.319,153,100,53,56.239,3,2012,2,94,320,192,0.848529479862309,82.8,18.7043956043956,98,1111.7986492654,-1.22709764426841
20491,523659.198,5330065.319,176,93,83,30.119,0,2013,1,125,305,177,0.831505424814457,-163.1,19.2582417582418,52,1111.7986492654,-1.22709764426841
20491,523659.198,5330065.319,155,47,108,48.638,3,2014,3,89,332,185,0.820717330772195,176.9,17.856043956044,96,1111.7986492654,-1.22709764426841
20491,523659.198,5330065.319,164,101,63,44.529,0,2015,1,104,340,169,0.837334987521174,-158.6,20.9142857142857,65,1111.7986492654,-1.22709764426841
20491,523659.198,5330065.319,168,99,69,54.446,6,2016,1,102,333,177,0.868704389542766,45.5,18.8857142857143,75,1111.7986492654,-1.22709764426841
20491,523659.198,5330065.319,157,94,63,39.373,7,2017,1,105,304,170,0.837927064106273,-10.8,19.7879120879121,65,1111.7986492654,-1.22709764426841
20491,523659.198,5330065.319,164,60,104,42.191,0,2018,2,104,344,160,0.855552845679052,-154,20.578021978022,56,1111.7986492654,-1.22709764426841
20491,523659.198,5330065.319,166,93,73,34.292,4,2019,1,115,332,161,0.844459358972946,-79.8,20.6626373626374,46,1111.7986492654,-1.22709764426841
20491,523659.198,5330065.319,129,93,36,33.963,3,2020,2,100,313,200,0.798881439184123,-19.2,19.0648351648352,100,1111.7986492654,-1.22709764426841
20496,523659.198,5328907.037,86,86,0,29.356,0,2001,2,122,292,193,0.821890968231167,103.5,18.1120879120879,71,1201.40698927988,-0.883237152429389
20496,523659.198,5328907.037,93,61,32,32.346,0,2002,3,117,287,209,0.801140300157233,46.4,18.2428571428571,92,1201.40698927988,-0.883237152429389
20496,523659.198,5328907.037,168,58,110,32.562,0,2003,2,115,312,169,0.777326236535105,-203.8,22.9692307692308,54,1201.40698927988,-0.883237152429389
20496,523659.198,5328907.037,177,129,48,26.664,0,2004,1,124,328,208,0.802552711442544,196.1,17.7461538461538,84,1201.40698927988,-0.883237152429389
20496,523659.198,5328907.037,160,93,67,41.8,0,2005,2,113,300,177,0.796828415767251,38.9,17.9032967032967,64,1201.40698927988,-0.883237152429389
20496,523659.198,5328907.037,196,63,133,26.088,0,2006,2,128,335,184,0.771817875453299,82.6,18.867032967033,56,1201.40698927988,-0.883237152429389
20496,523659.198,5328907.037,0,0,0,37.648,0,2007,0,106,303,185,0.769082774107669,317.9,17.0824175824176,79,1201.40698927988,-0.883237152429389
20496,523659.198,5328907.037,133,60,73,17.249,0,2008,3,129,306,193,0.822837196341613,40.8,17.6131868131868,64,1201.40698927988,-0.883237152429389
20496,523659.198,5328907.037,172,101,71,47.816,0,2009,1,98,292,169,0.828408226524821,41,18.5230769230769,71,1201.40698927988,-0.883237152429389
20496,523659.198,5328907.037,169,97,72,24.072,0,2010,2,125,308,193,0.795078855845127,122,18.3626373626374,68,1201.40698927988,-0.883237152429389
20496,523659.198,5328907.037,0,0,0,33.958,0,2011,0,100,320,194,0.781934499189496,127.1,17.5,94,1201.40698927988,-0.883237152429389
20496,523659.198,5328907.037,151,93,58,32.347,0,2012,1,120,308,177,0.817296998766308,82.8,18.7043956043956,57,1201.40698927988,-0.883237152429389
20496,523659.198,5328907.037,176,72,104,32.431,0,2013,2,123,303,185,0.783372372572476,-163.1,19.2582417582418,62,1201.40698927988,-0.883237152429389
20496,523659.198,5328907.037,154,66,88,36.632,3,2014,3,105,330,186,0.74528249415101,176.9,17.856043956044,81,1201.40698927988,-0.883237152429389
20496,523659.198,5328907.037,159,93,66,37.296,0,2015,1,112,325,168,0.772085375870594,-158.6,20.9142857142857,56,1201.40698927988,-0.883237152429389
20496,523659.198,5328907.037,170,96,74,33.772,0,2016,1,121,320,176,0.803434547377049,45.5,18.8857142857143,55,1201.40698927988,-0.883237152429389
20496,523659.198,5328907.037,133,103,30,28.745,0,2017,2,119,305,209,0.767210664289906,-10.8,19.7879120879121,90,1201.40698927988,-0.883237152429389
20496,523659.198,5328907.037,165,70,95,38.886,0,2018,2,107,306,162,0.808069167140295,-154,20.578021978022,55,1201.40698927988,-0.883237152429389
20496,523659.198,5328907.037,152,93,59,32.593,4,2019,1,117,317,170,0.758834675994712,-79.8,20.6626373626374,53,1201.40698927988,-0.883237152429389
20496,523659.198,5328907.037,0,0,0,23.11,0,2020,0,117,303,200,0.732613701625197,-19.2,19.0648351648352,83,1201.40698927988,-0.883237152429389
20544,523659.198,5317787.532,0,0,0,106.371,0,2001,2,56,317,170,0.866206214282041,-26.7,20.3989010989011,114,1086.92803193777,-1.49420129880827
20544,523659.198,5317787.532,86,77,9,43.332,0,2002,1,104,324,170,0.82394965597251,-5.6,20.2901098901099,66,1086.92803193777,-1.49420129880827
20544,523659.198,5317787.532,148,111,37,34.774,0,2003,1,108,317,162,0.835141254782221,-214.1,25.0835164835165,54,1086.92803193777,-1.49420129880827
20544,523659.198,5317787.532,148,106,42,34.944,0,2004,2,113,329,233,0.822848739951715,90.8,19.910989010989,120,1086.92803193777,-1.49420129880827
20544,523659.198,5317787.532,156,109,47,55.677,1,2005,1,98,310,161,0.842946216713743,-56.5,19.9923076923077,63,1086.92803193777,-1.49420129880827
20544,523659.198,5317787.532,178,99,79,44.934,0,2006,1,106,321,168,0.836630339531669,16.2,20.9538461538462,62,1086.92803193777,-1.49420129880827
20544,523659.198,5317787.532,104,78,26,68.26,6,2007,2,73,301,168,0.845187511071534,213,19.1032967032967,95,1086.92803193777,-1.49420129880827
20544,523659.198,5317787.532,93,69,24,35.43,0,2008,3,112,305,186,0.833846303358857,-1.79999999999999,19.6,74,1086.92803193777,-1.49420129880827
20544,523659.198,5317787.532,167,61,106,45.472,0,2009,2,95,304,153,0.847625767363731,-2.8,20.5450549450549,58,1086.92803193777,-1.49420129880827
20544,523659.198,5317787.532,170,104,66,30.589,0,2010,1,114,302,176,0.837892867563414,50.5,20.2241758241758,62,1086.92803193777,-1.49420129880827
20544,523659.198,5317787.532,0,0,0,35.373,0,2011,0,95,320,154,0.805879581527902,90.7,19.4164835164835,59,1086.92803193777,-1.49420129880827
20544,523659.198,5317787.532,149,81,68,45.911,1,2012,2,106,316,168,0.884667258960831,-6,20.743956043956,62,1086.92803193777,-1.49420129880827
20544,523659.198,5317787.532,178,80,98,38.585,0,2013,2,115,300,177,0.835355886326975,-200.2,21.3494505494505,62,1086.92803193777,-1.49420129880827
20544,523659.198,5317787.532,141,58,83,43.216,0,2014,3,93,326,210,0.827835333843177,51.4,19.8307692307692,117,1086.92803193777,-1.49420129880827
20544,523659.198,5317787.532,161,93,68,45.926,0,2015,1,102,328,161,0.870931177242643,-218.4,23.0318681318681,59,1086.92803193777,-1.49420129880827
20544,523659.198,5317787.532,171,124,47,47.88,1,2016,1,107,329,176,0.834741258229203,-39.8,20.9813186813187,69,1086.92803193777,-1.49420129880827
20544,523659.198,5317787.532,143,101,42,32.93,1,2017,1,111,300,161,0.805785494669517,-77.9,22.0516483516484,50,1086.92803193777,-1.49420129880827
20544,523659.198,5317787.532,168,85,83,55.978,0,2018,3,89,329,186,0.774121268355289,-139.3,22.7065934065934,97,1086.92803193777,-1.49420129880827
20544,523659.198,5317787.532,148,93,55,32.488,1,2019,1,116,326,169,0.790567693278025,-118.9,22.7472527472527,53,1086.92803193777,-1.49420129880827
20544,523659.198,5317787.532,0,0,0,32.179,0,2020,0,101,309,168,0.789576625083776,-119,21.1252747252747,67,1086.92803193777,-1.49420129880827
20545,523659.198,5317555.876,0,0,0,84.939,0,2001,2,74,320,169,0.857694365601083,-26.7,20.3989010989011,95,1122.68471021976,-0.256391576036246
20545,523659.198,5317555.876,86,77,9,36.469,0,2002,1,112,321,184,0.8211920071814,-5.6,20.2901098901099,72,1122.68471021976,-0.256391576036246
20545,523659.198,5317555.876,144,93,51,34.774,0,2003,1,108,323,160,0.836146700136761,-214.1,25.0835164835165,52,1122.68471021976,-0.256391576036246
20545,523659.198,5317555.876,151,93,58,34.944,0,2004,1,113,330,162,0.81878433980014,90.8,19.910989010989,49,1122.68471021976,-0.256391576036246
20545,523659.198,5317555.876,156,109,47,54.552,1,2005,1,99,310,161,0.845844643061722,-56.5,19.9923076923077,62,1122.68471021976,-0.256391576036246
20545,523659.198,5317555.876,183,96,87,29.192,0,2006,1,122,321,170,0.816398753670372,16.2,20.9538461538462,48,1122.68471021976,-0.256391576036246
20545,523659.198,5317555.876,108,78,30,46.235,0,2007,2,94,300,176,0.85728293780503,213,19.1032967032967,82,1122.68471021976,-0.256391576036246
20545,523659.198,5317555.876,83,64,19,34.332,0,2008,1,113,304,194,0.841212101736098,-1.79999999999999,19.6,81,1122.68471021976,-0.256391576036246
20545,523659.198,5317555.876,167,61,106,45.472,0,2009,2,95,306,154,0.849156294578616,-2.8,20.5450549450549,59,1122.68471021976,-0.256391576036246
20545,523659.198,5317555.876,170,97,73,26.826,0,2010,1,119,303,178,0.827117282368645,50.5,20.2241758241758,59,1122.68471021976,-0.256391576036246
20545,523659.198,5317555.876,0,0,0,35.373,0,2011,0,95,323,241,0.790016275531437,90.7,19.4164835164835,146,1122.68471021976,-0.256391576036246
20545,523659.198,5317555.876,150,82,68,48.933,1,2012,2,102,315,168,0.882410409435409,-6,20.743956043956,66,1122.68471021976,-0.256391576036246
20545,523659.198,5317555.876,175,79,96,40.462,0,2013,2,113,305,177,0.840674200406246,-200.2,21.3494505494505,64,1122.68471021976,-0.256391576036246
20545,523659.198,5317555.876,139,62,77,43.979,0,2014,3,92,326,233,0.822976490494392,51.4,19.8307692307692,141,1122.68471021976,-0.256391576036246
20545,523659.198,5317555.876,160,93,67,47.931,0,2015,1,100,333,161,0.860445975249467,-218.4,23.0318681318681,61,1122.68471021976,-0.256391576036246
20545,523659.198,5317555.876,173,93,80,46.75,1,2016,2,108,324,177,0.855567062837326,-39.8,20.9813186813187,69,1122.68471021976,-0.256391576036246
20545,523659.198,5317555.876,142,105,37,37.32,3,2017,1,105,299,162,0.799297916154334,-77.9,22.0516483516484,57,1122.68471021976,-0.256391576036246
20545,523659.198,5317555.876,168,85,83,55.978,0,2018,2,89,314,161,0.848677305957815,-139.3,22.7065934065934,72,1122.68471021976,-0.256391576036246
20545,523659.198,5317555.876,151,93,58,35.035,1,2019,1,113,331,162,0.792311722279228,-118.9,22.7472527472527,49,1122.68471021976,-0.256391576036246
20545,523659.198,5317555.876,0,0,0,41.131,0,2020,0,90,310,170,0.790904421048663,-119,21.1252747252747,80,1122.68471021976,-0.256391576036246
20639,523890.854,5346512.921,0,0,0,88.501,0,2001,2,71,297,192,0.840317541839002,118,17.3307692307692,121,1251.60092305556,1.42716515735031
20639,523890.854,5346512.921,93,67,26,33.371,0,2002,3,115,305,242,0.78651236442759,53.4,17.5120879120879,127,1251.60092305556,1.42716515735031
20639,523890.854,5346512.921,175,60,115,29.142,0,2003,2,119,288,178,0.828247948826903,-198.1,22.256043956044,59,1251.60092305556,1.42716515735031
20639,523890.854,5346512.921,167,27,140,22.694,0,2004,3,128,334,202,0.854720325760067,210.8,17.0318681318681,74,1251.60092305556,1.42716515735031
20639,523890.854,5346512.921,158,93,65,37.861,0,2005,2,116,313,185,0.822215447373774,45.7,17.2395604395604,69,1251.60092305556,1.42716515735031
20639,523890.854,5346512.921,191,67,124,31.944,1,2006,3,121,330,200,0.830331331429519,93.4,18.2021978021978,79,1251.60092305556,1.42716515735031
20639,523890.854,5346512.921,93,93,0,45.029,0,2007,1,97,293,177,0.843040383353989,334.9,16.4472527472527,80,1251.60092305556,1.42716515735031
20639,523890.854,5346512.921,175,56,119,18.844,0,2008,3,127,304,217,0.837514661907706,51.4,16.9230769230769,90,1251.60092305556,1.42716515735031
20639,523890.854,5346512.921,183,53,130,26.312,0,2009,2,119,290,178,0.86143139335638,56.1,17.7604395604396,59,1251.60092305556,1.42716515735031
20639,523890.854,5346512.921,176,125,51,27.947,0,2010,1,118,301,200,0.832655875058531,134.3,17.6802197802198,82,1251.60092305556,1.42716515735031
20639,523890.854,5346512.921,95,63,32,32.718,1,2011,2,100,323,177,0.81843353364547,136.8,16.9703296703297,77,1251.60092305556,1.42716515735031
20639,523890.854,5346512.921,166,100,66,38.221,0,2012,1,114,310,185,0.828497203582287,90.5,18.343956043956,71,1251.60092305556,1.42716515735031
20639,523890.854,5346512.921,176,63,113,27.37,1,2013,3,127,305,217,0.852203306855162,-155.5,18.543956043956,90,1251.60092305556,1.42716515735031
20639,523890.854,5346512.921,151,48,103,40.947,3,2014,2,98,341,177,0.80887293906163,192.7,17.3769230769231,79,1251.60092305556,1.42716515735031
20639,523890.854,5346512.921,165,95,70,44.652,0,2015,2,103,345,193,0.821996439973893,-153.6,20.3384615384615,90,1251.60092305556,1.42716515735031
20639,523890.854,5346512.921,171,93,78,25.77,0,2016,1,128,343,177,0.817546734203725,52.4,18.4901098901099,49,1251.60092305556,1.42716515735031
20639,523890.854,5346512.921,152,99,53,37.441,7,2017,2,107,292,193,0.836199073041872,-1.7,19.1,86,1251.60092305556,1.42716515735031
20639,523890.854,5346512.921,181,43,138,30.526,0,2018,3,115,305,185,0.815277931534443,-150.7,19.8846153846154,70,1251.60092305556,1.42716515735031
20639,523890.854,5346512.921,169,93,76,27.111,4,2019,1,123,301,178,0.792413755364327,-73,20.0010989010989,55,1251.60092305556,1.42716515735031
20639,523890.854,5346512.921,0,0,0,30.925,0,2020,0,104,337,201,0.79310700547438,-12.8,18.3098901098901,97,1251.60092305556,1.42716515735031
20640,523890.854,5346281.264,0,0,0,126.181,0,2001,2,37,299,201,0.827302941851119,118,17.3307692307692,164,1223.5380044413,-1.22915937028208
20640,523890.854,5346281.264,93,67,26,43.332,2,2002,3,103,308,249,0.787574196376949,53.4,17.5120879120879,146,1223.5380044413,-1.22915937028208
20640,523890.854,5346281.264,173,63,110,32.364,0,2003,2,115,290,177,0.826035365923931,-198.1,22.256043956044,62,1223.5380044413,-1.22915937028208
20640,523890.854,5346281.264,170,27,143,29.454,0,2004,3,120,335,216,0.836103939451799,210.8,17.0318681318681,96,1223.5380044413,-1.22915937028208
20640,523890.854,5346281.264,160,93,67,58.736,2,2005,2,97,311,186,0.822463483160742,45.7,17.2395604395604,89,1223.5380044413,-1.22915937028208
20640,523890.854,5346281.264,190,64,126,34.972,2,2006,3,118,339,201,0.82789248837645,93.4,18.2021978021978,83,1223.5380044413,-1.22915937028208
20640,523890.854,5346281.264,93,93,0,43.205,0,2007,1,99,299,178,0.837804735857657,334.9,16.4472527472527,79,1223.5380044413,-1.22915937028208
20640,523890.854,5346281.264,174,59,115,29.728,0,2008,2,116,307,169,0.833256284865912,51.4,16.9230769230769,53,1223.5380044413,-1.22915937028208
20640,523890.854,5346281.264,183,53,130,26.312,0,2009,2,119,306,184,0.853596855789243,56.1,17.7604395604396,65,1223.5380044413,-1.22915937028208
20640,523890.854,5346281.264,175,93,82,31.076,0,2010,2,114,301,209,0.827025052504607,134.3,17.6802197802198,95,1223.5380044413,-1.22915937028208
20640,523890.854,5346281.264,84,61,23,38.725,1,2011,1,93,329,193,0.786786195954459,136.8,16.9703296703297,100,1223.5380044413,-1.22915937028208
20640,523890.854,5346281.264,164,99,65,41.083,0,2012,1,111,311,185,0.83439222949383,90.5,18.343956043956,74,1223.5380044413,-1.22915937028208
20640,523890.854,5346281.264,176,61,115,36.934,1,2013,3,118,304,202,0.845871214933374,-155.5,18.543956043956,84,1223.5380044413,-1.22915937028208
20640,523890.854,5346281.264,157,46,111,42.379,3,2014,2,96,341,184,0.81616191349649,192.7,17.3769230769231,88,1223.5380044413,-1.22915937028208
20640,523890.854,5346281.264,174,93,81,34.296,0,2015,2,115,343,192,0.826651462392527,-153.6,20.3384615384615,77,1223.5380044413,-1.22915937028208
20640,523890.854,5346281.264,170,93,77,28.889,0,2016,1,125,343,177,0.807990032769085,52.4,18.4901098901099,52,1223.5380044413,-1.22915937028208
20640,523890.854,5346281.264,150,93,57,39.568,7,2017,2,104,305,194,0.824435372046902,-1.7,19.1,90,1223.5380044413,-1.22915937028208
20640,523890.854,5346281.264,179,47,132,34.723,0,2018,3,110,324,193,0.812880321106362,-150.7,19.8846153846154,83,1223.5380044413,-1.22915937028208
20640,523890.854,5346281.264,168,94,74,33.23,4,2019,2,116,308,185,0.788341122314222,-73,20.0010989010989,69,1223.5380044413,-1.22915937028208
20640,523890.854,5346281.264,0,0,0,36.857,0,2020,0,96,346,200,0.792108317811924,-12.8,18.3098901098901,104,1223.5380044413,-1.22915937028208
20642,523890.854,5345817.951,0,0,0,56.864,0,2001,2,97,335,193,0.814783814303513,118,17.3307692307692,96,1143.6940559086,0.255970674102632
20642,523890.854,5345817.951,93,82,11,49.033,5,2002,3,96,311,256,0.827203633251379,53.4,17.5120879120879,160,1143.6940559086,0.255970674102632
20642,523890.854,5345817.951,163,93,70,48.272,6,2003,1,97,332,177,0.796528684604347,-198.1,22.256043956044,80,1143.6940559086,0.255970674102632
20642,523890.854,5345817.951,155,47,108,45.279,0,2004,3,103,335,210,0.81033192383738,210.8,17.0318681318681,107,1143.6940559086,0.255970674102632
20642,523890.854,5345817.951,0,0,0,128.444,0,2005,0,35,318,250,0.801808497725753,45.7,17.2395604395604,215,1143.6940559086,0.255970674102632
20642,523890.854,5345817.951,178,66,112,42.638,2,2006,3,111,340,242,0.808623610559222,93.4,18.2021978021978,131,1143.6940559086,0.255970674102632
20642,523890.854,5345817.951,0,0,0,133.96,0,2007,0,16,306,162,0.857480765529432,334.9,16.4472527472527,146,1143.6940559086,0.255970674102632
20642,523890.854,5345817.951,170,63,107,35.433,0,2008,2,111,310,177,0.826535464131651,51.4,16.9230769230769,66,1143.6940559086,0.255970674102632
20642,523890.854,5345817.951,177,63,114,33.321,0,2009,2,111,304,170,0.86130335470726,56.1,17.7604395604396,59,1143.6940559086,0.255970674102632
20642,523890.854,5345817.951,165,56,109,40.305,1,2010,3,104,315,249,0.811334206533315,134.3,17.6802197802198,145,1143.6940559086,0.255970674102632
20642,523890.854,5345817.951,86,67,19,56.176,5,2011,1,73,325,249,0.799918238488849,136.8,16.9703296703297,176,1143.6940559086,0.255970674102632
20642,523890.854,5345817.951,160,93,67,52.651,3,2012,1,97,314,177,0.815753834600156,90.5,18.343956043956,80,1143.6940559086,0.255970674102632
20642,523890.854,5345817.951,167,63,104,57.14,1,2013,3,100,309,184,0.829982312139913,-155.5,18.543956043956,84,1143.6940559086,0.255970674102632
20642,523890.854,5345817.951,152,49,103,53.464,8,2014,3,82,345,273,0.797833495801385,192.7,17.3769230769231,191,1143.6940559086,0.255970674102632
20642,523890.854,5345817.951,160,93,67,51.957,2,2015,1,96,346,168,0.808238818893337,-153.6,20.3384615384615,72,1143.6940559086,0.255970674102632
20642,523890.854,5345817.951,168,93,75,54.392,7,2016,2,101,344,193,0.845795616340196,52.4,18.4901098901099,92,1143.6940559086,0.255970674102632
20642,523890.854,5345817.951,133,93,40,61.709,8,2017,2,79,309,208,0.822897010746055,-1.7,19.1,129,1143.6940559086,0.255970674102632
20642,523890.854,5345817.951,168,62,106,47.793,0,2018,2,97,325,177,0.804359977715029,-150.7,19.8846153846154,80,1143.6940559086,0.255970674102632
20642,523890.854,5345817.951,152,80,72,50.692,8,2019,2,96,319,168,0.775238373218677,-73,20.0010989010989,72,1143.6940559086,0.255970674102632
20642,523890.854,5345817.951,0,0,0,61.208,0,2020,0,71,316,170,0.802293687887663,-12.8,18.3098901098901,99,1143.6940559086,0.255970674102632
20695,523890.854,5333540.164,86,84,2,44.831,6,2001,2,108,293,202,0.822619641376929,103.5,18.1120879120879,94,1228.95763792506,1.34633741472209
20695,523890.854,5333540.164,86,58,28,27.076,0,2002,1,123,294,233,0.832304970356074,46.4,18.2428571428571,110,1228.95763792506,1.34633741472209
20695,523890.854,5333540.164,166,61,105,23.81,0,2003,3,125,298,224,0.767763302637364,-203.8,22.9692307692308,99,1228.95763792506,1.34633741472209
20695,523890.854,5333540.164,154,93,61,23.072,0,2004,2,128,304,201,0.843586984246075,196.1,17.7461538461538,73,1228.95763792506,1.34633741472209
20695,523890.854,5333540.164,154,93,61,32.068,0,2005,2,122,302,184,0.843586456624786,38.9,17.9032967032967,62,1228.95763792506,1.34633741472209
20695,523890.854,5333540.164,181,70,111,30.925,0,2006,3,123,320,193,0.840972795683266,82.6,18.867032967033,70,1228.95763792506,1.34633741472209
20695,523890.854,5333540.164,121,96,25,38.424,0,2007,1,105,297,170,0.843260029081181,317.9,17.0824175824176,65,1228.95763792506,1.34633741472209
20695,523890.854,5333540.164,177,69,108,18.079,0,2008,2,128,293,178,0.892904540929053,40.8,17.6131868131868,50,1228.95763792506,1.34633741472209
20695,523890.854,5333540.164,168,64,104,47.816,0,2009,2,98,291,177,0.88950634623865,41,18.5230769230769,79,1228.95763792506,1.34633741472209
20695,523890.854,5333540.164,168,64,104,24.072,0,2010,2,125,293,177,0.849660762292529,122,18.3626373626374,52,1228.95763792506,1.34633741472209
20695,523890.854,5333540.164,130,57,73,30.631,0,2011,2,104,313,162,0.809168150453453,127.1,17.5,58,1228.95763792506,1.34633741472209
20695,523890.854,5333540.164,156,82,74,25.279,0,2012,2,127,295,178,0.862561118530227,82.8,18.7043956043956,51,1228.95763792506,1.34633741472209
20695,523890.854,5333540.164,174,72,102,32.431,0,2013,3,123,295,192,0.848922391050692,-163.1,19.2582417582418,69,1228.95763792506,1.34633741472209
20695,523890.854,5333540.164,153,93,60,32.15,0,2014,1,112,331,177,0.837617071706249,176.9,17.856043956044,65,1228.95763792506,1.34633741472209
20695,523890.854,5333540.164,151,96,55,33.255,0,2015,1,117,298,177,0.816505329018898,-158.6,20.9142857142857,60,1228.95763792506,1.34633741472209
20695,523890.854,5333540.164,178,93,85,28.218,0,2016,3,126,320,200,0.868842710108284,45.5,18.8857142857143,74,1228.95763792506,1.34633741472209
20695,523890.854,5333540.164,141,107,34,28.745,0,2017,2,119,294,225,0.852606326526491,-10.8,19.7879120879121,106,1228.95763792506,1.34633741472209
20695,523890.854,5333540.164,160,66,94,37.829,0,2018,2,108,296,184,0.821086268652589,-154,20.578021978022,76,1228.95763792506,1.34633741472209
20695,523890.854,5333540.164,162,93,69,25.45,3,2019,1,125,295,170,0.835807002920381,-79.8,20.6626373626374,45,1228.95763792506,1.34633741472209
20695,523890.854,5333540.164,93,93,0,23.643,1,2020,2,116,295,201,0.793185221094558,-19.2,19.0648351648352,85,1228.95763792506,1.34633741472209
20700,523890.854,5332381.883,86,85,1,36.006,0,2001,2,116,298,177,0.86713050683677,103.5,18.1120879120879,61,1260.77243391446,-1.46087618402469
20700,523890.854,5332381.883,157,49,108,27.076,0,2002,2,123,293,176,0.844459195005099,46.4,18.2428571428571,53,1260.77243391446,-1.46087618402469
20700,523890.854,5332381.883,168,56,112,31.737,0,2003,3,116,288,154,0.814026591541196,-203.8,22.9692307692308,38,1260.77243391446,-1.46087618402469
20700,523890.854,5332381.883,176,29,147,21.135,0,2004,3,130,328,185,0.836828889223621,196.1,17.7461538461538,55,1260.77243391446,-1.46087618402469
20700,523890.854,5332381.883,158,99,59,36.257,0,2005,1,118,307,177,0.884432574418867,38.9,17.9032967032967,59,1260.77243391446,-1.46087618402469
20700,523890.854,5332381.883,187,93,94,38.802,1,2006,2,116,333,186,0.848597020063893,82.6,18.867032967033,70,1260.77243391446,-1.46087618402469
20700,523890.854,5332381.883,138,94,44,36.897,0,2007,2,107,290,216,0.823601221904676,317.9,17.0824175824176,109,1260.77243391446,-1.46087618402469
20700,523890.854,5332381.883,180,54,126,18.079,0,2008,2,128,302,178,0.88207413712737,40.8,17.6131868131868,50,1260.77243391446,-1.46087618402469
20700,523890.854,5332381.883,181,68,113,35.331,0,2009,3,109,299,240,0.866831058893459,41,18.5230769230769,131,1260.77243391446,-1.46087618402469
20700,523890.854,5332381.883,178,64,114,26.507,0,2010,3,122,308,185,0.884508070397753,122,18.3626373626374,63,1260.77243391446,-1.46087618402469
20700,523890.854,5332381.883,148,71,77,34.83,1,2011,2,99,315,161,0.872190289692712,127.1,17.5,62,1260.77243391446,-1.46087618402469
20700,523890.854,5332381.883,166,93,73,16.427,0,2012,1,136,313,178,0.903320157610313,82.8,18.7043956043956,42,1260.77243391446,-1.46087618402469
20700,523890.854,5332381.883,180,93,87,19.707,0,2013,2,135,301,193,0.879008220402515,-163.1,19.2582417582418,58,1260.77243391446,-1.46087618402469
20700,523890.854,5332381.883,161,55,106,32.15,0,2014,2,112,309,169,0.854138044218891,176.9,17.856043956044,57,1260.77243391446,-1.46087618402469
20700,523890.854,5332381.883,161,76,85,36.458,0,2015,2,113,321,161,0.869437466394469,-158.6,20.9142857142857,48,1260.77243391446,-1.46087618402469
20700,523890.854,5332381.883,175,117,58,30.443,0,2016,1,124,329,177,0.913516676746575,45.5,18.8857142857143,53,1260.77243391446,-1.46087618402469
20700,523890.854,5332381.883,137,97,40,29.541,1,2017,1,118,301,177,0.868172896599914,-10.8,19.7879120879121,59,1260.77243391446,-1.46087618402469
20700,523890.854,5332381.883,176,62,114,34.006,0,2018,3,112,303,234,0.846217906625226,-154,20.578021978022,122,1260.77243391446,-1.46087618402469
20700,523890.854,5332381.883,179,93,86,28.119,4,2019,1,122,298,169,0.86159712400185,-79.8,20.6626373626374,47,1260.77243391446,-1.46087618402469
20700,523890.854,5332381.883,0,0,0,25.318,0,2020,0,113,307,250,0.775705020040649,-19.2,19.0648351648352,137,1260.77243391446,-1.46087618402469
20715,523890.854,5328907.037,86,85,1,32.681,0,2001,2,119,293,192,0.752890177224295,103.5,18.1120879120879,73,1186.00363596759,-1.13596166552769
20715,523890.854,5328907.037,93,60,33,31.469,0,2002,3,118,288,232,0.749679140154992,46.4,18.2428571428571,114,1186.00363596759,-1.13596166552769
20715,523890.854,5328907.037,165,57,108,35.971,0,2003,2,111,298,169,0.748571202772875,-203.8,22.9692307692308,58,1186.00363596759,-1.13596166552769
20715,523890.854,5328907.037,177,128,49,24.906,0,2004,1,126,313,208,0.770523712515303,196.1,17.7461538461538,82,1186.00363596759,-1.13596166552769
20715,523890.854,5328907.037,158,106,52,38.51,0,2005,1,116,302,177,0.721225121033013,38.9,17.9032967032967,61,1186.00363596759,-1.13596166552769
20715,523890.854,5328907.037,194,63,131,30.925,0,2006,2,123,323,178,0.749291216071309,82.6,18.867032967033,55,1186.00363596759,-1.13596166552769
20715,523890.854,5328907.037,93,93,0,48.311,1,2007,1,94,290,169,0.790169895280699,317.9,17.0824175824176,75,1186.00363596759,-1.13596166552769
20715,523890.854,5328907.037,144,53,91,16.445,0,2008,3,130,305,194,0.759171118229578,40.8,17.6131868131868,64,1186.00363596759,-1.13596166552769
20715,523890.854,5328907.037,183,93,90,29.472,0,2009,2,115,296,169,0.825600107482302,41,18.5230769230769,54,1186.00363596759,-1.13596166552769
20715,523890.854,5328907.037,166,93,73,28.148,0,2010,2,120,301,200,0.751244142109743,122,18.3626373626374,80,1186.00363596759,-1.13596166552769
20715,523890.854,5328907.037,0,0,0,29.819,0,2011,0,105,315,192,0.736780150043621,127.1,17.5,87,1186.00363596759,-1.13596166552769
20715,523890.854,5328907.037,150,93,57,34.445,0,2012,1,118,312,177,0.781993703220115,82.8,18.7043956043956,59,1186.00363596759,-1.13596166552769
20715,523890.854,5328907.037,177,72,105,26.848,0,2013,2,128,296,185,0.759635447712803,-163.1,19.2582417582418,57,1186.00363596759,-1.13596166552769
20715,523890.854,5328907.037,154,64,90,36.632,3,2014,3,105,328,184,0.702512967748489,176.9,17.856043956044,79,1186.00363596759,-1.13596166552769
20715,523890.854,5328907.037,159,93,66,38.159,0,2015,1,111,309,168,0.725455832918335,-158.6,20.9142857142857,57,1186.00363596759,-1.13596166552769
20715,523890.854,5328907.037,174,131,43,33.772,0,2016,1,121,311,170,0.791741177178937,45.5,18.8857142857143,49,1186.00363596759,-1.13596166552769
20715,523890.854,5328907.037,135,110,25,29.541,1,2017,2,118,307,217,0.70721233969665,-10.8,19.7879120879121,99,1186.00363596759,-1.13596166552769
20715,523890.854,5328907.037,169,70,99,35.844,0,2018,2,110,303,162,0.793725547708,-154,20.578021978022,52,1186.00363596759,-1.13596166552769
20715,523890.854,5328907.037,156,93,63,25.45,3,2019,1,125,321,176,0.720207543429248,-79.8,20.6626373626374,51,1186.00363596759,-1.13596166552769
20715,523890.854,5328907.037,0,0,0,23.11,0,2020,0,117,305,192,0.684389049304467,-19.2,19.0648351648352,75,1186.00363596759,-1.13596166552769
20716,523890.854,5328675.381,86,85,1,24.188,0,2001,2,127,293,234,0.860505915384557,103.5,18.1120879120879,107,1181.86214674831,-0.154140657969452
20716,523890.854,5328675.381,93,62,31,38.443,0,2002,3,110,293,224,0.829989392314856,46.4,18.2428571428571,114,1181.86214674831,-0.154140657969452
20716,523890.854,5328675.381,163,60,103,38.54,1,2003,2,108,314,170,0.791372679981817,-203.8,22.9692307692308,62,1181.86214674831,-0.154140657969452
20716,523890.854,5328675.381,174,93,81,29.278,0,2004,1,121,316,170,0.820180977700668,196.1,17.7461538461538,49,1181.86214674831,-0.154140657969452
20716,523890.854,5328675.381,152,116,36,46.32,0,2005,1,109,304,162,0.848383669996386,38.9,17.9032967032967,53,1181.86214674831,-0.154140657969452
20716,523890.854,5328675.381,191,65,126,36.445,1,2006,3,118,323,218,0.83106684304723,82.6,18.867032967033,100,1181.86214674831,-0.154140657969452
20716,523890.854,5328675.381,0,0,0,48.311,0,2007,0,94,289,232,0.848973249492238,317.9,17.0824175824176,138,1181.86214674831,-0.154140657969452
20716,523890.854,5328675.381,133,57,76,20.737,0,2008,2,125,308,177,0.866632201021735,40.8,17.6131868131868,52,1181.86214674831,-0.154140657969452
20716,523890.854,5328675.381,173,93,80,38.55,0,2009,1,106,289,162,0.83184377241192,41,18.5230769230769,56,1181.86214674831,-0.154140657969452
20716,523890.854,5328675.381,164,95,69,34.453,0,2010,1,113,310,176,0.850335444228034,122,18.3626373626374,63,1181.86214674831,-0.154140657969452
20716,523890.854,5328675.381,93,93,0,37.588,1,2011,1,96,314,169,0.779856201094025,127.1,17.5,73,1181.86214674831,-0.154140657969452
20716,523890.854,5328675.381,148,93,55,43.577,0,2012,2,109,301,202,0.842142955874021,82.8,18.7043956043956,93,1181.86214674831,-0.154140657969452
20716,523890.854,5328675.381,176,72,104,38.115,0,2013,2,118,293,178,0.827800656827636,-163.1,19.2582417582418,60,1181.86214674831,-0.154140657969452
20716,523890.854,5328675.381,153,64,89,35.971,2,2014,2,106,337,178,0.846193648912939,176.9,17.856043956044,72,1181.86214674831,-0.154140657969452
20716,523890.854,5328675.381,160,93,67,36.458,0,2015,1,113,301,169,0.777479402194005,-158.6,20.9142857142857,56,1181.86214674831,-0.154140657969452
20716,523890.854,5328675.381,168,93,75,36.982,3,2016,1,118,319,169,0.847998422396961,45.5,18.8857142857143,51,1181.86214674831,-0.154140657969452
20716,523890.854,5328675.381,130,94,36,28.745,0,2017,1,119,295,169,0.834376976946268,-10.8,19.7879120879121,50,1181.86214674831,-0.154140657969452
20716,523890.854,5328675.381,162,62,100,41.07,0,2018,3,105,297,184,0.794881602057658,-154,20.578021978022,79,1181.86214674831,-0.154140657969452
20716,523890.854,5328675.381,159,100,59,29.899,4,2019,1,120,323,168,0.812794425824902,-79.8,20.6626373626374,48,1181.86214674831,-0.154140657969452
20716,523890.854,5328675.381,0,0,0,26.508,0,2020,0,111,304,185,0.797786550983312,-19.2,19.0648351648352,74,1181.86214674831,-0.154140657969452
20762,523890.854,5318019.188,0,0,0,56.677,0,2001,2,97,311,176,0.873853238844689,-26.7,20.3989010989011,79,1037.62530524696,1.44425643814202
20762,523890.854,5318019.188,101,86,15,42.466,0,2002,3,105,310,226,0.854285979820095,-5.6,20.2901098901099,121,1037.62530524696,1.44425643814202
20762,523890.854,5318019.188,158,77,81,36.329,0,2003,2,106,302,162,0.811108306528659,-214.1,25.0835164835165,56,1037.62530524696,1.44425643814202
20762,523890.854,5318019.188,130,94,36,39.626,0,2004,1,108,311,177,0.864861955723472,90.8,19.910989010989,69,1037.62530524696,1.44425643814202
20762,523890.854,5318019.188,149,100,49,59.549,1,2005,1,94,309,169,0.88107807615856,-56.5,19.9923076923077,75,1037.62530524696,1.44425643814202
20762,523890.854,5318019.188,181,94,87,17.788,0,2006,2,135,324,185,0.831938394589602,16.2,20.9538461538462,50,1037.62530524696,1.44425643814202
20762,523890.854,5318019.188,93,93,0,64.223,6,2007,1,77,301,177,0.852194126506883,213,19.1032967032967,100,1037.62530524696,1.44425643814202
20762,523890.854,5318019.188,86,77,9,27.601,0,2008,1,119,305,200,0.870473893678142,-1.79999999999999,19.6,81,1037.62530524696,1.44425643814202
20762,523890.854,5318019.188,169,93,76,33.727,0,2009,1,108,304,161,0.870031745239645,-2.8,20.5450549450549,53,1037.62530524696,1.44425643814202
20762,523890.854,5318019.188,162,93,69,29.802,0,2010,2,115,297,192,0.869399564514175,50.5,20.2241758241758,77,1037.62530524696,1.44425643814202
20762,523890.854,5318019.188,86,60,26,37.066,0,2011,1,93,326,185,0.822254546949679,90.7,19.4164835164835,92,1037.62530524696,1.44425643814202
20762,523890.854,5318019.188,140,97,43,46.664,1,2012,1,105,303,169,0.899334158016671,-6,20.743956043956,64,1037.62530524696,1.44425643814202
20762,523890.854,5318019.188,166,63,103,40.462,0,2013,2,113,301,177,0.867620730092069,-200.2,21.3494505494505,64,1037.62530524696,1.44425643814202
20762,523890.854,5318019.188,146,66,80,39.516,0,2014,3,98,337,218,0.852654954972373,51.4,19.8307692307692,120,1037.62530524696,1.44425643814202
20762,523890.854,5318019.188,153,93,60,53.44,3,2015,2,95,319,193,0.860724632467844,-218.4,23.0318681318681,98,1037.62530524696,1.44425643814202
20762,523890.854,5318019.188,166,101,65,51.923,1,2016,2,103,335,192,0.886136761432351,-39.8,20.9813186813187,89,1037.62530524696,1.44425643814202
20762,523890.854,5318019.188,157,102,55,42.6,3,2017,1,98,296,161,0.832461068257928,-77.9,22.0516483516484,63,1037.62530524696,1.44425643814202
20762,523890.854,5318019.188,157,61,96,59.178,1,2018,2,86,316,169,0.857989304984636,-139.3,22.7065934065934,83,1037.62530524696,1.44425643814202
20762,523890.854,5318019.188,144,94,50,37.628,1,2019,2,110,318,186,0.863658382011658,-118.9,22.7472527472527,76,1037.62530524696,1.44425643814202
20762,523890.854,5318019.188,93,93,0,37.668,1,2020,1,94,307,161,0.824719484450249,-119,21.1252747252747,67,1037.62530524696,1.44425643814202
20763,523890.854,5317787.532,0,0,0,108.554,0,2001,2,54,321,177,0.848411404696504,-26.7,20.3989010989011,123,1083.16366499982,-1.00286821671842
20763,523890.854,5317787.532,86,77,9,42.466,0,2002,1,105,315,241,0.801878627165713,-5.6,20.2901098901099,136,1083.16366499982,-1.00286821671842
20763,523890.854,5317787.532,147,110,37,36.329,0,2003,1,106,304,161,0.816725431106234,-214.1,25.0835164835165,55,1083.16366499982,-1.00286821671842
20763,523890.854,5317787.532,146,100,46,34.031,0,2004,2,114,327,232,0.81093021922276,90.8,19.910989010989,118,1083.16366499982,-1.00286821671842
20763,523890.854,5317787.532,146,118,28,61.495,1,2005,1,92,308,161,0.847447556265255,-56.5,19.9923076923077,69,1083.16366499982,-1.00286821671842
20763,523890.854,5317787.532,182,93,89,35.665,0,2006,1,115,323,162,0.844667380971562,16.2,20.9538461538462,47,1083.16366499982,-1.00286821671842
20763,523890.854,5317787.532,105,78,27,60.003,3,2007,2,81,300,169,0.854719824692644,213,19.1032967032967,88,1083.16366499982,-1.00286821671842
20763,523890.854,5317787.532,82,64,18,36.518,0,2008,1,111,306,186,0.840898054560938,-1.79999999999999,19.6,75,1083.16366499982,-1.00286821671842
20763,523890.854,5317787.532,166,61,105,47.563,0,2009,2,93,302,169,0.875210811408178,-2.8,20.5450549450549,76,1083.16366499982,-1.00286821671842
20763,523890.854,5317787.532,170,104,66,29.035,0,2010,1,116,302,192,0.844763611937661,50.5,20.2241758241758,76,1083.16366499982,-1.00286821671842
20763,523890.854,5317787.532,0,0,0,33.693,0,2011,0,97,319,170,0.800058468893901,90.7,19.4164835164835,73,1083.16366499982,-1.00286821671842
20763,523890.854,5317787.532,146,81,65,48.933,1,2012,2,102,315,168,0.883739714183636,-6,20.743956043956,66,1083.16366499982,-1.00286821671842
20763,523890.854,5317787.532,175,79,96,39.511,0,2013,2,114,299,176,0.842062293969938,-200.2,21.3494505494505,62,1083.16366499982,-1.00286821671842
20763,523890.854,5317787.532,139,61,78,44.754,0,2014,2,91,323,162,0.846089373482167,51.4,19.8307692307692,71,1083.16366499982,-1.00286821671842
20763,523890.854,5317787.532,159,93,66,51.15,1,2015,1,97,327,161,0.875877057194251,-218.4,23.0318681318681,64,1083.16366499982,-1.00286821671842
20763,523890.854,5317787.532,170,132,38,52.886,1,2016,1,102,327,170,0.872372007206492,-39.8,20.9813186813187,68,1083.16366499982,-1.00286821671842
20763,523890.854,5317787.532,142,94,48,37.32,3,2017,1,105,302,162,0.807326563732345,-77.9,22.0516483516484,57,1083.16366499982,-1.00286821671842
20763,523890.854,5317787.532,167,94,73,60.2,1,2018,2,85,320,185,0.784460013326503,-139.3,22.7065934065934,100,1083.16366499982,-1.00286821671842
20763,523890.854,5317787.532,147,93,54,37.628,1,2019,1,110,330,170,0.812078997428919,-118.9,22.7472527472527,60,1083.16366499982,-1.00286821671842
20763,523890.854,5317787.532,0,0,0,32.909,0,2020,0,100,309,184,0.797419741481123,-119,21.1252747252747,84,1083.16366499982,-1.00286821671842
20764,523890.854,5317555.876,0,0,0,102.151,0,2001,3,60,327,161,0.860461641404315,-26.7,20.3989010989011,101,1102.57622314873,0.451439972516419
20764,523890.854,5317555.876,86,77,9,40.742,0,2002,1,107,325,185,0.80518954456597,-5.6,20.2901098901099,78,1102.57622314873,0.451439972516419
20764,523890.854,5317555.876,144,93,51,37.96,0,2003,1,104,312,154,0.823505345787381,-214.1,25.0835164835165,50,1102.57622314873,0.451439972516419
20764,523890.854,5317555.876,146,100,46,35.871,0,2004,1,112,333,169,0.816160464612232,90.8,19.910989010989,57,1102.57622314873,0.451439972516419
20764,523890.854,5317555.876,156,110,46,57.677,1,2005,1,96,315,169,0.861740881699942,-56.5,19.9923076923077,73,1102.57622314873,0.451439972516419
20764,523890.854,5317555.876,178,93,85,47.166,0,2006,1,104,322,169,0.837591499519062,16.2,20.9538461538462,65,1102.57622314873,0.451439972516419
20764,523890.854,5317555.876,105,78,27,62.151,5,2007,2,79,302,176,0.862180189646467,213,19.1032967032967,97,1102.57622314873,0.451439972516419
20764,523890.854,5317555.876,83,65,18,42.189,1,2008,1,106,309,192,0.838519759425369,-1.79999999999999,19.6,86,1102.57622314873,0.451439972516419
20764,523890.854,5317555.876,175,62,113,33.727,0,2009,3,108,309,170,0.885030494940626,-2.8,20.5450549450549,62,1102.57622314873,0.451439972516419
20764,523890.854,5317555.876,169,97,72,29.802,0,2010,1,115,301,177,0.823754976958029,50.5,20.2241758241758,62,1102.57622314873,0.451439972516419
20764,523890.854,5317555.876,85,84,1,37.912,0,2011,1,92,325,249,0.785622751781385,90.7,19.4164835164835,157,1102.57622314873,0.451439972516419
20764,523890.854,5317555.876,146,82,64,49.666,1,2012,2,101,317,168,0.891931361640461,-6,20.743956043956,67,1102.57622314873,0.451439972516419
20764,523890.854,5317555.876,176,79,97,36.779,0,2013,2,117,304,177,0.850209338584858,-200.2,21.3494505494505,60,1102.57622314873,0.451439972516419
20764,523890.854,5317555.876,136,62,74,48.827,0,2014,2,86,324,160,0.821989109025278,51.4,19.8307692307692,74,1102.57622314873,0.451439972516419
20764,523890.854,5317555.876,161,93,68,48.974,0,2015,1,99,330,161,0.872908866316369,-218.4,23.0318681318681,62,1102.57622314873,0.451439972516419
20764,523890.854,5317555.876,168,119,49,58.922,1,2016,1,96,322,177,0.8674785314923,-39.8,20.9813186813187,81,1102.57622314873,0.451439972516419
20764,523890.854,5317555.876,143,113,30,43.418,3,2017,1,97,302,162,0.802978193603715,-77.9,22.0516483516484,65,1102.57622314873,0.451439972516419
20764,523890.854,5317555.876,167,94,73,61.234,1,2018,1,84,323,161,0.822095477498085,-139.3,22.7065934065934,77,1102.57622314873,0.451439972516419
20764,523890.854,5317555.876,152,128,24,38.54,1,2019,1,109,336,161,0.795413443924505,-118.9,22.7472527472527,52,1102.57622314873,0.451439972516419
20764,523890.854,5317555.876,0,0,0,93.344,0,2020,0,44,312,176,0.814269114816631,-119,21.1252747252747,132,1102.57622314873,0.451439972516419
20848,524122.511,5348829.484,86,85,1,121.428,34,2001,2,41,302,192,0.862410608987875,118,17.3307692307692,151,1209.51250192396,0.45819748756282
20848,524122.511,5348829.484,86,69,17,18.034,0,2002,1,132,315,249,0.795910047099259,53.4,17.5120879120879,117,1209.51250192396,0.45819748756282
20848,524122.511,5348829.484,180,80,100,31.566,0,2003,3,116,305,217,0.806301858467188,-198.1,22.256043956044,101,1209.51250192396,0.45819748756282
20848,524122.511,5348829.484,178,35,143,22.694,0,2004,3,128,324,201,0.853717213302475,210.8,17.0318681318681,73,1209.51250192396,0.45819748756282
20848,524122.511,5348829.484,155,93,62,36.77,0,2005,2,117,314,185,0.845147060451983,45.7,17.2395604395604,68,1209.51250192396,0.45819748756282
20848,524122.511,5348829.484,195,66,129,22.651,1,2006,3,131,346,185,0.815821449140124,93.4,18.2021978021978,54,1209.51250192396,0.45819748756282
20848,524122.511,5348829.484,136,121,15,40.609,0,2007,1,102,287,184,0.833884862824184,334.9,16.4472527472527,82,1209.51250192396,0.45819748756282
20848,524122.511,5348829.484,119,52,67,23.456,0,2008,3,122,300,192,0.841332376041339,51.4,16.9230769230769,70,1209.51250192396,0.45819748756282
20848,524122.511,5348829.484,179,66,113,23.052,0,2009,3,123,285,186,0.861188762461471,56.1,17.7604395604396,63,1209.51250192396,0.45819748756282
20848,524122.511,5348829.484,179,62,117,22.223,0,2010,3,126,296,194,0.855353403536334,134.3,17.6802197802198,68,1209.51250192396,0.45819748756282
20848,524122.511,5348829.484,150,93,57,32.718,1,2011,2,100,322,186,0.840498844512041,136.8,16.9703296703297,86,1209.51250192396,0.45819748756282
20848,524122.511,5348829.484,160,94,66,33.906,0,2012,2,118,320,208,0.843095543079687,90.5,18.343956043956,90,1209.51250192396,0.45819748756282
20848,524122.511,5348829.484,180,96,84,33.758,1,2013,2,121,315,209,0.862314789028185,-155.5,18.543956043956,88,1209.51250192396,0.45819748756282
20848,524122.511,5348829.484,149,50,99,32.489,0,2014,3,111,306,217,0.86191416850785,192.7,17.3769230769231,106,1209.51250192396,0.45819748756282
20848,524122.511,5348829.484,172,70,102,29.308,0,2015,3,121,332,217,0.836660709553795,-153.6,20.3384615384615,96,1209.51250192396,0.45819748756282
20848,524122.511,5348829.484,171,94,77,34.304,2,2016,2,120,331,185,0.84232358368312,52.4,18.4901098901099,65,1209.51250192396,0.45819748756282
20848,524122.511,5348829.484,151,95,56,41.723,7,2017,2,101,302,202,0.856083214470623,-1.7,19.1,101,1209.51250192396,0.45819748756282
20848,524122.511,5348829.484,168,53,115,38.486,0,2018,3,106,322,186,0.868629441225125,-150.7,19.8846153846154,80,1209.51250192396,0.45819748756282
20848,524122.511,5348829.484,167,93,74,27.111,4,2019,2,123,299,200,0.862382725243508,-73,20.0010989010989,77,1209.51250192396,0.45819748756282
20848,524122.511,5348829.484,0,0,0,35.269,0,2020,0,98,312,217,0.83469079921659,-12.8,18.3098901098901,119,1209.51250192396,0.45819748756282
20849,524122.511,5348597.828,86,85,1,28.937,0,2001,2,122,299,193,0.856573200445155,118,17.3307692307692,71,1228.46816123851,-0.592866576360004
20849,524122.511,5348597.828,86,69,17,19.92,0,2002,1,130,315,256,0.795182684767968,53.4,17.5120879120879,126,1228.46816123851,-0.592866576360004
20849,524122.511,5348597.828,180,78,102,30.761,0,2003,3,117,291,218,0.816281413622933,-198.1,22.256043956044,101,1228.46816123851,-0.592866576360004
20849,524122.511,5348597.828,179,31,148,17.624,0,2004,2,133,274,208,0.852747005158826,210.8,17.0318681318681,75,1228.46816123851,-0.592866576360004
20849,524122.511,5348597.828,157,93,64,34.607,0,2005,2,119,313,192,0.857585562693409,45.7,17.2395604395604,73,1228.46816123851,-0.592866576360004
20849,524122.511,5348597.828,188,66,122,28.21,1,2006,3,125,329,193,0.826223530995667,93.4,18.2021978021978,68,1228.46816123851,-0.592866576360004
20849,524122.511,5348597.828,149,93,56,35.253,0,2007,3,109,289,193,0.835657826902177,334.9,16.4472527472527,84,1228.46816123851,-0.592866576360004
20849,524122.511,5348597.828,136,54,82,16.39,0,2008,3,130,296,193,0.832359914372267,51.4,16.9230769230769,63,1228.46816123851,-0.592866576360004
20849,524122.511,5348597.828,176,66,110,30.557,0,2009,3,114,282,186,0.864020085087502,56.1,17.7604395604396,72,1228.46816123851,-0.592866576360004
20849,524122.511,5348597.828,173,67,106,19.919,0,2010,3,129,289,225,0.916529561693033,134.3,17.6802197802198,96,1228.46816123851,-0.592866576360004
20849,524122.511,5348597.828,148,85,63,26.607,0,2011,3,108,318,201,0.820126949728014,136.8,16.9703296703297,93,1228.46816123851,-0.592866576360004
20849,524122.511,5348597.828,160,94,66,34.981,0,2012,2,117,305,193,0.860179778345052,90.5,18.343956043956,76,1228.46816123851,-0.592866576360004
20849,524122.511,5348597.828,180,93,87,20.364,1,2013,2,134,307,210,0.862600795202756,-155.5,18.543956043956,76,1228.46816123851,-0.592866576360004
20849,524122.511,5348597.828,150,47,103,19.427,0,2014,3,130,307,218,0.854642376990996,192.7,17.3769230769231,88,1228.46816123851,-0.592866576360004
20849,524122.511,5348597.828,171,71,100,29.308,0,2015,3,121,315,208,0.842168409159713,-153.6,20.3384615384615,87,1228.46816123851,-0.592866576360004
20849,524122.511,5348597.828,172,110,62,2.156,0,2016,2,152,329,249,0.789735644147287,52.4,18.4901098901099,97,1228.46816123851,-0.592866576360004
20849,524122.511,5348597.828,153,94,59,24.639,0,2017,2,124,296,208,0.852437336333515,-1.7,19.1,84,1228.46816123851,-0.592866576360004
20849,524122.511,5348597.828,171,51,120,22.52,0,2018,3,125,315,201,0.865265394846227,-150.7,19.8846153846154,76,1228.46816123851,-0.592866576360004
20849,524122.511,5348597.828,168,93,75,23.541,1,2019,2,127,295,193,0.879803508867287,-73,20.0010989010989,66,1228.46816123851,-0.592866576360004
20849,524122.511,5348597.828,0,0,0,25.303,0,2020,0,113,309,217,0.833281150008248,-12.8,18.3098901098901,104,1228.46816123851,-0.592866576360004
20850,524122.511,5348366.171,0,0,0,29.981,0,2001,1,121,310,193,0.875187267550221,118,17.3307692307692,72,1238.48735073049,0.834407893101805
20850,524122.511,5348366.171,0,0,0,19.92,0,2002,0,130,318,194,0.851292200522623,53.4,17.5120879120879,64,1238.48735073049,0.834407893101805
20850,524122.511,5348366.171,172,135,37,29.946,0,2003,2,118,289,224,0.809009844325047,-198.1,22.256043956044,106,1238.48735073049,0.834407893101805
20850,524122.511,5348366.171,180,27,153,13.645,0,2004,3,137,327,233,0.802422905574972,210.8,17.0318681318681,96,1238.48735073049,0.834407893101805
20850,524122.511,5348366.171,158,93,65,36.77,0,2005,2,117,306,185,0.873066762684432,45.7,17.2395604395604,68,1238.48735073049,0.834407893101805
20850,524122.511,5348366.171,195,60,135,21.669,1,2006,2,132,337,185,0.830821690328039,93.4,18.2021978021978,53,1238.48735073049,0.834407893101805
20850,524122.511,5348366.171,93,93,0,38.189,0,2007,2,105,292,192,0.857464084444088,334.9,16.4472527472527,87,1238.48735073049,0.834407893101805
20850,524122.511,5348366.171,136,58,78,18.001,0,2008,3,128,296,208,0.851702716656986,51.4,16.9230769230769,80,1238.48735073049,0.834407893101805
20850,524122.511,5348366.171,183,67,116,38.272,0,2009,3,106,310,194,0.864917082103708,56.1,17.7604395604396,88,1238.48735073049,0.834407893101805
20850,524122.511,5348366.171,164,69,95,21.471,0,2010,3,127,290,194,0.85942633128964,134.3,17.6802197802198,67,1238.48735073049,0.834407893101805
20850,524122.511,5348366.171,150,63,87,28.831,0,2011,2,105,320,178,0.820559809774095,136.8,16.9703296703297,73,1238.48735073049,0.834407893101805
20850,524122.511,5348366.171,163,100,63,41.964,0,2012,2,110,306,232,0.844257205162218,90.5,18.343956043956,122,1238.48735073049,0.834407893101805
20850,524122.511,5348366.171,177,67,110,25.348,1,2013,3,129,303,209,0.86334395679892,-155.5,18.543956043956,80,1238.48735073049,0.834407893101805
20850,524122.511,5348366.171,165,45,120,30.074,0,2014,3,115,307,217,0.831588147085058,192.7,17.3769230769231,102,1238.48735073049,0.834407893101805
20850,524122.511,5348366.171,173,75,98,27.126,0,2015,2,123,306,194,0.876920194423257,-153.6,20.3384615384615,71,1238.48735073049,0.834407893101805
20850,524122.511,5348366.171,172,120,52,6.181,0,2016,1,148,331,200,0.825707351465866,52.4,18.4901098901099,52,1238.48735073049,0.834407893101805
20850,524122.511,5348366.171,152,97,55,21.338,0,2017,2,128,295,200,0.861544819287298,-1.7,19.1,72,1238.48735073049,0.834407893101805
20850,524122.511,5348366.171,177,93,84,21.784,0,2018,2,126,334,193,0.856477584943214,-150.7,19.8846153846154,67,1238.48735073049,0.834407893101805
20850,524122.511,5348366.171,0,0,0,21.729,0,2019,0,129,295,200,0.874090940246704,-73,20.0010989010989,71,1238.48735073049,0.834407893101805
20850,524122.511,5348366.171,134,51,83,24.189,1,2020,3,115,328,226,0.835466384356954,-12.8,18.3098901098901,111,1238.48735073049,0.834407893101805
20851,524122.511,5348134.515,0,0,0,35.329,0,2001,1,116,302,192,0.855739076727759,118,17.3307692307692,76,1227.15368347078,1.26952449334718
20851,524122.511,5348134.515,86,86,0,22.785,0,2002,1,127,327,192,0.841224995676061,53.4,17.5120879120879,65,1227.15368347078,1.26952449334718
20851,524122.511,5348134.515,165,93,72,34.827,0,2003,1,112,290,169,0.80718029671352,-198.1,22.256043956044,57,1227.15368347078,1.26952449334718
20851,524122.511,5348134.515,173,27,146,37.481,0,2004,3,111,333,226,0.834030223460955,210.8,17.0318681318681,115,1227.15368347078,1.26952449334718
20851,524122.511,5348134.515,158,93,65,38.952,0,2005,2,115,308,186,0.856480302877168,45.7,17.2395604395604,71,1227.15368347078,1.26952449334718
20851,524122.511,5348134.515,196,60,136,22.651,1,2006,3,131,335,185,0.83118746812243,93.4,18.2021978021978,54,1227.15368347078,1.26952449334718
20851,524122.511,5348134.515,93,93,0,36.683,0,2007,2,107,295,184,0.854798256767521,334.9,16.4472527472527,77,1227.15368347078,1.26952449334718
20851,524122.511,5348134.515,135,59,76,19.715,0,2008,3,126,304,217,0.844263909899475,51.4,16.9230769230769,91,1227.15368347078,1.26952449334718
20851,524122.511,5348134.515,183,67,116,35.285,0,2009,3,109,314,194,0.860088838045729,56.1,17.7604395604396,85,1227.15368347078,1.26952449334718
20851,524122.511,5348134.515,165,70,95,22.223,0,2010,3,126,294,193,0.850774632457853,134.3,17.6802197802198,67,1227.15368347078,1.26952449334718
20851,524122.511,5348134.515,149,65,84,30.373,1,2011,2,103,321,160,0.818624233805783,136.8,16.9703296703297,57,1227.15368347078,1.26952449334718
20851,524122.511,5348134.515,163,94,69,43.713,1,2012,2,108,305,226,0.828750457620879,90.5,18.343956043956,118,1227.15368347078,1.26952449334718
20851,524122.511,5348134.515,177,67,110,26.345,1,2013,3,128,302,200,0.848323677969529,-155.5,18.543956043956,72,1227.15368347078,1.26952449334718
20851,524122.511,5348134.515,160,45,115,33.711,1,2014,3,109,312,217,0.822429983091257,192.7,17.3769230769231,108,1227.15368347078,1.26952449334718
20851,524122.511,5348134.515,173,76,97,31.041,0,2015,2,119,306,185,0.861903590727409,-153.6,20.3384615384615,66,1227.15368347078,1.26952449334718
20851,524122.511,5348134.515,173,104,69,16.15,0,2016,1,138,331,193,0.837686206192106,52.4,18.4901098901099,55,1227.15368347078,1.26952449334718
20851,524122.511,5348134.515,150,94,56,26.986,0,2017,2,121,296,186,0.852411981403327,-1.7,19.1,65,1227.15368347078,1.26952449334718
20851,524122.511,5348134.515,178,93,85,21.784,0,2018,2,126,338,185,0.835254556759534,-150.7,19.8846153846154,59,1227.15368347078,1.26952449334718
20851,524122.511,5348134.515,97,95,2,25.341,3,2019,2,125,294,193,0.846278455334809,-73,20.0010989010989,68,1227.15368347078,1.26952449334718
20851,524122.511,5348134.515,86,48,38,22.089,1,2020,1,119,326,225,0.820606174024793,-12.8,18.3098901098901,106,1227.15368347078,1.26952449334718
20861,524122.511,5345817.951,0,0,0,64.441,0,2001,2,90,313,186,0.831346631618818,118,17.3307692307692,96,1112.64015823172,-1.35461137386649
20861,524122.511,5345817.951,93,81,12,53.597,5,2002,3,91,299,249,0.810514267258667,53.4,17.5120879120879,158,1112.64015823172,-1.35461137386649
20861,524122.511,5345817.951,161,98,63,49.269,7,2003,1,96,328,161,0.822123701058348,-198.1,22.256043956044,65,1112.64015823172,-1.35461137386649
20861,524122.511,5345817.951,159,38,121,46.344,0,2004,2,102,334,178,0.828395501907446,210.8,17.0318681318681,76,1112.64015823172,-1.35461137386649
20861,524122.511,5345817.951,144,104,40,75.034,2,2005,1,83,308,161,0.834651594029556,45.7,17.2395604395604,78,1112.64015823172,-1.35461137386649
20861,524122.511,5345817.951,185,86,99,50.523,2,2006,3,105,339,225,0.827434917017775,93.4,18.2021978021978,120,1112.64015823172,-1.35461137386649
20861,524122.511,5345817.951,0,0,0,67.115,0,2007,0,75,309,178,0.813073258804925,334.9,16.4472527472527,103,1112.64015823172,-1.35461137386649
20861,524122.511,5345817.951,170,66,104,36.538,0,2008,3,110,311,233,0.824723595118488,51.4,16.9230769230769,123,1112.64015823172,-1.35461137386649
20861,524122.511,5345817.951,175,63,112,35.285,0,2009,2,109,312,169,0.853495995431682,56.1,17.7604395604396,60,1112.64015823172,-1.35461137386649
20861,524122.511,5345817.951,165,78,87,39.288,0,2010,2,105,313,177,0.812718716771394,134.3,17.6802197802198,72,1112.64015823172,-1.35461137386649
20861,524122.511,5345817.951,137,67,70,57.947,5,2011,5,71,327,250,0.820380622735054,136.8,16.9703296703297,179,1112.64015823172,-1.35461137386649
20861,524122.511,5345817.951,164,83,81,56.634,4,2012,2,92,324,170,0.827558015340027,90.5,18.343956043956,78,1112.64015823172,-1.35461137386649
20861,524122.511,5345817.951,168,93,75,54.473,1,2013,2,102,305,185,0.830457262677613,-155.5,18.543956043956,83,1112.64015823172,-1.35461137386649
20861,524122.511,5345817.951,149,60,89,48.473,3,2014,3,88,346,266,0.810700490701499,192.7,17.3769230769231,178,1112.64015823172,-1.35461137386649
20861,524122.511,5345817.951,159,94,65,48.634,0,2015,1,99,347,162,0.816730325864423,-153.6,20.3384615384615,63,1112.64015823172,-1.35461137386649
20861,524122.511,5345817.951,170,93,77,54.392,7,2016,2,101,343,200,0.859877836220523,52.4,18.4901098901099,99,1112.64015823172,-1.35461137386649
20861,524122.511,5345817.951,135,94,41,52.538,7,2017,1,88,314,169,0.814750300557662,-1.7,19.1,81,1112.64015823172,-1.35461137386649
20861,524122.511,5345817.951,159,53,106,52.372,0,2018,2,93,322,154,0.83671064871159,-150.7,19.8846153846154,61,1112.64015823172,-1.35461137386649
20861,524122.511,5345817.951,160,80,80,48.909,8,2019,2,98,314,154,0.78885335872159,-73,20.0010989010989,56,1112.64015823172,-1.35461137386649
20861,524122.511,5345817.951,0,0,0,73.18,0,2020,0,61,352,178,0.84446934324853,-12.8,18.3098901098901,117,1112.64015823172,-1.35461137386649
20906,524122.511,5335393.415,0,0,0,50.688,0,2001,1,103,295,193,0.883182850293476,116.8,17.4,90,1228.51488270991,1.09008638674569
20906,524122.511,5335393.415,120,73,47,28.1,0,2002,3,122,298,233,0.861397498658171,52.7,17.567032967033,111,1228.51488270991,1.09008638674569
20906,524122.511,5335393.415,153,81,72,33.746,0,2003,2,114,323,169,0.853345341379206,-198,22.3252747252747,55,1228.51488270991,1.09008638674569
20906,524122.511,5335393.415,155,93,62,27.35,0,2004,2,123,327,185,0.842517306742536,209.7,17.0835164835165,62,1228.51488270991,1.09008638674569
20906,524122.511,5335393.415,149,116,33,39.654,0,2005,1,115,301,177,0.873987511208787,44.2,17.3054945054945,62,1228.51488270991,1.09008638674569
20906,524122.511,5335393.415,188,59,129,27.774,1,2006,3,126,331,208,0.85546278835125,92.3,18.2626373626374,82,1228.51488270991,1.09008638674569
20906,524122.511,5335393.415,0,0,0,41.204,0,2007,0,102,286,162,0.865677355089681,332.6,16.5076923076923,60,1228.51488270991,1.09008638674569
20906,524122.511,5335393.415,0,0,0,21.639,0,2008,0,124,299,208,0.846383660931903,50.1,16.9747252747253,84,1228.51488270991,1.09008638674569
20906,524122.511,5335393.415,179,67,112,29.053,0,2009,2,116,293,160,0.869850516268136,55,17.8153846153846,44,1228.51488270991,1.09008638674569
20906,524122.511,5335393.415,170,93,77,25.349,0,2010,2,122,300,210,0.863563650010522,133.1,17.7351648351648,88,1228.51488270991,1.09008638674569
20906,524122.511,5335393.415,86,65,21,31.308,1,2011,1,102,334,161,0.849388801642243,136.1,17.0351648351648,59,1228.51488270991,1.09008638674569
20906,524122.511,5335393.415,161,93,68,32.403,0,2012,1,120,297,170,0.864483014183716,88.9,18.4296703296703,50,1228.51488270991,1.09008638674569
20906,524122.511,5335393.415,186,77,109,20.729,1,2013,3,134,299,201,0.835158760305592,-156.9,18.6175824175824,67,1228.51488270991,1.09008638674569
20906,524122.511,5335393.415,150,51,99,35.525,1,2014,3,107,307,201,0.850759036306358,191.6,17.4516483516484,94,1228.51488270991,1.09008638674569
20906,524122.511,5335393.415,154,93,61,34.827,0,2015,2,115,341,209,0.855682530627961,-154.6,20.4153846153846,94,1228.51488270991,1.09008638674569
20906,524122.511,5335393.415,164,93,71,2.195,0,2016,2,152,321,209,0.873808884238206,50.9,18.5681318681319,57,1228.51488270991,1.09008638674569
20906,524122.511,5335393.415,123,93,30,38.111,7,2017,1,107,335,176,0.864984372311683,-2.3,19.1582417582418,69,1228.51488270991,1.09008638674569
20906,524122.511,5335393.415,168,93,75,35.087,0,2018,2,110,294,225,0.84667273506487,-151.3,19.9417582417582,115,1228.51488270991,1.09008638674569
20906,524122.511,5335393.415,148,74,74,27.567,4,2019,3,123,298,185,0.862571442634705,-73.4,20.0571428571429,62,1228.51488270991,1.09008638674569
20906,524122.511,5335393.415,0,0,0,110.012,0,2020,0,31,296,225,0.827913531587704,-13.6,18.3758241758242,194,1228.51488270991,1.09008638674569
20907,524122.511,5335161.759,0,0,0,53.14,0,2001,1,101,301,186,0.893532445813574,116.8,17.4,85,1236.43132760433,-1.50066551055847
20907,524122.511,5335161.759,111,73,38,28.961,0,2002,2,121,304,177,0.872492981332578,52.7,17.567032967033,56,1236.43132760433,-1.50066551055847
20907,524122.511,5335161.759,154,93,61,31.289,0,2003,2,117,331,216,0.831764705934468,-198,22.3252747252747,99,1236.43132760433,-1.50066551055847
20907,524122.511,5335161.759,153,94,59,29.894,0,2004,2,120,309,185,0.847898116279197,209.7,17.0835164835165,65,1236.43132760433,-1.50066551055847
20907,524122.511,5335161.759,150,93,57,38.543,0,2005,2,116,302,178,0.857491400569814,44.2,17.3054945054945,62,1236.43132760433,-1.50066551055847
20907,524122.511,5335161.759,188,59,129,28.664,1,2006,3,125,331,200,0.859929309822645,92.3,18.2626373626374,75,1236.43132760433,-1.50066551055847
20907,524122.511,5335161.759,0,0,0,49.678,0,2007,0,93,286,200,0.863203028781965,332.6,16.5076923076923,107,1236.43132760433,-1.50066551055847
20907,524122.511,5335161.759,0,0,0,21.639,0,2008,0,124,299,192,0.849534521725482,50.1,16.9747252747253,68,1236.43132760433,-1.50066551055847
20907,524122.511,5335161.759,175,67,108,31.72,0,2009,2,113,293,161,0.8926564995354,55,17.8153846153846,48,1236.43132760433,-1.50066551055847
20907,524122.511,5335161.759,172,93,79,24.628,0,2010,2,123,299,202,0.881800212662342,133.1,17.7351648351648,79,1236.43132760433,-1.50066551055847
20907,524122.511,5335161.759,85,63,22,33.726,1,2011,1,99,347,217,0.852655506877431,136.1,17.0351648351648,118,1236.43132760433,-1.50066551055847
20907,524122.511,5335161.759,153,94,59,38.92,0,2012,1,114,300,169,0.86693039245119,88.9,18.4296703296703,55,1236.43132760433,-1.50066551055847
20907,524122.511,5335161.759,185,79,106,25.798,1,2013,3,129,298,193,0.872876491348184,-156.9,18.6175824175824,64,1236.43132760433,-1.50066551055847
20907,524122.511,5335161.759,149,52,97,37.471,3,2014,3,104,309,185,0.845129126382815,191.6,17.4516483516484,81,1236.43132760433,-1.50066551055847
20907,524122.511,5335161.759,153,93,60,38.112,0,2015,2,111,330,218,0.87535497726661,-154.6,20.4153846153846,107,1236.43132760433,-1.50066551055847
20907,524122.511,5335161.759,165,93,72,2.195,0,2016,2,152,328,209,0.879089033224968,50.9,18.5681318681319,57,1236.43132760433,-1.50066551055847
20907,524122.511,5335161.759,123,93,30,37.348,7,2017,2,108,335,184,0.878363456258583,-2.3,19.1582417582418,76,1236.43132760433,-1.50066551055847
20907,524122.511,5335161.759,168,93,75,35.087,0,2018,2,110,298,234,0.849117423040111,-151.3,19.9417582417582,124,1236.43132760433,-1.50066551055847
20907,524122.511,5335161.759,140,75,65,26.669,4,2019,3,124,298,185,0.879445500012308,-73.4,20.0571428571429,61,1236.43132760433,-1.50066551055847
20907,524122.511,5335161.759,0,0,0,122.728,0,2020,0,18,304,218,0.840670104051339,-13.6,18.3758241758242,200,1236.43132760433,-1.50066551055847
20914,524122.511,5333540.164,0,0,0,40.363,0,2001,2,112,290,184,0.863732108117148,103.5,18.1120879120879,72,1230.96223806117,0.980854299915924
20914,524122.511,5333540.164,86,70,16,21.06,0,2002,1,129,298,185,0.865999770161074,46.4,18.2428571428571,56,1230.96223806117,0.980854299915924
20914,524122.511,5333540.164,173,96,77,22.089,0,2003,2,127,302,218,0.817203699340784,-203.8,22.9692307692308,91,1230.96223806117,0.980854299915924
20914,524122.511,5333540.164,161,93,68,14.757,0,2004,2,136,297,193,0.854152819935605,196.1,17.7461538461538,57,1230.96223806117,0.980854299915924
20914,524122.511,5333540.164,162,93,69,29.122,0,2005,2,125,300,194,0.847709356492258,38.9,17.9032967032967,69,1230.96223806117,0.980854299915924
20914,524122.511,5333540.164,187,60,127,43.612,1,2006,3,112,322,208,0.866182194698929,82.6,18.867032967033,96,1230.96223806117,0.980854299915924
20914,524122.511,5333540.164,106,93,13,39.224,0,2007,1,104,292,170,0.85348857138853,317.9,17.0824175824176,66,1230.96223806117,0.980854299915924
20914,524122.511,5333540.164,180,68,112,15.668,0,2008,2,131,288,186,0.884159085702515,40.8,17.6131868131868,55,1230.96223806117,0.980854299915924
20914,524122.511,5333540.164,175,113,62,36.411,0,2009,1,108,303,177,0.923926306972072,41,18.5230769230769,69,1230.96223806117,0.980854299915924
20914,524122.511,5333540.164,179,76,103,19.851,0,2010,2,130,290,178,0.881356542728652,122,18.3626373626374,48,1230.96223806117,0.980854299915924
20914,524122.511,5333540.164,93,93,0,29.819,0,2011,1,105,312,168,0.842721696116396,127.1,17.5,63,1230.96223806117,0.980854299915924
20914,524122.511,5333540.164,174,93,81,22.277,0,2012,2,130,301,185,0.894661196931568,82.8,18.7043956043956,55,1230.96223806117,0.980854299915924
20914,524122.511,5333540.164,166,77,89,67.669,6,2013,3,93,293,193,0.884017128241359,-163.1,19.2582417582418,100,1230.96223806117,0.980854299915924
20914,524122.511,5333540.164,153,59,94,29.689,0,2014,2,116,332,177,0.858265628279298,176.9,17.856043956044,61,1230.96223806117,0.980854299915924
20914,524122.511,5333540.164,163,93,70,33.255,0,2015,1,117,306,177,0.807880079223888,-158.6,20.9142857142857,60,1230.96223806117,0.980854299915924
20914,524122.511,5333540.164,171,93,78,21.367,0,2016,2,133,320,185,0.901355210640461,45.5,18.8857142857143,52,1230.96223806117,0.980854299915924
20914,524122.511,5333540.164,134,93,41,30.32,2,2017,2,117,293,194,0.874124346397139,-10.8,19.7879120879121,77,1230.96223806117,0.980854299915924
20914,524122.511,5333540.164,172,69,103,29.593,0,2018,2,117,290,193,0.855498106701361,-154,20.578021978022,76,1230.96223806117,0.980854299915924
20914,524122.511,5333540.164,165,93,72,25.45,3,2019,1,125,289,176,0.860356844368502,-79.8,20.6626373626374,51,1230.96223806117,0.980854299915924
20914,524122.511,5333540.164,0,0,0,22.062,0,2020,0,119,294,217,0.811731929337769,-19.2,19.0648351648352,98,1230.96223806117,0.980854299915924
20915,524122.511,5333308.508,0,0,0,30.436,0,2001,2,121,294,185,0.855404597025063,103.5,18.1120879120879,64,1247.75692305956,1.2323967622293
20915,524122.511,5333308.508,93,71,22,23.03,0,2002,3,127,297,184,0.851184326784212,46.4,18.2428571428571,57,1247.75692305956,1.2323967622293
20915,524122.511,5333308.508,167,93,74,24.699,0,2003,2,124,305,225,0.773557734611651,-203.8,22.9692307692308,101,1247.75692305956,1.2323967622293
20915,524122.511,5333308.508,164,94,70,13.781,0,2004,2,137,300,201,0.867420307761259,196.1,17.7461538461538,64,1247.75692305956,1.2323967622293
20915,524122.511,5333308.508,159,93,66,27.062,0,2005,2,127,302,210,0.833495921432013,38.9,17.9032967032967,83,1247.75692305956,1.2323967622293
20915,524122.511,5333308.508,199,59,140,21.947,0,2006,2,132,317,193,0.856110284478463,82.6,18.867032967033,61,1247.75692305956,1.2323967622293
20915,524122.511,5333308.508,102,93,9,43.519,0,2007,1,99,287,153,0.822202253869477,317.9,17.0824175824176,54,1247.75692305956,1.2323967622293
20915,524122.511,5333308.508,176,67,109,15.668,0,2008,2,131,287,185,0.877943310235521,40.8,17.6131868131868,54,1247.75692305956,1.2323967622293
20915,524122.511,5333308.508,172,93,79,45.396,0,2009,1,100,307,177,0.918547472309739,41,18.5230769230769,77,1247.75692305956,1.2323967622293
20915,524122.511,5333308.508,176,76,100,19.851,0,2010,3,130,291,185,0.869526316370829,122,18.3626373626374,55,1247.75692305956,1.2323967622293
20915,524122.511,5333308.508,93,93,0,29.021,0,2011,1,106,314,170,0.844167002312868,127.1,17.5,64,1247.75692305956,1.2323967622293
20915,524122.511,5333308.508,172,107,65,22.277,0,2012,1,130,304,177,0.889763584351112,82.8,18.7043956043956,47,1247.75692305956,1.2323967622293
20915,524122.511,5333308.508,185,78,107,18.716,0,2013,3,136,296,192,0.873927571581688,-163.1,19.2582417582418,56,1247.75692305956,1.2323967622293
20915,524122.511,5333308.508,153,59,94,29.689,0,2014,2,116,330,177,0.864440917504709,176.9,17.856043956044,61,1247.75692305956,1.2323967622293
20915,524122.511,5333308.508,159,93,66,35.641,0,2015,1,114,309,154,0.783688964967629,-158.6,20.9142857142857,40,1247.75692305956,1.2323967622293
20915,524122.511,5333308.508,172,93,79,24.185,0,2016,1,130,310,178,0.901661754383006,45.5,18.8857142857143,48,1247.75692305956,1.2323967622293
20915,524122.511,5333308.508,135,93,42,29.541,1,2017,2,118,303,193,0.845879599949011,-10.8,19.7879120879121,75,1247.75692305956,1.2323967622293
20915,524122.511,5333308.508,173,70,103,32.25,0,2018,2,114,295,192,0.843421356848393,-154,20.578021978022,78,1247.75692305956,1.2323967622293
20915,524122.511,5333308.508,173,95,78,17.663,0,2019,1,133,296,177,0.848446656546634,-79.8,20.6626373626374,44,1247.75692305956,1.2323967622293
20915,524122.511,5333308.508,0,0,0,18.388,0,2020,0,125,300,216,0.805909278898118,-19.2,19.0648351648352,91,1247.75692305956,1.2323967622293
20916,524122.511,5333076.852,0,0,0,27.282,0,2001,1,124,287,201,0.874747764216802,103.5,18.1120879120879,77,1251.55865763446,-0.396417871732559
20916,524122.511,5333076.852,153,71,82,24.05,0,2002,3,126,283,225,0.876648384178648,46.4,18.2428571428571,99,1251.55865763446,-0.396417871732559
20916,524122.511,5333076.852,160,93,67,26.541,0,2003,2,122,312,217,0.826991095709762,-203.8,22.9692307692308,95,1251.55865763446,-0.396417871732559
20916,524122.511,5333076.852,150,93,57,17.851,0,2004,2,133,294,201,0.875951575551593,196.1,17.7461538461538,68,1251.55865763446,-0.396417871732559
20916,524122.511,5333076.852,159,98,61,29.122,0,2005,2,125,296,192,0.910571652875711,38.9,17.9032967032967,67,1251.55865763446,-0.396417871732559
20916,524122.511,5333076.852,190,93,97,18.037,0,2006,2,136,315,200,0.885865787425168,82.6,18.867032967033,64,1251.55865763446,-0.396417871732559
20916,524122.511,5333076.852,115,93,22,36.897,0,2007,1,107,293,176,0.873882121776592,317.9,17.0824175824176,69,1251.55865763446,-0.396417871732559
20916,524122.511,5333076.852,174,65,109,16.445,0,2008,3,130,290,208,0.877382366974391,40.8,17.6131868131868,78,1251.55865763446,-0.396417871732559
20916,524122.511,5333076.852,176,93,83,33.246,0,2009,1,111,309,170,0.89899360409198,41,18.5230769230769,59,1251.55865763446,-0.396417871732559
20916,524122.511,5333076.852,171,93,78,21.571,0,2010,2,128,297,185,0.883144516983631,122,18.3626373626374,57,1251.55865763446,-0.396417871732559
20916,524122.511,5333076.852,93,66,27,30.631,0,2011,3,104,308,201,0.871790114818821,127.1,17.5,97,1251.55865763446,-0.396417871732559
20916,524122.511,5333076.852,162,93,69,25.279,0,2012,1,127,301,178,0.904589549655059,82.8,18.7043956043956,51,1251.55865763446,-0.396417871732559
20916,524122.511,5333076.852,180,93,87,13.554,0,2013,2,141,299,209,0.8766591087831,-163.1,19.2582417582418,68,1251.55865763446,-0.396417871732559
20916,524122.511,5333076.852,151,97,54,27.823,0,2014,2,119,327,194,0.864635109933808,176.9,17.856043956044,75,1251.55865763446,-0.396417871732559
20916,524122.511,5333076.852,151,93,58,34.05,0,2015,2,116,311,210,0.877422557991148,-158.6,20.9142857142857,94,1251.55865763446,-0.396417871732559
20916,524122.511,5333076.852,171,93,78,19.343,0,2016,2,135,329,184,0.900066874118249,45.5,18.8857142857143,49,1251.55865763446,-0.396417871732559
20916,524122.511,5333076.852,132,93,39,24.767,0,2017,2,124,291,186,0.88531629314262,-10.8,19.7879120879121,62,1251.55865763446,-0.396417871732559
20916,524122.511,5333076.852,148,66,82,26.188,0,2018,3,121,305,194,0.874763347305877,-154,20.578021978022,73,1251.55865763446,-0.396417871732559
20916,524122.511,5333076.852,167,93,74,19.757,0,2019,2,131,293,185,0.896868116401408,-79.8,20.6626373626374,54,1251.55865763446,-0.396417871732559
20916,524122.511,5333076.852,0,0,0,22.584,0,2020,0,118,305,233,0.829366103621116,-19.2,19.0648351648352,115,1251.55865763446,-0.396417871732559
20934,524122.511,5328907.037,86,79,7,40.363,2,2001,2,112,296,185,0.814268340234772,103.5,18.1120879120879,73,1176.5339910683,-1.21945591665069
20934,524122.511,5328907.037,93,65,28,27.076,0,2002,2,123,286,178,0.812028584843553,46.4,18.2428571428571,55,1176.5339910683,-1.21945591665069
20934,524122.511,5328907.037,167,55,112,34.263,0,2003,2,113,279,162,0.776271356312413,-203.8,22.9692307692308,49,1176.5339910683,-1.21945591665069
20934,524122.511,5328907.037,178,100,78,26.664,0,2004,2,124,320,208,0.797798290406926,196.1,17.7461538461538,84,1176.5339910683,-1.21945591665069
20934,524122.511,5328907.037,159,93,66,34.089,0,2005,2,120,302,225,0.747653398372487,38.9,17.9032967032967,105,1176.5339910683,-1.21945591665069
20934,524122.511,5328907.037,182,60,122,28.905,0,2006,2,125,324,178,0.778654301394525,82.6,18.867032967033,53,1176.5339910683,-1.21945591665069
20934,524122.511,5328907.037,0,0,0,34.746,0,2007,0,110,285,162,0.770964612641566,317.9,17.0824175824176,52,1176.5339910683,-1.21945591665069
20934,524122.511,5328907.037,82,53,29,15.668,0,2008,1,131,298,194,0.798516718792434,40.8,17.6131868131868,63,1176.5339910683,-1.21945591665069
20934,524122.511,5328907.037,176,60,116,45.396,0,2009,2,100,296,177,0.811889310842874,41,18.5230769230769,77,1176.5339910683,-1.21945591665069
20934,524122.511,5328907.037,169,68,101,25.687,0,2010,2,123,299,193,0.786146653001591,122,18.3626373626374,70,1176.5339910683,-1.21945591665069
20934,524122.511,5328907.037,93,65,28,29.021,0,2011,2,106,315,170,0.790214898106331,127.1,17.5,64,1176.5339910683,-1.21945591665069
20934,524122.511,5328907.037,153,81,72,35.543,0,2012,3,117,303,201,0.802456045951426,82.8,18.7043956043956,84,1176.5339910683,-1.21945591665069
20934,524122.511,5328907.037,187,56,131,27.909,0,2013,3,127,300,184,0.784970232855557,-163.1,19.2582417582418,57,1176.5339910683,-1.21945591665069
20934,524122.511,5328907.037,155,50,105,35.971,2,2014,3,106,322,217,0.761266614033849,176.9,17.856043956044,111,1176.5339910683,-1.21945591665069
20934,524122.511,5328907.037,159,93,66,38.159,0,2015,1,111,314,169,0.767534081941913,-158.6,20.9142857142857,58,1176.5339910683,-1.21945591665069
20934,524122.511,5328907.037,173,111,62,30.443,0,2016,1,124,315,176,0.824378286882838,45.5,18.8857142857143,52,1176.5339910683,-1.21945591665069
20934,524122.511,5328907.037,144,100,44,27.161,0,2017,2,121,300,208,0.773131110603147,-10.8,19.7879120879121,87,1176.5339910683,-1.21945591665069
20934,524122.511,5328907.037,166,50,116,34.006,0,2018,2,112,303,169,0.826809280249963,-154,20.578021978022,57,1176.5339910683,-1.21945591665069
20934,524122.511,5328907.037,152,75,77,24.54,2,2019,2,126,313,178,0.735370646960071,-79.8,20.6626373626374,52,1176.5339910683,-1.21945591665069
20934,524122.511,5328907.037,0,0,0,20.946,0,2020,0,121,299,186,0.69881181382032,-19.2,19.0648351648352,65,1176.5339910683,-1.21945591665069
20935,524122.511,5328675.381,86,80,6,39.272,1,2001,2,113,299,161,0.783812908806375,103.5,18.1120879120879,48,1167.66564837693,1.41132534951549
20935,524122.511,5328675.381,93,64,29,33.203,0,2002,2,116,297,169,0.781509552047635,46.4,18.2428571428571,53,1167.66564837693,1.41132534951549
20935,524122.511,5328675.381,163,58,105,38.54,1,2003,2,108,287,161,0.791351027126533,-203.8,22.9692307692308,53,1167.66564837693,1.41132534951549
20935,524122.511,5328675.381,181,93,88,31.063,0,2004,1,119,327,169,0.860881482632606,196.1,17.7461538461538,50,1167.66564837693,1.41132534951549
20935,524122.511,5328675.381,162,98,64,46.32,0,2005,2,109,301,218,0.82183792285461,38.9,17.9032967032967,109,1167.66564837693,1.41132534951549
20935,524122.511,5328675.381,177,60,117,41.171,1,2006,2,114,329,169,0.775022827165658,82.6,18.867032967033,55,1167.66564837693,1.41132534951549
20935,524122.511,5328675.381,0,0,0,47.311,0,2007,0,95,295,224,0.829385576323531,317.9,17.0824175824176,129,1167.66564837693,1.41132534951549
20935,524122.511,5328675.381,83,54,29,24.635,0,2008,1,121,305,170,0.846805646306946,40.8,17.6131868131868,49,1167.66564837693,1.41132534951549
20935,524122.511,5328675.381,179,64,115,32.257,0,2009,2,112,291,169,0.824647568474115,41,18.5230769230769,57,1167.66564837693,1.41132534951549
20935,524122.511,5328675.381,168,68,100,32.534,0,2010,2,115,312,176,0.846201354344659,122,18.3626373626374,61,1167.66564837693,1.41132534951549
20935,524122.511,5328675.381,93,69,24,36.643,1,2011,3,97,320,256,0.800384840314965,127.1,17.5,159,1167.66564837693,1.41132534951549
20935,524122.511,5328675.381,153,81,72,38.851,0,2012,2,114,301,170,0.806796100101894,82.8,18.7043956043956,56,1167.66564837693,1.41132534951549
20935,524122.511,5328675.381,179,57,122,48.235,0,2013,2,109,293,177,0.809275337882592,-163.1,19.2582417582418,68,1167.66564837693,1.41132534951549
20935,524122.511,5328675.381,155,49,106,42.312,3,2014,2,97,336,161,0.800563553661662,176.9,17.856043956044,64,1167.66564837693,1.41132534951549
20935,524122.511,5328675.381,158,93,65,39.952,0,2015,1,109,302,154,0.765654820169271,-158.6,20.9142857142857,45,1167.66564837693,1.41132534951549
20935,524122.511,5328675.381,167,94,73,44.478,6,2016,1,111,321,162,0.838785587183844,45.5,18.8857142857143,51,1167.66564837693,1.41132534951549
20935,524122.511,5328675.381,142,95,47,31.805,3,2017,1,115,297,176,0.801947196434456,-10.8,19.7879120879121,61,1167.66564837693,1.41132534951549
20935,524122.511,5328675.381,160,49,111,47.939,0,2018,2,99,305,169,0.789415553591549,-154,20.578021978022,70,1167.66564837693,1.41132534951549
20935,524122.511,5328675.381,152,76,76,29,4,2019,2,121,327,170,0.799748946873784,-79.8,20.6626373626374,49,1167.66564837693,1.41132534951549
20935,524122.511,5328675.381,0,0,0,23.643,0,2020,0,116,301,177,0.741704940726411,-19.2,19.0648351648352,61,1167.66564837693,1.41132534951549
20981,524122.511,5318019.188,86,86,0,66.885,4,2001,2,88,314,176,0.870703897605529,-26.7,20.3989010989011,88,1056.78170138991,-0.516471852737982
20981,524122.511,5318019.188,93,93,0,37.317,0,2002,2,111,304,186,0.849616536669884,-5.6,20.2901098901099,75,1056.78170138991,-0.516471852737982
20981,524122.511,5318019.188,152,104,48,36.329,0,2003,1,106,300,153,0.816670937589331,-214.1,25.0835164835165,47,1056.78170138991,-0.516471852737982
20981,524122.511,5318019.188,128,100,28,34.944,0,2004,1,113,316,178,0.893828273879401,90.8,19.910989010989,65,1056.78170138991,-0.516471852737982
20981,524122.511,5318019.188,143,93,50,59.549,1,2005,2,94,305,176,0.869333563340968,-56.5,19.9923076923077,82,1056.78170138991,-0.516471852737982
20981,524122.511,5318019.188,186,63,123,27.458,0,2006,3,124,317,265,0.84801470632697,16.2,20.9538461538462,141,1056.78170138991,-0.516471852737982
20981,524122.511,5318019.188,0,0,0,52.354,0,2007,0,88,303,177,0.853812366247073,213,19.1032967032967,89,1056.78170138991,-0.516471852737982
20981,524122.511,5318019.188,0,0,0,43.354,0,2008,0,105,305,200,0.85128656728867,-1.79999999999999,19.6,95,1056.78170138991,-0.516471852737982
20981,524122.511,5318019.188,181,60,121,33.727,0,2009,3,108,302,153,0.87416371655047,-2.8,20.5450549450549,45,1056.78170138991,-0.516471852737982
20981,524122.511,5318019.188,167,93,74,27.543,0,2010,2,118,303,186,0.869697485585054,50.5,20.2241758241758,68,1056.78170138991,-0.516471852737982
20981,524122.511,5318019.188,86,69,17,34.527,0,2011,1,96,313,170,0.841644459183736,90.7,19.4164835164835,74,1056.78170138991,-0.516471852737982
20981,524122.511,5318019.188,133,94,39,51.129,2,2012,1,99,298,161,0.839764739587929,-6,20.743956043956,62,1056.78170138991,-0.516471852737982
20981,524122.511,5318019.188,152,57,95,36.779,0,2013,2,117,299,185,0.84652146755077,-200.2,21.3494505494505,68,1056.78170138991,-0.516471852737982
20981,524122.511,5318019.188,147,85,62,43.216,0,2014,2,93,312,178,0.867660464323965,51.4,19.8307692307692,85,1056.78170138991,-0.516471852737982
20981,524122.511,5318019.188,157,93,64,42.171,0,2015,1,106,322,161,0.880883494736675,-218.4,23.0318681318681,55,1056.78170138991,-0.516471852737982
20981,524122.511,5318019.188,161,94,67,54.855,1,2016,2,100,337,185,0.887909345644172,-39.8,20.9813186813187,85,1056.78170138991,-0.516471852737982
20981,524122.511,5318019.188,135,93,42,39.496,3,2017,1,102,295,177,0.834498891698653,-77.9,22.0516483516484,75,1056.78170138991,-0.516471852737982
20981,524122.511,5318019.188,149,66,83,57.081,1,2018,2,88,346,185,0.854975182107759,-139.3,22.7065934065934,97,1056.78170138991,-0.516471852737982
20981,524122.511,5318019.188,135,94,41,40.415,1,2019,1,107,324,176,0.84766099646294,-118.9,22.7472527472527,69,1056.78170138991,-0.516471852737982
20981,524122.511,5318019.188,93,93,0,35.21,0,2020,2,97,307,192,0.822162269233654,-119,21.1252747252747,95,1056.78170138991,-0.516471852737982
20982,524122.511,5317787.532,0,0,0,92.813,0,2001,3,68,323,169,0.859162118092275,-26.7,20.3989010989011,101,1094.93208758041,-1.22349940917836
20982,524122.511,5317787.532,125,79,46,39.88,0,2002,3,108,316,192,0.825180919478888,-5.6,20.2901098901099,84,1094.93208758041,-1.22349940917836
20982,524122.511,5317787.532,162,135,27,35.542,0,2003,1,107,303,154,0.826436833001654,-214.1,25.0835164835165,47,1094.93208758041,-1.22349940917836
20982,524122.511,5317787.532,144,100,44,34.944,0,2004,2,113,325,210,0.787402375005207,90.8,19.910989010989,97,1094.93208758041,-1.22349940917836
20982,524122.511,5317787.532,138,111,27,59.549,1,2005,1,94,306,168,0.860910891005198,-56.5,19.9923076923077,74,1094.93208758041,-1.22349940917836
20982,524122.511,5317787.532,185,57,128,40.567,0,2006,3,110,323,265,0.829813230694735,16.2,20.9538461538462,155,1094.93208758041,-1.22349940917836
20982,524122.511,5317787.532,112,80,32,48.223,0,2007,2,92,306,162,0.853259411636665,213,19.1032967032967,70,1094.93208758041,-1.22349940917836
20982,524122.511,5317787.532,0,0,0,43.354,0,2008,0,105,302,194,0.819133521046775,-1.79999999999999,19.6,89,1094.93208758041,-1.22349940917836
20982,524122.511,5317787.532,167,53,114,46.506,0,2009,2,94,301,153,0.836371227785407,-2.8,20.5450549450549,59,1094.93208758041,-1.22349940917836
20982,524122.511,5317787.532,174,136,38,28.28,0,2010,1,117,302,186,0.852405146065581,50.5,20.2241758241758,69,1094.93208758041,-1.22349940917836
20982,524122.511,5317787.532,86,62,24,35.373,0,2011,1,95,320,176,0.813772335908275,90.7,19.4164835164835,81,1094.93208758041,-1.22349940917836
20982,524122.511,5317787.532,145,103,42,47.418,1,2012,1,104,306,168,0.876272326093463,-6,20.743956043956,64,1094.93208758041,-1.22349940917836
20982,524122.511,5317787.532,182,104,78,42.419,0,2013,1,111,302,176,0.841076317062039,-200.2,21.3494505494505,65,1094.93208758041,-1.22349940917836
20982,524122.511,5317787.532,143,62,81,43.979,0,2014,2,92,320,176,0.841707310965371,51.4,19.8307692307692,84,1094.93208758041,-1.22349940917836
20982,524122.511,5317787.532,161,93,68,48.974,0,2015,1,99,326,162,0.852336281426527,-218.4,23.0318681318681,63,1094.93208758041,-1.22349940917836
20982,524122.511,5317787.532,172,135,37,47.88,1,2016,1,107,327,184,0.867074605187754,-39.8,20.9813186813187,77,1094.93208758041,-1.22349940917836
20982,524122.511,5317787.532,126,111,15,41.012,3,2017,1,100,297,169,0.806150623644765,-77.9,22.0516483516484,69,1094.93208758041,-1.22349940917836
20982,524122.511,5317787.532,171,59,112,43.16,0,2018,2,101,316,185,0.812680708161329,-139.3,22.7065934065934,84,1094.93208758041,-1.22349940917836
20982,524122.511,5317787.532,152,120,32,37.628,1,2019,1,110,324,170,0.819784317365803,-118.9,22.7472527472527,60,1094.93208758041,-1.22349940917836
20982,524122.511,5317787.532,93,93,0,37.668,1,2020,2,94,312,185,0.793106612144484,-119,21.1252747252747,91,1094.93208758041,-1.22349940917836
20983,524122.511,5317555.876,0,0,0,96.572,0,2001,1,65,326,168,0.867129348310246,-26.7,20.3989010989011,103,1093.20643233059,-0.565013971228902
20983,524122.511,5317555.876,128,79,49,35.63,0,2002,2,113,319,170,0.834379741758606,-5.6,20.2901098901099,57,1093.20643233059,-0.565013971228902
20983,524122.511,5317555.876,160,108,52,34.774,0,2003,1,108,300,160,0.826710337294156,-214.1,25.0835164835165,52,1093.20643233059,-0.565013971228902
20983,524122.511,5317555.876,144,100,44,37.746,0,2004,2,110,333,201,0.773552375900906,90.8,19.910989010989,91,1093.20643233059,-0.565013971228902
20983,524122.511,5317555.876,144,93,51,60.512,1,2005,1,93,312,162,0.866514662786636,-56.5,19.9923076923077,69,1093.20643233059,-0.565013971228902
20983,524122.511,5317555.876,180,60,120,61.423,5,2006,2,92,337,161,0.833761308021816,16.2,20.9538461538462,69,1093.20643233059,-0.565013971228902
20983,524122.511,5317555.876,112,93,19,56.671,0,2007,1,84,309,169,0.85777415755932,213,19.1032967032967,85,1093.20643233059,-0.565013971228902
20983,524122.511,5317555.876,0,0,0,53.315,0,2008,0,96,311,178,0.845915643815478,-1.79999999999999,19.6,82,1093.20643233059,-0.565013971228902
20983,524122.511,5317555.876,166,57,109,50.886,0,2009,2,90,309,146,0.833015330312115,-2.8,20.5450549450549,56,1093.20643233059,-0.565013971228902
20983,524122.511,5317555.876,174,136,38,29.802,0,2010,1,115,305,185,0.83779862609719,50.5,20.2241758241758,70,1093.20643233059,-0.565013971228902
20983,524122.511,5317555.876,86,62,24,37.912,0,2011,1,92,324,170,0.778901189215202,90.7,19.4164835164835,78,1093.20643233059,-0.565013971228902
20983,524122.511,5317555.876,145,104,41,51.864,2,2012,1,98,310,169,0.881878520096002,-6,20.743956043956,71,1093.20643233059,-0.565013971228902
20983,524122.511,5317555.876,189,93,96,35.767,0,2013,2,118,303,176,0.801994241411415,-200.2,21.3494505494505,58,1093.20643233059,-0.565013971228902
20983,524122.511,5317555.876,148,61,87,43.216,0,2014,2,93,322,169,0.82838493819465,51.4,19.8307692307692,76,1093.20643233059,-0.565013971228902
20983,524122.511,5317555.876,161,93,68,50.047,0,2015,1,98,340,145,0.791309315631427,-218.4,23.0318681318681,47,1093.20643233059,-0.565013971228902
20983,524122.511,5317555.876,172,133,39,50.947,1,2016,1,104,325,178,0.847751861177136,-39.8,20.9813186813187,74,1093.20643233059,-0.565013971228902
20983,524122.511,5317555.876,122,94,28,49.516,3,2017,1,90,303,161,0.788997822598336,-77.9,22.0516483516484,71,1093.20643233059,-0.565013971228902
20983,524122.511,5317555.876,168,64,104,50.602,0,2018,2,94,332,177,0.747562483777397,-139.3,22.7065934065934,83,1093.20643233059,-0.565013971228902
20983,524122.511,5317555.876,150,104,46,44.182,2,2019,1,103,338,162,0.799801487500528,-118.9,22.7472527472527,59,1093.20643233059,-0.565013971228902
20983,524122.511,5317555.876,93,93,0,47.533,11,2020,1,83,315,169,0.796830849695162,-119,21.1252747252747,86,1093.20643233059,-0.565013971228902
21065,524354.167,5349292.797,0,0,0,130.634,0,2001,2,33,292,192,0.86521226578984,118,17.3307692307692,159,1234.95319601562,-1.15495139312068
21065,524354.167,5349292.797,74,62,12,27.622,0,2002,1,122,314,178,0.859153711250849,53.4,17.5120879120879,56,1234.95319601562,-1.15495139312068
21065,524354.167,5349292.797,173,98,75,29.142,0,2003,1,119,291,185,0.830867322132947,-198.1,22.256043956044,66,1234.95319601562,-1.15495139312068
21065,524354.167,5349292.797,165,27,138,29.454,0,2004,2,120,305,178,0.803655147569725,210.8,17.0318681318681,58,1234.95319601562,-1.15495139312068
21065,524354.167,5349292.797,158,93,65,45.369,0,2005,1,109,308,178,0.8113484167014,45.7,17.2395604395604,69,1234.95319601562,-1.15495139312068
21065,524354.167,5349292.797,183,63,120,46.529,2,2006,2,108,328,184,0.819763731356925,93.4,18.2021978021978,76,1234.95319601562,-1.15495139312068
21065,524354.167,5349292.797,137,117,20,35.962,0,2007,1,108,293,194,0.825281864188208,334.9,16.4472527472527,86,1234.95319601562,-1.15495139312068
21065,524354.167,5349292.797,86,63,23,24.442,0,2008,1,121,300,177,0.81803519142612,51.4,16.9230769230769,56,1234.95319601562,-1.15495139312068
21065,524354.167,5349292.797,181,63,118,26.312,0,2009,3,119,281,217,0.830545006885059,56.1,17.7604395604396,98,1234.95319601562,-1.15495139312068
21065,524354.167,5349292.797,170,60,110,22.938,0,2010,3,125,299,225,0.855995856176202,134.3,17.6802197802198,100,1234.95319601562,-1.15495139312068
21065,524354.167,5349292.797,141,86,55,27.335,0,2011,2,107,312,178,0.835712836026587,136.8,16.9703296703297,71,1234.95319601562,-1.15495139312068
21065,524354.167,5349292.797,172,94,78,20.963,0,2012,1,131,313,178,0.838711156936575,90.5,18.343956043956,47,1234.95319601562,-1.15495139312068
21065,524354.167,5349292.797,193,63,130,20.364,1,2013,3,134,297,210,0.848753011760958,-155.5,18.543956043956,76,1234.95319601562,-1.15495139312068
21065,524354.167,5349292.797,159,50,109,28.294,0,2014,3,118,310,208,0.834015308010746,192.7,17.3769230769231,90,1234.95319601562,-1.15495139312068
21065,524354.167,5349292.797,167,70,97,33.522,0,2015,3,116,331,186,0.860915978613567,-153.6,20.3384615384615,70,1234.95319601562,-1.15495139312068
21065,524354.167,5349292.797,171,93,78,25.77,0,2016,2,128,323,193,0.843239173414,52.4,18.4901098901099,65,1234.95319601562,-1.15495139312068
21065,524354.167,5349292.797,139,99,40,28.537,0,2017,2,119,295,233,1.00262253286137,-1.7,19.1,114,1234.95319601562,-1.15495139312068
21065,524354.167,5349292.797,164,94,70,38.486,0,2018,2,106,319,192,0.858484180595615,-150.7,19.8846153846154,86,1234.95319601562,-1.15495139312068
21065,524354.167,5349292.797,165,93,72,27.975,4,2019,2,122,312,193,0.872252490917098,-73,20.0010989010989,71,1234.95319601562,-1.15495139312068
21065,524354.167,5349292.797,86,79,7,28.942,1,2020,1,107,316,240,0.802822517301229,-12.8,18.3098901098901,133,1234.95319601562,-1.15495139312068
21066,524354.167,5349061.14,0,0,0,28.937,0,2001,2,122,299,192,0.862936367110074,118,17.3307692307692,70,1241.22526742857,-0.717248811059513
21066,524354.167,5349061.14,86,75,11,23.78,0,2002,1,126,316,201,0.846955411870997,53.4,17.5120879120879,75,1241.22526742857,-0.717248811059513
21066,524354.167,5349061.14,174,96,78,25.583,0,2003,2,123,287,193,0.851317303319354,-198.1,22.256043956044,70,1241.22526742857,-0.717248811059513
21066,524354.167,5349061.14,169,26,143,19.747,0,2004,2,131,306,178,0.796764873137528,210.8,17.0318681318681,47,1241.22526742857,-0.717248811059513
21066,524354.167,5349061.14,159,93,66,38.952,0,2005,2,115,310,186,0.839246006185783,45.7,17.2395604395604,71,1241.22526742857,-0.717248811059513
21066,524354.167,5349061.14,189,68,121,25.613,1,2006,2,128,325,193,0.837875437842662,93.4,18.2021978021978,65,1241.22526742857,-0.717248811059513
21066,524354.167,5349061.14,134,120,14,33.878,0,2007,1,111,290,200,0.824303267564227,334.9,16.4472527472527,89,1241.22526742857,-0.717248811059513
21066,524354.167,5349061.14,86,63,23,20.614,0,2008,1,125,295,193,0.841082945225525,51.4,16.9230769230769,68,1241.22526742857,-0.717248811059513
21066,524354.167,5349061.14,180,62,118,21.437,0,2009,3,125,283,193,0.850504615465173,56.1,17.7604395604396,68,1241.22526742857,-0.717248811059513
21066,524354.167,5349061.14,175,61,114,20.692,0,2010,2,128,299,194,0.841680904120071,134.3,17.6802197802198,66,1241.22526742857,-0.717248811059513
21066,524354.167,5349061.14,139,93,46,24.513,0,2011,2,111,316,185,0.840573061694177,136.8,16.9703296703297,74,1241.22526742857,-0.717248811059513
21066,524354.167,5349061.14,176,99,77,20.963,0,2012,1,131,311,186,0.850053504386387,90.5,18.343956043956,55,1241.22526742857,-0.717248811059513
21066,524354.167,5349061.14,194,63,131,17.412,1,2013,3,137,300,217,0.855742594714049,-155.5,18.543956043956,80,1241.22526742857,-0.717248811059513
21066,524354.167,5349061.14,159,51,108,25.661,0,2014,3,122,309,209,0.842673153291255,192.7,17.3769230769231,87,1241.22526742857,-0.717248811059513
21066,524354.167,5349061.14,167,71,96,25.906,0,2015,3,124,320,194,0.87281222833388,-153.6,20.3384615384615,70,1241.22526742857,-0.717248811059513
21066,524354.167,5349061.14,166,94,72,24.799,0,2016,2,129,337,217,0.880121166388196,52.4,18.4901098901099,88,1241.22526742857,-0.717248811059513
21066,524354.167,5349061.14,137,94,43,29.329,1,2017,2,118,291,218,0.881327300568314,-1.7,19.1,100,1241.22526742857,-0.717248811059513
21066,524354.167,5349061.14,169,103,66,32.196,0,2018,1,113,314,170,0.892676239754002,-150.7,19.8846153846154,57,1241.22526742857,-0.717248811059513
21066,524354.167,5349061.14,162,94,68,27.111,4,2019,2,123,307,194,0.864626447098526,-73,20.0010989010989,71,1241.22526742857,-0.717248811059513
21066,524354.167,5349061.14,86,65,21,23.652,1,2020,1,116,316,226,0.833051694025172,-12.8,18.3098901098901,110,1241.22526742857,-0.717248811059513
21067,524354.167,5348829.484,86,85,1,24.925,0,2001,2,126,309,193,0.853702114321292,118,17.3307692307692,67,1236.77488003266,-0.516014724915892
21067,524354.167,5348829.484,86,71,15,18.985,0,2002,1,131,313,249,0.784306445796308,53.4,17.5120879120879,118,1236.77488003266,-0.516014724915892
21067,524354.167,5348829.484,181,79,102,23.802,0,2003,3,125,287,217,0.811436188390518,-198.1,22.256043956044,92,1236.77488003266,-0.516014724915892
21067,524354.167,5348829.484,176,30,146,19.747,0,2004,2,131,322,193,0.818516983203218,210.8,17.0318681318681,62,1236.77488003266,-0.516014724915892
21067,524354.167,5348829.484,157,93,64,37.861,0,2005,2,116,311,192,0.843483249064046,45.7,17.2395604395604,76,1236.77488003266,-0.516014724915892
21067,524354.167,5348829.484,196,66,130,19.757,1,2006,4,134,324,186,0.819676518034055,93.4,18.2021978021978,52,1236.77488003266,-0.516014724915892
21067,524354.167,5348829.484,142,93,49,31.315,0,2007,3,115,288,193,0.832855415670188,334.9,16.4472527472527,78,1236.77488003266,-0.516014724915892
21067,524354.167,5348829.484,129,52,77,17.183,0,2008,3,129,293,185,0.853882514054932,51.4,16.9230769230769,56,1236.77488003266,-0.516014724915892
21067,524354.167,5348829.484,176,64,112,22.238,0,2009,3,124,280,193,0.853744534423959,56.1,17.7604395604396,69,1236.77488003266,-0.516014724915892
21067,524354.167,5348829.484,179,62,117,13.85,0,2010,3,136,295,217,0.849854744605203,134.3,17.6802197802198,81,1236.77488003266,-0.516014724915892
21067,524354.167,5348829.484,148,85,63,22.557,0,2011,3,114,314,186,0.822820715815567,136.8,16.9703296703297,72,1236.77488003266,-0.516014724915892
21067,524354.167,5348829.484,160,94,66,31.85,0,2012,2,120,303,201,0.846428887089283,90.5,18.343956043956,81,1236.77488003266,-0.516014724915892
21067,524354.167,5348829.484,182,93,89,20.364,1,2013,2,134,296,209,0.861462366554758,-155.5,18.543956043956,75,1236.77488003266,-0.516014724915892
21067,524354.167,5348829.484,151,43,108,21.043,0,2014,3,128,309,218,0.842585015354027,192.7,17.3769230769231,90,1236.77488003266,-0.516014724915892
21067,524354.167,5348829.484,171,71,100,24.707,0,2015,3,125,326,200,0.856027605383282,-153.6,20.3384615384615,75,1236.77488003266,-0.516014724915892
21067,524354.167,5348829.484,169,105,64,24.799,0,2016,1,129,329,186,0.810100725497927,52.4,18.4901098901099,57,1236.77488003266,-0.516014724915892
21067,524354.167,5348829.484,154,99,55,27.755,0,2017,2,120,297,202,0.857642746391549,-1.7,19.1,82,1236.77488003266,-0.516014724915892
21067,524354.167,5348829.484,172,51,121,25.612,0,2018,3,121,314,185,0.857338316540943,-150.7,19.8846153846154,64,1236.77488003266,-0.516014724915892
21067,524354.167,5348829.484,167,93,74,20.724,0,2019,2,130,295,201,0.861279003132872,-73,20.0010989010989,71,1236.77488003266,-0.516014724915892
21067,524354.167,5348829.484,0,0,0,20.372,0,2020,0,122,310,209,0.83692319210385,-12.8,18.3098901098901,87,1236.77488003266,-0.516014724915892
21068,524354.167,5348597.828,86,85,1,127.372,35,2001,3,36,299,194,0.839149445195351,118,17.3307692307692,158,1252.63986087947,-1.04352626304439
21068,524354.167,5348597.828,84,67,17,22.785,0,2002,1,127,314,250,0.775929144403407,53.4,17.5120879120879,123,1252.63986087947,-1.04352626304439
21068,524354.167,5348597.828,175,76,99,30.761,0,2003,3,117,291,226,0.793494918708485,-198.1,22.256043956044,109,1252.63986087947,-1.04352626304439
21068,524354.167,5348597.828,175,30,145,18.678,0,2004,2,132,316,202,0.791940251856161,210.8,17.0318681318681,70,1252.63986087947,-1.04352626304439
21068,524354.167,5348597.828,157,93,64,37.861,0,2005,2,116,312,193,0.841694710828126,45.7,17.2395604395604,77,1252.63986087947,-1.04352626304439
21068,524354.167,5348597.828,196,66,130,19.757,1,2006,4,134,322,192,0.815985536562232,93.4,18.2021978021978,58,1252.63986087947,-1.04352626304439
21068,524354.167,5348597.828,143,93,50,28.901,0,2007,3,119,288,200,0.829426841593951,334.9,16.4472527472527,81,1252.63986087947,-1.04352626304439
21068,524354.167,5348597.828,132,51,81,14.883,0,2008,3,132,293,192,0.828734385263278,51.4,16.9230769230769,60,1252.63986087947,-1.04352626304439
21068,524354.167,5348597.828,181,64,117,19.095,0,2009,3,128,287,194,0.839378647637495,56.1,17.7604395604396,66,1252.63986087947,-1.04352626304439
21068,524354.167,5348597.828,173,67,106,14.749,0,2010,3,135,291,200,0.820204522448321,134.3,17.6802197802198,65,1252.63986087947,-1.04352626304439
21068,524354.167,5348597.828,147,93,54,23.194,0,2011,2,113,320,201,0.807861830637273,136.8,16.9703296703297,88,1252.63986087947,-1.04352626304439
21068,524354.167,5348597.828,162,103,59,30.867,0,2012,1,121,306,192,0.858272347213399,90.5,18.343956043956,71,1252.63986087947,-1.04352626304439
21068,524354.167,5348597.828,183,106,77,18.412,1,2013,2,136,296,217,0.854392388318503,-155.5,18.543956043956,81,1252.63986087947,-1.04352626304439
21068,524354.167,5348597.828,152,42,110,20.253,0,2014,3,129,309,209,0.797633587072556,192.7,17.3769230769231,80,1252.63986087947,-1.04352626304439
21068,524354.167,5348597.828,176,71,105,19.353,0,2015,2,130,319,201,0.852642359957039,-153.6,20.3384615384615,71,1252.63986087947,-1.04352626304439
21068,524354.167,5348597.828,172,128,44,17.138,0,2016,2,137,331,257,0.771523713961642,52.4,18.4901098901099,120,1252.63986087947,-1.04352626304439
21068,524354.167,5348597.828,154,109,45,24.639,0,2017,2,124,298,209,0.852803058821353,-1.7,19.1,85,1252.63986087947,-1.04352626304439
21068,524354.167,5348597.828,167,51,116,27.214,0,2018,3,119,315,201,0.857883126057465,-150.7,19.8846153846154,82,1252.63986087947,-1.04352626304439
21068,524354.167,5348597.828,167,93,74,22.657,0,2019,2,128,298,200,0.839909530361865,-73,20.0010989010989,72,1252.63986087947,-1.04352626304439
21068,524354.167,5348597.828,0,0,0,24.189,0,2020,0,115,312,216,0.840278043908036,-12.8,18.3098901098901,101,1252.63986087947,-1.04352626304439
21069,524354.167,5348366.171,0,0,0,122.632,0,2001,2,40,278,194,0.844247809656627,118,17.3307692307692,154,1266.82148194543,0.915520035361364
21069,524354.167,5348366.171,62,52,10,20.858,0,2002,1,129,318,201,0.849129156348019,53.4,17.5120879120879,72,1266.82148194543,0.915520035361364
21069,524354.167,5348366.171,167,101,66,29.946,0,2003,2,118,290,201,0.8271412241071,-198.1,22.256043956044,83,1266.82148194543,0.915520035361364
21069,524354.167,5348366.171,175,27,148,12.714,0,2004,3,138,330,210,0.843761640668173,210.8,17.0318681318681,72,1266.82148194543,0.915520035361364
21069,524354.167,5348366.171,163,93,70,35.677,0,2005,2,118,313,193,0.83306461060218,45.7,17.2395604395604,75,1266.82148194543,0.915520035361364
21069,524354.167,5348366.171,189,63,126,29.107,1,2006,2,124,339,192,0.816193094930893,93.4,18.2021978021978,68,1266.82148194543,0.915520035361364
21069,524354.167,5348366.171,93,93,0,27.64,0,2007,2,121,294,193,0.84017679220835,334.9,16.4472527472527,72,1266.82148194543,0.915520035361364
21069,524354.167,5348366.171,137,57,80,12.777,0,2008,3,135,294,216,0.809727379929748,51.4,16.9230769230769,81,1266.82148194543,0.915520035361364
21069,524354.167,5348366.171,190,65,125,18.318,0,2009,2,129,313,201,0.839007150685782,56.1,17.7604395604396,72,1266.82148194543,0.915520035361364
21069,524354.167,5348366.171,164,69,95,21.471,0,2010,3,127,292,202,0.835348820327722,134.3,17.6802197802198,75,1266.82148194543,0.915520035361364
21069,524354.167,5348366.171,150,64,86,24.513,0,2011,3,111,321,210,0.782289879812475,136.8,16.9703296703297,99,1266.82148194543,0.915520035361364
21069,524354.167,5348366.171,163,94,69,34.981,0,2012,2,117,306,226,0.828165403268228,90.5,18.343956043956,109,1266.82148194543,0.915520035361364
21069,524354.167,5348366.171,181,67,114,21.365,1,2013,2,133,297,210,0.851203539008929,-155.5,18.543956043956,77,1266.82148194543,0.915520035361364
21069,524354.167,5348366.171,161,43,118,27.023,0,2014,3,120,309,216,0.790741675464762,192.7,17.3769230769231,96,1266.82148194543,0.915520035361364
21069,524354.167,5348366.171,172,75,97,24.707,0,2015,3,125,316,202,0.849225124865793,-153.6,20.3384615384615,77,1266.82148194543,0.915520035361364
21069,524354.167,5348366.171,172,128,44,14.2,0,2016,2,140,334,225,0.836776085655251,52.4,18.4901098901099,85,1266.82148194543,0.915520035361364
21069,524354.167,5348366.171,150,97,53,26.986,0,2017,2,121,297,193,0.838030759767525,-1.7,19.1,72,1266.82148194543,0.915520035361364
21069,524354.167,5348366.171,180,94,86,16.321,0,2018,2,134,325,201,0.852901327753027,-150.7,19.8846153846154,67,1266.82148194543,0.915520035361364
21069,524354.167,5348366.171,0,0,0,25.341,0,2019,0,125,297,201,0.837320561222121,-73,20.0010989010989,76,1266.82148194543,0.915520035361364
21069,524354.167,5348366.171,86,51,35,114.121,41,2020,1,25,328,224,0.83027769205945,-12.8,18.3098901098901,199,1266.82148194543,0.915520035361364
21070,524354.167,5348134.515,0,0,0,131.708,0,2001,3,32,297,194,0.853747087679235,118,17.3307692307692,162,1251.42260160341,1.26302970983174
21070,524354.167,5348134.515,86,86,0,23.78,0,2002,1,126,319,193,0.852801526292983,53.4,17.5120879120879,67,1251.42260160341,1.26302970983174
21070,524354.167,5348134.515,170,103,67,29.142,0,2003,2,119,290,192,0.826649943892834,-198.1,22.256043956044,73,1251.42260160341,1.26302970983174
21070,524354.167,5348134.515,179,27,152,13.645,0,2004,3,137,338,226,0.825498454900482,210.8,17.0318681318681,89,1251.42260160341,1.26302970983174
21070,524354.167,5348134.515,158,93,65,38.952,0,2005,2,115,312,193,0.848592310041655,45.7,17.2395604395604,78,1251.42260160341,1.26302970983174
21070,524354.167,5348134.515,188,62,126,31.944,1,2006,3,121,339,192,0.83060221019711,93.4,18.2021978021978,71,1251.42260160341,1.26302970983174
21070,524354.167,5348134.515,133,93,40,36.683,0,2007,3,107,295,185,0.846374821161005,334.9,16.4472527472527,78,1251.42260160341,1.26302970983174
21070,524354.167,5348134.515,134,59,75,13.462,0,2008,3,134,303,224,0.830664898350154,51.4,16.9230769230769,90,1251.42260160341,1.26302970983174
21070,524354.167,5348134.515,189,67,122,23.052,0,2009,2,123,317,194,0.85509085205474,56.1,17.7604395604396,71,1251.42260160341,1.26302970983174
21070,524354.167,5348134.515,164,70,94,16.559,0,2010,3,133,295,194,0.836020171760441,134.3,17.6802197802198,61,1251.42260160341,1.26302970983174
21070,524354.167,5348134.515,151,65,86,27.335,0,2011,3,107,323,249,0.770216668982536,136.8,16.9703296703297,142,1251.42260160341,1.26302970983174
21070,524354.167,5348134.515,163,94,69,40.189,0,2012,2,112,309,232,0.828923762260884,90.5,18.343956043956,120,1251.42260160341,1.26302970983174
21070,524354.167,5348134.515,178,68,110,19.383,1,2013,3,135,298,209,0.857441957146268,-155.5,18.543956043956,74,1251.42260160341,1.26302970983174
21070,524354.167,5348134.515,161,43,118,30.074,0,2014,3,115,314,202,0.771859664867348,192.7,17.3769230769231,87,1251.42260160341,1.26302970983174
21070,524354.167,5348134.515,170,76,94,27.126,0,2015,3,123,315,194,0.855821211232902,-153.6,20.3384615384615,71,1251.42260160341,1.26302970983174
21070,524354.167,5348134.515,168,94,74,27.813,0,2016,2,126,333,257,0.784763863861684,52.4,18.4901098901099,131,1251.42260160341,1.26302970983174
21070,524354.167,5348134.515,150,94,56,26.986,0,2017,2,121,300,185,0.842826261002987,-1.7,19.1,64,1251.42260160341,1.26302970983174
21070,524354.167,5348134.515,180,94,86,21.784,0,2018,2,126,336,186,0.833824034563625,-150.7,19.8846153846154,60,1251.42260160341,1.26302970983174
21070,524354.167,5348134.515,0,0,0,25.341,0,2019,0,125,299,193,0.852358978779267,-73,20.0010989010989,68,1251.42260160341,1.26302970983174
21070,524354.167,5348134.515,128,51,77,27.686,1,2020,3,109,333,226,0.818964456681475,-12.8,18.3098901098901,117,1251.42260160341,1.26302970983174
21071,524354.167,5347902.859,0,0,0,33.189,0,2001,2,118,299,193,0.852140189302284,118,17.3307692307692,75,1231.35830440447,-0.820924503884301
21071,524354.167,5347902.859,86,69,17,22.785,0,2002,1,127,323,210,0.80886823107948,53.4,17.5120879120879,83,1231.35830440447,-0.820924503884301
21071,524354.167,5347902.859,172,82,90,27.419,0,2003,3,121,291,192,0.839663705777506,-198.1,22.256043956044,71,1231.35830440447,-0.820924503884301
21071,524354.167,5347902.859,175,30,145,21.802,0,2004,3,129,308,192,0.811904028275967,210.8,17.0318681318681,63,1231.35830440447,-0.820924503884301
21071,524354.167,5347902.859,0,0,0,28.707,0,2005,0,125,314,185,0.839294081752846,45.7,17.2395604395604,60,1231.35830440447,-0.820924503884301
21071,524354.167,5347902.859,183,118,65,24.668,1,2006,1,129,339,192,0.824788948683539,93.4,18.2021978021978,63,1231.35830440447,-0.820924503884301
21071,524354.167,5347902.859,0,0,0,44.108,0,2007,0,98,293,169,0.86180836239234,334.9,16.4472527472527,71,1231.35830440447,-0.820924503884301
21071,524354.167,5347902.859,110,55,55,15.623,0,2008,3,131,305,225,0.8389582235433,51.4,16.9230769230769,94,1231.35830440447,-0.820924503884301
21071,524354.167,5347902.859,177,62,115,29.679,0,2009,3,115,287,194,0.851463170272632,56.1,17.7604395604396,79,1231.35830440447,-0.820924503884301
21071,524354.167,5347902.859,173,112,61,23.649,0,2010,1,124,298,192,0.828015647548619,134.3,17.6802197802198,68,1231.35830440447,-0.820924503884301
21071,524354.167,5347902.859,141,65,76,30.373,1,2011,4,103,323,194,0.79784620943967,136.8,16.9703296703297,91,1231.35830440447,-0.820924503884301
21071,524354.167,5347902.859,164,94,70,78.451,5,2012,2,69,298,210,0.828977762723741,90.5,18.343956043956,141,1231.35830440447,-0.820924503884301
21071,524354.167,5347902.859,182,58,124,20.364,1,2013,3,134,298,210,0.845556510778839,-155.5,18.543956043956,76,1231.35830440447,-0.820924503884301
21071,524354.167,5347902.859,145,54,91,31.88,0,2014,3,112,342,210,0.818045739789195,192.7,17.3769230769231,98,1231.35830440447,-0.820924503884301
21071,524354.167,5347902.859,168,93,75,33.522,0,2015,2,116,317,185,0.847226993856781,-153.6,20.3384615384615,69,1231.35830440447,-0.820924503884301
21071,524354.167,5347902.859,166,93,73,26.773,0,2016,2,127,336,186,0.827239332990937,52.4,18.4901098901099,59,1231.35830440447,-0.820924503884301
21071,524354.167,5347902.859,141,94,47,30.85,3,2017,2,116,299,186,0.837882683625596,-1.7,19.1,70,1231.35830440447,-0.820924503884301
21071,524354.167,5347902.859,170,60,110,34.723,0,2018,3,110,322,185,0.83328548739192,-150.7,19.8846153846154,75,1231.35830440447,-0.820924503884301
21071,524354.167,5347902.859,151,99,52,28.844,4,2019,2,121,301,193,0.850017464306557,-73,20.0010989010989,72,1231.35830440447,-0.820924503884301
21071,524354.167,5347902.859,0,0,0,30.252,0,2020,0,105,330,226,0.810557254101195,-12.8,18.3098901098901,121,1231.35830440447,-0.820924503884301
21077,524354.167,5346512.921,0,0,0,55.737,0,2001,2,98,317,193,0.808569304560867,118,17.3307692307692,95,1072.37104710769,-0.930959004556452
21077,524354.167,5346512.921,93,74,19,47.339,3,2002,3,98,292,225,0.816085773055167,53.4,17.5120879120879,127,1072.37104710769,-0.930959004556452
21077,524354.167,5346512.921,162,93,69,44.428,2,2003,1,101,337,169,0.81643966206826,-198.1,22.256043956044,68,1072.37104710769,-0.930959004556452
21077,524354.167,5346512.921,165,44,121,39.372,0,2004,2,109,337,176,0.793142259323563,210.8,17.0318681318681,67,1072.37104710769,-0.930959004556452
21077,524354.167,5346512.921,161,105,56,59.785,2,2005,1,96,314,169,0.831309276840623,45.7,17.2395604395604,73,1072.37104710769,-0.930959004556452
21077,524354.167,5346512.921,195,61,134,31.944,1,2006,2,121,345,169,0.819049174877513,93.4,18.2021978021978,48,1072.37104710769,-0.930959004556452
21077,524354.167,5346512.921,0,0,0,118.536,0,2007,0,29,302,169,0.819505174379159,334.9,16.4472527472527,140,1072.37104710769,-0.930959004556452
21077,524354.167,5346512.921,168,59,109,46.948,3,2008,2,101,312,161,0.830275690046464,51.4,16.9230769230769,60,1072.37104710769,-0.930959004556452
21077,524354.167,5346512.921,180,84,96,38.272,0,2009,2,106,326,170,0.848590526608381,56.1,17.7604395604396,64,1072.37104710769,-0.930959004556452
21077,524354.167,5346512.921,161,77,84,34.518,0,2010,2,110,315,169,0.795725483604338,134.3,17.6802197802198,59,1072.37104710769,-0.930959004556452
21077,524354.167,5346512.921,86,85,1,47.31,1,2011,1,83,325,153,0.789672964591493,136.8,16.9703296703297,70,1072.37104710769,-0.930959004556452
21077,524354.167,5346512.921,164,93,71,39.243,0,2012,1,113,325,170,0.832003405670603,90.5,18.343956043956,57,1072.37104710769,-0.930959004556452
21077,524354.167,5346512.921,173,76,97,48.039,1,2013,3,107,298,185,0.825239121060951,-155.5,18.543956043956,78,1072.37104710769,-0.930959004556452
21077,524354.167,5346512.921,93,50,43,47.665,3,2014,3,89,323,216,0.803617383411784,192.7,17.3769230769231,127,1072.37104710769,-0.930959004556452
21077,524354.167,5346512.921,166,93,73,43.717,0,2015,1,104,346,153,0.805443930323123,-153.6,20.3384615384615,49,1072.37104710769,-0.930959004556452
21077,524354.167,5346512.921,171,94,77,47.357,7,2016,2,108,340,226,0.824138245220109,52.4,18.4901098901099,118,1072.37104710769,-0.930959004556452
21077,524354.167,5346512.921,148,99,49,44.802,7,2017,1,97,296,184,0.823159797927252,-1.7,19.1,87,1072.37104710769,-0.930959004556452
21077,524354.167,5346512.921,165,43,122,48.951,0,2018,3,96,326,281,0.771573182357087,-150.7,19.8846153846154,185,1072.37104710769,-0.930959004556452
21077,524354.167,5346512.921,166,80,86,41.652,4,2019,2,106,318,161,0.791567674546728,-73,20.0010989010989,55,1072.37104710769,-0.930959004556452
21077,524354.167,5346512.921,0,0,0,59.934,0,2020,0,72,320,177,0.799472038339219,-12.8,18.3098901098901,105,1072.37104710769,-0.930959004556452
21127,524354.167,5334930.103,0,0,0,85.881,0,2001,2,74,298,178,0.869095708217474,116.8,17.4,104,1213.74234332218,0.598561856983567
21127,524354.167,5334930.103,86,70,16,32.329,0,2002,1,117,306,217,0.845647320542431,52.7,17.567032967033,100,1213.74234332218,0.598561856983567
21127,524354.167,5334930.103,146,93,53,34.588,0,2003,1,113,328,176,0.839720199627724,-198,22.3252747252747,63,1213.74234332218,0.598561856983567
21127,524354.167,5334930.103,146,94,52,29.894,0,2004,2,120,299,202,0.840936086627626,209.7,17.0835164835165,82,1213.74234332218,0.598561856983567
21127,524354.167,5334930.103,0,0,0,41.777,0,2005,0,113,299,210,0.833100204944434,44.2,17.3054945054945,97,1213.74234332218,0.598561856983567
21127,524354.167,5334930.103,186,52,134,28.664,1,2006,2,125,335,177,0.836351272144911,92.3,18.2626373626374,52,1213.74234332218,0.598561856983567
21127,524354.167,5334930.103,0,0,0,45.71,0,2007,0,97,279,209,0.865046065825709,332.6,16.5076923076923,112,1213.74234332218,0.598561856983567
21127,524354.167,5334930.103,0,0,0,23.59,0,2008,0,122,302,224,0.854532649291897,50.1,16.9747252747253,102,1213.74234332218,0.598561856983567
21127,524354.167,5334930.103,123,75,48,36.617,0,2009,2,108,310,169,0.899793228424981,55,17.8153846153846,61,1213.74234332218,0.598561856983567
21127,524354.167,5334930.103,170,93,77,26.07,0,2010,2,121,307,186,0.871644240735661,133.1,17.7351648351648,65,1213.74234332218,0.598561856983567
21127,524354.167,5334930.103,0,0,0,36.327,0,2011,0,96,316,225,0.826964415357005,136.1,17.0351648351648,129,1213.74234332218,0.598561856983567
21127,524354.167,5334930.103,0,0,0,32.403,0,2012,0,120,295,176,0.890331571944991,88.9,18.4296703296703,56,1213.74234332218,0.598561856983567
21127,524354.167,5334930.103,173,62,111,26.812,1,2013,3,128,301,185,0.861487193956709,-156.9,18.6175824175824,57,1213.74234332218,0.598561856983567
21127,524354.167,5334930.103,93,93,0,34.896,1,2014,1,108,327,177,0.843511161837798,191.6,17.4516483516484,69,1213.74234332218,0.598561856983567
21127,524354.167,5334930.103,139,93,46,39.889,0,2015,1,109,337,162,0.858228893372332,-154.6,20.4153846153846,53,1213.74234332218,0.598561856983567
21127,524354.167,5334930.103,168,95,73,27.214,0,2016,2,127,330,202,0.871552730730926,50.9,18.5681318681319,75,1213.74234332218,0.598561856983567
21127,524354.167,5334930.103,94,94,0,35.057,4,2017,1,111,307,176,0.85749543052305,-2.3,19.1582417582418,65,1213.74234332218,0.598561856983567
21127,524354.167,5334930.103,0,0,0,29.987,0,2018,0,116,297,225,0.831146375077221,-151.3,19.9417582417582,109,1213.74234332218,0.598561856983567
21127,524354.167,5334930.103,0,0,0,25.763,0,2019,0,125,299,177,0.862685517358135,-73.4,20.0571428571429,52,1213.74234332218,0.598561856983567
21127,524354.167,5334930.103,0,0,0,31.826,0,2020,0,103,309,202,0.799276769188871,-13.6,18.3758241758242,99,1213.74234332218,0.598561856983567
21202,524354.167,5317555.876,0,0,0,91.553,0,2001,2,69,323,176,0.863942265050833,-26.7,20.3989010989011,107,1104.22116094234,-0.626881941421404
21202,524354.167,5317555.876,128,79,49,35.63,0,2002,3,113,312,185,0.824919970299378,-5.6,20.2901098901099,72,1104.22116094234,-0.626881941421404
21202,524354.167,5317555.876,160,93,67,30.987,0,2003,1,113,287,161,0.824344150822783,-214.1,25.0835164835165,48,1104.22116094234,-0.626881941421404
21202,524354.167,5317555.876,144,99,45,33.12,0,2004,2,115,335,194,0.759130115381649,90.8,19.910989010989,79,1104.22116094234,-0.626881941421404
21202,524354.167,5317555.876,139,110,29,61.495,1,2005,1,92,311,161,0.869098277122199,-56.5,19.9923076923077,69,1104.22116094234,-0.626881941421404
21202,524354.167,5317555.876,186,61,125,41.625,0,2006,3,109,329,162,0.817069451538819,16.2,20.9538461538462,53,1104.22116094234,-0.626881941421404
21202,524354.167,5317555.876,111,82,29,51.316,0,2007,2,89,309,162,0.843917568604253,213,19.1032967032967,73,1104.22116094234,-0.626881941421404
21202,524354.167,5317555.876,0,0,0,51.257,0,2008,0,98,308,201,0.778951469534197,-1.79999999999999,19.6,103,1104.22116094234,-0.626881941421404
21202,524354.167,5317555.876,165,57,108,54.478,0,2009,2,87,307,168,0.864527909222299,-2.8,20.5450549450549,81,1104.22116094234,-0.626881941421404
21202,524354.167,5317555.876,174,124,50,30.589,0,2010,1,114,304,185,0.823224494554836,50.5,20.2241758241758,71,1104.22116094234,-0.626881941421404
21202,524354.167,5317555.876,86,61,25,40.481,0,2011,1,89,335,168,0.744103894517909,90.7,19.4164835164835,79,1104.22116094234,-0.626881941421404
21202,524354.167,5317555.876,143,94,49,51.129,2,2012,1,99,309,169,0.877526364517696,-6,20.743956043956,70,1104.22116094234,-0.626881941421404
21202,524354.167,5317555.876,185,105,80,38.585,0,2013,1,115,293,169,0.813204928802601,-200.2,21.3494505494505,54,1104.22116094234,-0.626881941421404
21202,524354.167,5317555.876,143,59,84,46.341,0,2014,2,89,324,176,0.8058819082414,51.4,19.8307692307692,87,1104.22116094234,-0.626881941421404
21202,524354.167,5317555.876,165,125,40,50.047,0,2015,1,98,340,144,0.782415184094752,-218.4,23.0318681318681,46,1104.22116094234,-0.626881941421404
21202,524354.167,5317555.876,167,94,73,60.866,1,2016,2,94,329,185,0.82569759835895,-39.8,20.9813186813187,91,1104.22116094234,-0.626881941421404
21202,524354.167,5317555.876,122,94,28,47.711,3,2017,1,92,300,154,0.755726103715221,-77.9,22.0516483516484,62,1104.22116094234,-0.626881941421404
21202,524354.167,5317555.876,170,60,110,44.18,0,2018,2,100,333,168,0.748682266090736,-139.3,22.7065934065934,68,1104.22116094234,-0.626881941421404
21202,524354.167,5317555.876,148,93,55,47.103,2,2019,1,100,338,161,0.776992178930536,-118.9,22.7472527472527,61,1104.22116094234,-0.626881941421404
21202,524354.167,5317555.876,93,93,0,48.508,11,2020,1,82,315,176,0.763440368732546,-119,21.1252747252747,94,1104.22116094234,-0.626881941421404
21283,524585.823,5349524.453,0,0,0,27.48,0,2001,2,123,304,185,0.82602124751651,-10.6,19.1659340659341,62,1230.28657462628,-1.15708494491614
21283,524585.823,5349524.453,86,52,34,20.88,0,2002,1,129,315,185,0.796013864596733,6.29999999999999,19.1637362637363,56,1230.28657462628,-1.15708494491614
21283,524585.823,5349524.453,177,84,93,25.196,0,2003,2,121,298,169,0.781027671396603,-207.1,23.9516483516484,48,1230.28657462628,-1.15708494491614
21283,524585.823,5349524.453,178,56,122,19.09,0,2004,3,131,306,209,0.827340749071128,109,18.7549450549451,78,1230.28657462628,-1.15708494491614
21283,524585.823,5349524.453,171,94,77,31.193,0,2005,1,121,306,178,0.825371801818499,-46.2,18.9098901098901,57,1230.28657462628,-1.15708494491614
21283,524585.823,5349524.453,198,93,105,21.457,0,2006,2,131,334,184,0.812476316690243,29.4,19.8868131868132,53,1230.28657462628,-1.15708494491614
21283,524585.823,5349524.453,0,0,0,37.213,0,2007,0,104,292,186,0.816790633757608,236.4,18.0659340659341,82,1230.28657462628,-1.15708494491614
21283,524585.823,5349524.453,86,61,25,19.622,0,2008,1,127,297,184,0.822371707489097,13.4,18.4934065934066,57,1230.28657462628,-1.15708494491614
21283,524585.823,5349524.453,189,66,123,22.27,0,2009,3,123,298,218,0.811225477928439,14,19.4461538461538,95,1230.28657462628,-1.15708494491614
21283,524585.823,5349524.453,176,62,114,21.311,0,2010,3,127,307,185,0.827418653866357,69.3,19.1879120879121,58,1230.28657462628,-1.15708494491614
21283,524585.823,5349524.453,157,99,58,26.013,0,2011,1,107,315,185,0.808632750642268,108.7,18.4846153846154,78,1230.28657462628,-1.15708494491614
21283,524585.823,5349524.453,181,93,88,25.34,0,2012,1,127,307,177,0.845935405976885,6.9,19.8923076923077,50,1230.28657462628,-1.15708494491614
21283,524585.823,5349524.453,182,93,89,23.295,0,2013,2,130,298,202,0.828746339856501,-187.7,20.2681318681319,72,1230.28657462628,-1.15708494491614
21283,524585.823,5349524.453,161,48,113,31.541,0,2014,3,111,312,193,0.85053039083061,71,18.9736263736264,82,1230.28657462628,-1.15708494491614
21283,524585.823,5349524.453,173,106,67,30.127,0,2015,1,120,327,192,0.835586228482814,-210.3,22.0318681318681,72,1230.28657462628,-1.15708494491614
21283,524585.823,5349524.453,172,119,53,8.9,0,2016,1,145,333,208,0.839876487506621,-28.3,20.1868131868132,63,1230.28657462628,-1.15708494491614
21283,524585.823,5349524.453,150,95,55,25.041,0,2017,1,122,296,177,0.820015353367713,-67,20.9692307692308,55,1230.28657462628,-1.15708494491614
21283,524585.823,5349524.453,185,57,128,33.29,0,2018,3,111,314,186,0.799332601988863,-134,21.621978021978,75,1230.28657462628,-1.15708494491614
21283,524585.823,5349524.453,168,93,75,25.483,2,2019,2,124,299,184,0.830993990896281,-110.8,21.721978021978,60,1230.28657462628,-1.15708494491614
21283,524585.823,5349524.453,0,0,0,21.782,0,2020,0,119,321,201,0.798518328159575,-108.6,20.0032967032967,82,1230.28657462628,-1.15708494491614
21284,524585.823,5349292.797,86,85,1,28.505,0,2001,3,122,295,193,0.820895262712004,-10.6,19.1659340659341,71,1251.44786979905,0.519061260418112
21284,524585.823,5349292.797,149,65,84,21.881,0,2002,3,128,315,210,0.789544409554793,6.29999999999999,19.1637362637363,82,1251.44786979905,0.519061260418112
21284,524585.823,5349292.797,175,83,92,26.819,0,2003,2,119,328,169,0.778038104652319,-207.1,23.9516483516484,50,1251.44786979905,0.519061260418112
21284,524585.823,5349292.797,175,94,81,20.112,0,2004,2,130,328,209,0.805026347493885,109,18.7549450549451,79,1251.44786979905,0.519061260418112
21284,524585.823,5349292.797,160,94,66,32.183,0,2005,2,120,310,184,0.832401320639128,-46.2,18.9098901098901,64,1251.44786979905,0.519061260418112
21284,524585.823,5349292.797,190,61,129,34.766,0,2006,3,116,334,192,0.81547062373208,29.4,19.8868131868132,76,1251.44786979905,0.519061260418112
21284,524585.823,5349292.797,131,93,38,37.213,0,2007,3,104,294,193,0.808543567106384,236.4,18.0659340659341,89,1251.44786979905,0.519061260418112
21284,524585.823,5349292.797,135,61,74,20.499,0,2008,3,126,291,184,0.810474535116609,13.4,18.4934065934066,58,1251.44786979905,0.519061260418112
21284,524585.823,5349292.797,187,62,125,15.566,0,2009,4,132,295,210,0.814147824591139,14,19.4461538461538,78,1251.44786979905,0.519061260418112
21284,524585.823,5349292.797,166,75,91,23.426,0,2010,2,124,291,186,0.818712320279674,69.3,19.1879120879121,62,1251.44786979905,0.519061260418112
21284,524585.823,5349292.797,149,62,87,24.647,0,2011,3,109,315,193,0.80393096547715,108.7,18.4846153846154,84,1251.44786979905,0.519061260418112
21284,524585.823,5349292.797,176,93,83,26.359,0,2012,2,126,305,194,0.807435501514437,6.9,19.8923076923077,68,1251.44786979905,0.519061260418112
21284,524585.823,5349292.797,195,62,133,7.369,0,2013,2,146,297,201,0.840996373381974,-187.7,20.2681318681319,55,1251.44786979905,0.519061260418112
21284,524585.823,5349292.797,151,44,107,28.593,0,2014,3,116,311,209,0.824003469583906,71,18.9736263736264,93,1251.44786979905,0.519061260418112
21284,524585.823,5349292.797,177,114,63,25.866,0,2015,1,124,321,194,0.840014748214191,-210.3,22.0318681318681,70,1251.44786979905,0.519061260418112
21284,524585.823,5349292.797,170,125,45,12.774,0,2016,1,141,332,201,0.83406198614602,-28.3,20.1868131868132,60,1251.44786979905,0.519061260418112
21284,524585.823,5349292.797,152,101,51,24.274,0,2017,2,123,297,193,0.824790210177067,-67,20.9692307692308,70,1251.44786979905,0.519061260418112
21284,524585.823,5349292.797,177,54,123,30.78,0,2018,2,114,319,176,0.844527852356848,-134,21.621978021978,62,1251.44786979905,0.519061260418112
21284,524585.823,5349292.797,168,94,74,26.341,2,2019,2,123,296,186,0.825417531695221,-110.8,21.721978021978,63,1251.44786979905,0.519061260418112
21284,524585.823,5349292.797,146,94,52,18.955,0,2020,2,124,314,209,0.813422536654683,-108.6,20.0032967032967,85,1251.44786979905,0.519061260418112
21285,524585.823,5349061.14,86,85,1,17.734,0,2001,3,133,295,194,0.832024733767019,-10.6,19.1659340659341,61,1259.48921357758,-0.347575628202999
21285,524585.823,5349061.14,148,66,82,12.369,0,2002,3,138,313,209,0.807615438502703,6.29999999999999,19.1637362637363,71,1259.48921357758,-0.347575628202999
21285,524585.823,5349061.14,177,82,95,23.526,0,2003,3,123,326,185,0.838225257042515,-207.1,23.9516483516484,62,1259.48921357758,-0.347575628202999
21285,524585.823,5349061.14,180,113,67,12.329,0,2004,2,138,322,209,0.841409016168615,109,18.7549450549451,71,1259.48921357758,-0.347575628202999
21285,524585.823,5349061.14,165,136,29,27.374,0,2005,1,125,308,185,0.831611557556359,-46.2,18.9098901098901,60,1259.48921357758,-0.347575628202999
21285,524585.823,5349061.14,196,61,135,21.457,0,2006,2,131,333,193,0.831540103480167,29.4,19.8868131868132,62,1259.48921357758,-0.347575628202999
21285,524585.823,5349061.14,134,93,41,30.837,0,2007,3,113,293,200,0.821460687869397,236.4,18.0659340659341,87,1259.48921357758,-0.347575628202999
21285,524585.823,5349061.14,135,61,74,16.382,0,2008,3,131,289,184,0.822772489616744,13.4,18.4934065934066,53,1259.48921357758,-0.347575628202999
21285,524585.823,5349061.14,180,62,118,15.566,0,2009,3,132,285,209,0.819816687205955,14,19.4461538461538,77,1259.48921357758,-0.347575628202999
21285,524585.823,5349061.14,166,74,92,16.547,0,2010,3,133,288,192,0.825054059727424,69.3,19.1879120879121,59,1259.48921357758,-0.347575628202999
21285,524585.823,5349061.14,152,62,90,22.097,0,2011,3,113,312,193,0.812268969943514,108.7,18.4846153846154,80,1259.48921357758,-0.347575628202999
21285,524585.823,5349061.14,177,94,83,21.286,0,2012,2,131,302,185,0.835886963288911,6.9,19.8923076923077,54,1259.48921357758,-0.347575628202999
21285,524585.823,5349061.14,191,60,131,11.587,0,2013,3,142,293,208,0.851069460330078,-187.7,20.2681318681319,66,1259.48921357758,-0.347575628202999
21285,524585.823,5349061.14,153,44,109,26.786,0,2014,3,119,307,208,0.830783036352779,71,18.9736263736264,89,1259.48921357758,-0.347575628202999
21285,524585.823,5349061.14,175,95,80,18.125,0,2015,2,131,323,201,0.857206853730469,-210.3,22.0318681318681,70,1259.48921357758,-0.347575628202999
21285,524585.823,5349061.14,169,112,57,7.894,0,2016,2,146,328,209,0.833137264109963,-28.3,20.1868131868132,63,1259.48921357758,-0.347575628202999
21285,524585.823,5349061.14,151,99,52,16.918,0,2017,2,132,298,193,0.841881552844055,-67,20.9692307692308,61,1259.48921357758,-0.347575628202999
21285,524585.823,5349061.14,178,55,123,29.103,0,2018,2,116,309,176,0.850573123214814,-134,21.621978021978,60,1259.48921357758,-0.347575628202999
21285,524585.823,5349061.14,170,98,72,20.159,0,2019,2,130,294,194,0.849586140814409,-110.8,21.721978021978,64,1259.48921357758,-0.347575628202999
21285,524585.823,5349061.14,0,0,0,12.873,0,2020,0,134,314,218,0.834682438191728,-108.6,20.0032967032967,84,1259.48921357758,-0.347575628202999
21286,524585.823,5348829.484,86,82,4,15.585,0,2001,3,136,305,200,0.832440329206053,118,17.3307692307692,64,1264.62722973697,0.963279934090449
21286,524585.823,5348829.484,104,77,27,15.186,0,2002,2,135,313,186,0.793108202594935,53.4,17.5120879120879,51,1264.62722973697,0.963279934090449
21286,524585.823,5348829.484,176,78,98,25.583,0,2003,3,123,287,209,0.80641690709245,-198.1,22.256043956044,86,1264.62722973697,0.963279934090449
21286,524585.823,5348829.484,175,31,144,19.747,0,2004,3,131,306,202,0.822844914055345,210.8,17.0318681318681,71,1264.62722973697,0.963279934090449
21286,524585.823,5348829.484,165,93,72,26.685,0,2005,2,127,312,186,0.838795994069738,45.7,17.2395604395604,59,1264.62722973697,0.963279934090449
21286,524585.823,5348829.484,197,63,134,21.669,1,2006,4,132,338,185,0.814893928966611,93.4,18.2021978021978,53,1264.62722973697,0.963279934090449
21286,524585.823,5348829.484,143,111,32,30.711,0,2007,1,116,293,170,0.837102280631855,334.9,16.4472527472527,54,1264.62722973697,0.963279934090449
21286,524585.823,5348829.484,114,57,57,14.883,0,2008,3,132,288,192,0.824042015220735,51.4,16.9230769230769,60,1264.62722973697,0.963279934090449
21286,524585.823,5348829.484,190,61,129,15.993,0,2009,4,132,292,202,0.819104164234224,56.1,17.7604395604396,70,1264.62722973697,0.963279934090449
21286,524585.823,5348829.484,171,67,104,15.653,0,2010,3,134,289,194,0.828398614029705,134.3,17.6802197802198,60,1264.62722973697,0.963279934090449
21286,524585.823,5348829.484,130,94,36,23.194,0,2011,1,113,315,162,0.761111897744333,136.8,16.9703296703297,49,1264.62722973697,0.963279934090449
21286,524585.823,5348829.484,163,94,69,30.867,0,2012,2,121,300,192,0.838145934158032,90.5,18.343956043956,71,1264.62722973697,0.963279934090449
21286,524585.823,5348829.484,186,68,118,12.243,1,2013,2,142,296,216,0.851979026564915,-155.5,18.543956043956,74,1264.62722973697,0.963279934090449
21286,524585.823,5348829.484,152,43,109,21.043,0,2014,3,128,308,216,0.831820917697594,192.7,17.3769230769231,88,1264.62722973697,0.963279934090449
21286,524585.823,5348829.484,172,72,100,20.359,0,2015,3,129,329,202,0.855910604359605,-153.6,20.3384615384615,73,1264.62722973697,0.963279934090449
21286,524585.823,5348829.484,178,153,25,23.86,0,2016,1,130,329,178,0.815171948143689,52.4,18.4901098901099,48,1264.62722973697,0.963279934090449
21286,524585.823,5348829.484,152,94,58,22.221,0,2017,2,127,298,184,0.808705400553877,-1.7,19.1,57,1264.62722973697,0.963279934090449
21286,524585.823,5348829.484,169,65,104,33.012,0,2018,3,112,309,193,0.845105088373433,-150.7,19.8846153846154,81,1264.62722973697,0.963279934090449
21286,524585.823,5348829.484,170,127,43,22.657,0,2019,1,128,295,201,0.837134772316025,-73,20.0010989010989,73,1264.62722973697,0.963279934090449
21286,524585.823,5348829.484,86,72,14,19.1,1,2020,1,124,315,217,0.836458540703211,-12.8,18.3098901098901,93,1264.62722973697,0.963279934090449
21287,524585.823,5348597.828,86,82,4,20.019,0,2001,3,131,302,192,0.841618673306508,118,17.3307692307692,61,1279.71263148008,1.29839729881844
21287,524585.823,5348597.828,106,75,31,16.127,0,2002,3,134,314,200,0.820713316664663,53.4,17.5120879120879,66,1279.71263148008,1.29839729881844
21287,524585.823,5348597.828,179,78,101,23.802,0,2003,2,125,288,210,0.797330034403854,-198.1,22.256043956044,85,1279.71263148008,1.29839729881844
21287,524585.823,5348597.828,173,31,142,26.132,0,2004,3,124,303,201,0.803598060205991,210.8,17.0318681318681,77,1279.71263148008,1.29839729881844
21287,524585.823,5348597.828,167,93,74,25.616,0,2005,3,128,307,194,0.795609720232898,45.7,17.2395604395604,66,1279.71263148008,1.29839729881844
21287,524585.823,5348597.828,189,59,130,34.972,2,2006,3,118,338,185,0.801428876491756,93.4,18.2021978021978,67,1279.71263148008,1.29839729881844
21287,524585.823,5348597.828,143,111,32,30.122,0,2007,1,117,292,170,0.835485073845606,334.9,16.4472527472527,53,1279.71263148008,1.29839729881844
21287,524585.823,5348597.828,114,57,57,14.167,0,2008,3,133,293,194,0.811077915950289,51.4,16.9230769230769,61,1279.71263148008,1.29839729881844
21287,524585.823,5348597.828,190,63,127,15.21,0,2009,4,133,299,201,0.81596432259732,56.1,17.7604395604396,68,1279.71263148008,1.29839729881844
21287,524585.823,5348597.828,175,68,107,15.653,0,2010,2,134,290,200,0.816444690803639,134.3,17.6802197802198,66,1279.71263148008,1.29839729881844
21287,524585.823,5348597.828,137,99,38,24.513,0,2011,2,111,318,241,0.75204808089513,136.8,16.9703296703297,130,1279.71263148008,1.29839729881844
21287,524585.823,5348597.828,163,104,59,33.906,0,2012,2,118,302,201,0.825633594453167,90.5,18.343956043956,83,1279.71263148008,1.29839729881844
21287,524585.823,5348597.828,184,66,118,10.034,1,2013,3,144,293,217,0.848476914184984,-155.5,18.543956043956,73,1279.71263148008,1.29839729881844
21287,524585.823,5348597.828,151,40,111,24.101,0,2014,3,124,308,217,0.835930453637943,192.7,17.3769230769231,93,1279.71263148008,1.29839729881844
21287,524585.823,5348597.828,171,72,99,24.707,0,2015,3,125,331,216,0.846650575452511,-153.6,20.3384615384615,91,1279.71263148008,1.29839729881844
21287,524585.823,5348597.828,177,150,27,23.86,0,2016,1,130,330,233,0.815277544971307,52.4,18.4901098901099,103,1279.71263148008,1.29839729881844
21287,524585.823,5348597.828,152,94,58,25.421,0,2017,2,123,298,185,0.797539139022884,-1.7,19.1,62,1279.71263148008,1.29839729881844
21287,524585.823,5348597.828,170,65,105,33.012,0,2018,3,112,313,200,0.83716585267504,-150.7,19.8846153846154,88,1279.71263148008,1.29839729881844
21287,524585.823,5348597.828,169,130,39,28.844,4,2019,1,121,297,201,0.835605574059825,-73,20.0010989010989,80,1279.71263148008,1.29839729881844
21287,524585.823,5348597.828,86,72,14,23.126,1,2020,1,117,317,217,0.83479707307782,-12.8,18.3098901098901,100,1279.71263148008,1.29839729881844
21288,524585.823,5348366.171,0,0,0,28.937,0,2001,3,122,292,194,0.841001537602755,118,17.3307692307692,72,1291.35767121035,1.26337895211597
21288,524585.823,5348366.171,107,66,41,20.858,0,2002,3,129,318,208,0.806805949219841,53.4,17.5120879120879,79,1291.35767121035,1.26337895211597
21288,524585.823,5348366.171,173,116,57,24.681,0,2003,1,124,289,185,0.838492796884443,-198.1,22.256043956044,61,1291.35767121035,1.26337895211597
21288,524585.823,5348366.171,180,31,149,11.812,0,2004,3,139,331,194,0.831977773697599,210.8,17.0318681318681,55,1291.35767121035,1.26337895211597
21288,524585.823,5348366.171,168,93,75,24.541,0,2005,2,129,314,193,0.810401425471015,45.7,17.2395604395604,64,1291.35767121035,1.26337895211597
21288,524585.823,5348366.171,193,105,88,31.944,1,2006,1,121,327,192,0.824470965549879,93.4,18.2021978021978,71,1291.35767121035,1.26337895211597
21288,524585.823,5348366.171,139,93,46,35.962,0,2007,3,108,296,192,0.828945116504919,334.9,16.4472527472527,84,1291.35767121035,1.26337895211597
21288,524585.823,5348366.171,86,58,28,12.108,0,2008,1,136,296,201,0.821696688702096,51.4,16.9230769230769,65,1291.35767121035,1.26337895211597
21288,524585.823,5348366.171,174,63,111,21.437,0,2009,3,125,314,210,0.822379491860644,56.1,17.7604395604396,85,1291.35767121035,1.26337895211597
21288,524585.823,5348366.171,172,75,97,18.273,0,2010,3,131,285,201,0.830010304534583,134.3,17.6802197802198,70,1291.35767121035,1.26337895211597
21288,524585.823,5348366.171,0,0,0,25.893,0,2011,0,109,321,234,0.76452928233025,136.8,16.9703296703297,125,1291.35767121035,1.26337895211597
21288,524585.823,5348366.171,164,102,62,30.867,0,2012,2,121,307,200,0.837879291439344,90.5,18.343956043956,79,1291.35767121035,1.26337895211597
21288,524585.823,5348366.171,186,81,105,13.34,1,2013,3,141,295,210,0.848883449672092,-155.5,18.543956043956,69,1291.35767121035,1.26337895211597
21288,524585.823,5348366.171,149,40,109,34.326,1,2014,3,108,310,202,0.794390181441634,192.7,17.3769230769231,94,1291.35767121035,1.26337895211597
21288,524585.823,5348366.171,173,127,46,30.175,0,2015,1,120,332,200,0.842874878947913,-153.6,20.3384615384615,80,1291.35767121035,1.26337895211597
21288,524585.823,5348366.171,177,122,55,22.016,0,2016,2,132,329,225,0.827617563991157,52.4,18.4901098901099,93,1291.35767121035,1.26337895211597
21288,524585.823,5348366.171,152,109,43,30.85,3,2017,2,116,304,201,0.826097226318598,-1.7,19.1,85,1291.35767121035,1.26337895211597
21288,524585.823,5348366.171,170,58,112,33.854,0,2018,2,111,316,178,0.839067548821992,-150.7,19.8846153846154,67,1291.35767121035,1.26337895211597
21288,524585.823,5348366.171,165,80,85,22.657,0,2019,3,128,299,193,0.841869591840952,-73,20.0010989010989,65,1291.35767121035,1.26337895211597
21288,524585.823,5348366.171,86,85,1,23.126,1,2020,1,117,318,209,0.829848145436716,-12.8,18.3098901098901,92,1291.35767121035,1.26337895211597
21289,524585.823,5348134.515,0,0,0,35.329,0,2001,3,116,299,193,0.850220892983264,118,17.3307692307692,77,1275.21837988681,-0.84715857959949
21289,524585.823,5348134.515,86,67,19,20.858,0,2002,1,129,318,194,0.81268493978706,53.4,17.5120879120879,65,1275.21837988681,-0.84715857959949
21289,524585.823,5348134.515,172,114,58,25.583,0,2003,1,123,291,185,0.846247825123421,-198.1,22.256043956044,62,1275.21837988681,-0.84715857959949
21289,524585.823,5348134.515,179,31,148,11.812,0,2004,3,139,336,200,0.789110152696909,210.8,17.0318681318681,61,1275.21837988681,-0.84715857959949
21289,524585.823,5348134.515,167,93,74,29.701,0,2005,2,124,315,194,0.802071136259431,45.7,17.2395604395604,70,1275.21837988681,-0.84715857959949
21289,524585.823,5348134.515,192,101,91,36.008,2,2006,2,117,329,193,0.833181510784445,93.4,18.2021978021978,76,1275.21837988681,-0.84715857959949
21289,524585.823,5348134.515,139,116,23,38.977,0,2007,1,104,297,177,0.842602942221677,334.9,16.4472527472527,73,1275.21837988681,-0.84715857959949
21289,524585.823,5348134.515,86,58,28,13.462,0,2008,1,134,306,201,0.845702419899858,51.4,16.9230769230769,67,1275.21837988681,-0.84715857959949
21289,524585.823,5348134.515,175,64,111,22.238,0,2009,3,124,315,210,0.828866568586356,56.1,17.7604395604396,86,1275.21837988681,-0.84715857959949
21289,524585.823,5348134.515,172,75,97,16.559,0,2010,3,133,292,194,0.840713482750297,134.3,17.6802197802198,61,1275.21837988681,-0.84715857959949
21289,524585.823,5348134.515,0,0,0,28.831,0,2011,0,105,324,178,0.803579351529439,136.8,16.9703296703297,73,1275.21837988681,-0.84715857959949
21289,524585.823,5348134.515,164,100,64,31.85,0,2012,2,120,311,193,0.844112169493049,90.5,18.343956043956,73,1275.21837988681,-0.84715857959949
21289,524585.823,5348134.515,184,81,103,17.412,1,2013,3,137,294,208,0.85737788296262,-155.5,18.543956043956,71,1275.21837988681,-0.84715857959949
21289,524585.823,5348134.515,149,40,109,34.326,1,2014,3,108,306,200,0.74085464763232,192.7,17.3769230769231,92,1275.21837988681,-0.84715857959949
21289,524585.823,5348134.515,172,76,96,30.175,0,2015,2,120,320,193,0.842477363437962,-153.6,20.3384615384615,73,1275.21837988681,-0.84715857959949
21289,524585.823,5348134.515,176,93,83,20.098,0,2016,1,134,333,178,0.829055771220928,52.4,18.4901098901099,44,1275.21837988681,-0.84715857959949
21289,524585.823,5348134.515,152,106,46,25.421,0,2017,1,123,305,194,0.832397045518055,-1.7,19.1,71,1275.21837988681,-0.84715857959949
21289,524585.823,5348134.515,171,59,112,33.854,0,2018,2,111,316,177,0.841314609594688,-150.7,19.8846153846154,66,1275.21837988681,-0.84715857959949
21289,524585.823,5348134.515,164,80,84,24.438,2,2019,2,126,303,193,0.844265799937267,-73,20.0010989010989,67,1275.21837988681,-0.84715857959949
21289,524585.823,5348134.515,93,86,7,23.126,1,2020,3,117,314,201,0.817764345445829,-12.8,18.3098901098901,84,1275.21837988681,-0.84715857959949
21290,524585.823,5347902.859,0,0,0,34.248,0,2001,2,117,312,186,0.834957717166038,118,17.3307692307692,69,1237.39311631668,-0.985652181706106
21290,524585.823,5347902.859,86,73,13,34.178,0,2002,1,114,317,248,0.787602197143688,53.4,17.5120879120879,134,1237.39311631668,-0.985652181706106
21290,524585.823,5347902.859,162,93,69,36.461,0,2003,2,110,287,185,0.837046154465362,-198.1,22.256043956044,75,1237.39311631668,-0.985652181706106
21290,524585.823,5347902.859,176,30,146,18.678,0,2004,3,132,335,193,0.816732825061386,210.8,17.0318681318681,61,1237.39311631668,-0.985652181706106
21290,524585.823,5347902.859,157,93,64,39.998,0,2005,2,114,315,225,0.787825428553787,45.7,17.2395604395604,111,1237.39311631668,-0.985652181706106
21290,524585.823,5347902.859,179,67,112,27.331,1,2006,2,126,336,178,0.814822177122538,93.4,18.2021978021978,52,1237.39311631668,-0.985652181706106
21290,524585.823,5347902.859,0,0,0,38.189,0,2007,0,105,310,161,0.856475887397962,334.9,16.4472527472527,56,1237.39311631668,-0.985652181706106
21290,524585.823,5347902.859,86,57,29,15.623,0,2008,1,131,304,202,0.841082673774762,51.4,16.9230769230769,71,1237.39311631668,-0.985652181706106
21290,524585.823,5347902.859,185,67,118,27.978,0,2009,4,117,314,210,0.821370864593623,56.1,17.7604395604396,93,1237.39311631668,-0.985652181706106
21290,524585.823,5347902.859,169,94,75,23.649,0,2010,2,124,300,201,0.824536380015721,134.3,17.6802197802198,77,1237.39311631668,-0.985652181706106
21290,524585.823,5347902.859,148,64,84,32.718,1,2011,3,100,324,161,0.781044959683471,136.8,16.9703296703297,61,1237.39311631668,-0.985652181706106
21290,524585.823,5347902.859,176,96,80,27.873,0,2012,2,124,312,194,0.832193992844307,90.5,18.343956043956,70,1237.39311631668,-0.985652181706106
21290,524585.823,5347902.859,184,75,109,19.383,1,2013,3,135,304,201,0.831102211824114,-155.5,18.543956043956,66,1237.39311631668,-0.985652181706106
21290,524585.823,5347902.859,142,58,84,33.097,0,2014,5,110,317,217,0.849839665842473,192.7,17.3769230769231,107,1237.39311631668,-0.985652181706106
21290,524585.823,5347902.859,167,93,74,34.296,0,2015,2,115,319,185,0.838775945759931,-153.6,20.3384615384615,70,1237.39311631668,-0.985652181706106
21290,524585.823,5347902.859,166,105,61,33.249,1,2016,2,121,334,201,0.853116680816246,52.4,18.4901098901099,80,1237.39311631668,-0.985652181706106
21290,524585.823,5347902.859,152,94,58,49.828,7,2017,2,91,306,185,0.821643516483886,-1.7,19.1,94,1237.39311631668,-0.985652181706106
21290,524585.823,5347902.859,167,66,101,40.498,0,2018,2,104,320,168,0.861634190317095,-150.7,19.8846153846154,64,1237.39311631668,-0.985652181706106
21290,524585.823,5347902.859,164,94,70,23.541,1,2019,2,127,306,201,0.821005100972108,-73,20.0010989010989,74,1237.39311631668,-0.985652181706106
21290,524585.823,5347902.859,86,71,15,115.043,42,2020,1,24,322,194,0.806414469736544,-12.8,18.3098901098901,170,1237.39311631668,-0.985652181706106
21362,524585.823,5331223.601,145,86,59,31.548,0,2001,3,120,285,193,0.864560220292396,103.5,18.1120879120879,73,1133.90680065637,1.35214394125772
21362,524585.823,5331223.601,152,77,75,28.013,0,2002,3,122,290,185,0.869981187281105,46.4,18.2428571428571,63,1133.90680065637,1.35214394125772
21362,524585.823,5331223.601,152,60,92,36.828,0,2003,2,110,281,168,0.887785009814972,-203.8,22.9692307692308,58,1133.90680065637,1.35214394125772
21362,524585.823,5331223.601,166,93,73,28.399,0,2004,2,122,325,186,0.870085215522092,196.1,17.7461538461538,64,1133.90680065637,1.35214394125772
21362,524585.823,5331223.601,152,94,58,40.722,0,2005,1,114,304,177,0.89033476719244,38.9,17.9032967032967,63,1133.90680065637,1.35214394125772
21362,524585.823,5331223.601,186,98,88,30.925,0,2006,1,123,335,178,0.854153181468948,82.6,18.867032967033,55,1133.90680065637,1.35214394125772
21362,524585.823,5331223.601,164,96,68,40.881,0,2007,2,102,287,185,0.882314178922058,317.9,17.0824175824176,83,1133.90680065637,1.35214394125772
21362,524585.823,5331223.601,86,52,34,27.767,0,2008,1,118,298,185,0.883145185298453,40.8,17.6131868131868,67,1133.90680065637,1.35214394125772
21362,524585.823,5331223.601,169,65,104,57.574,0,2009,2,90,295,170,0.911595944070071,41,18.5230769230769,80,1133.90680065637,1.35214394125772
21362,524585.823,5331223.601,166,66,100,27.331,0,2010,2,121,301,178,0.879786205898453,122,18.3626373626374,57,1133.90680065637,1.35214394125772
21362,524585.823,5331223.601,86,70,16,29.021,0,2011,1,106,310,176,0.853326843978986,127.1,17.5,70,1133.90680065637,1.35214394125772
21362,524585.823,5331223.601,148,93,55,48.762,1,2012,2,103,275,185,0.894901504401935,82.8,18.7043956043956,82,1133.90680065637,1.35214394125772
21362,524585.823,5331223.601,181,62,119,10.193,0,2013,3,144,284,200,0.885850138436616,-163.1,19.2582417582418,56,1133.90680065637,1.35214394125772
21362,524585.823,5331223.601,159,45,114,32.15,0,2014,3,112,335,201,0.864395055426319,176.9,17.856043956044,89,1133.90680065637,1.35214394125772
21362,524585.823,5331223.601,154,93,61,34.844,0,2015,1,115,290,176,0.872474466953368,-158.6,20.9142857142857,61,1133.90680065637,1.35214394125772
21362,524585.823,5331223.601,172,127,45,34.845,1,2016,1,120,313,193,0.887325659330965,45.5,18.8857142857143,73,1133.90680065637,1.35214394125772
21362,524585.823,5331223.601,144,103,41,29.541,1,2017,1,118,299,184,0.865156921996245,-10.8,19.7879120879121,66,1133.90680065637,1.35214394125772
21362,524585.823,5331223.601,172,75,97,31.36,0,2018,3,115,300,184,0.867263124907853,-154,20.578021978022,69,1133.90680065637,1.35214394125772
21362,524585.823,5331223.601,167,99,68,26.352,4,2019,1,124,318,177,0.855232856175862,-79.8,20.6626373626374,53,1133.90680065637,1.35214394125772
21362,524585.823,5331223.601,0,0,0,21.533,0,2020,0,120,304,201,0.818835141276534,-19.2,19.0648351648352,81,1133.90680065637,1.35214394125772
21363,524585.823,5330991.945,127,93,34,38.195,0,2001,4,114,306,185,0.870674920781269,103.5,18.1120879120879,71,1099.47787575513,0.337812005006214
21363,524585.823,5330991.945,153,79,74,37.538,0,2002,2,111,291,176,0.865605017012014,46.4,18.2428571428571,65,1099.47787575513,0.337812005006214
21363,524585.823,5330991.945,152,60,92,37.678,1,2003,2,109,280,169,0.881277064364823,-203.8,22.9692307692308,60,1099.47787575513,0.337812005006214
21363,524585.823,5330991.945,168,112,56,31.965,0,2004,1,118,326,184,0.886948907926546,196.1,17.7461538461538,66,1099.47787575513,0.337812005006214
21363,524585.823,5330991.945,152,94,58,48.62,0,2005,1,107,308,170,0.892878051163496,38.9,17.9032967032967,63,1099.47787575513,0.337812005006214
21363,524585.823,5330991.945,186,105,81,36.445,1,2006,1,118,336,178,0.85674358510321,82.6,18.867032967033,60,1099.47787575513,0.337812005006214
21363,524585.823,5330991.945,163,96,67,42.62,0,2007,1,100,292,177,0.876769466935579,317.9,17.0824175824176,77,1099.47787575513,0.337812005006214
21363,524585.823,5330991.945,82,51,31,25.659,0,2008,1,120,305,178,0.873664454559438,40.8,17.6131868131868,58,1099.47787575513,0.337812005006214
21363,524585.823,5330991.945,168,65,103,62.364,1,2009,3,86,297,184,0.925907038185175,41,18.5230769230769,98,1099.47787575513,0.337812005006214
21363,524585.823,5330991.945,165,66,99,29.831,0,2010,2,118,308,178,0.880166129390285,122,18.3626373626374,60,1099.47787575513,0.337812005006214
21363,524585.823,5330991.945,93,71,22,34.83,1,2011,2,99,315,170,0.854579053160599,127.1,17.5,71,1099.47787575513,0.337812005006214
21363,524585.823,5330991.945,148,94,54,42.673,0,2012,2,110,300,194,0.854742141773682,82.8,18.7043956043956,84,1099.47787575513,0.337812005006214
21363,524585.823,5330991.945,181,61,120,13.554,0,2013,3,141,298,192,0.879425436674639,-163.1,19.2582417582418,51,1099.47787575513,0.337812005006214
21363,524585.823,5330991.945,158,50,108,33.407,0,2014,2,110,342,178,0.863124541527322,176.9,17.856043956044,68,1099.47787575513,0.337812005006214
21363,524585.823,5330991.945,153,93,60,39.952,0,2015,1,109,313,169,0.881825046720034,-158.6,20.9142857142857,60,1099.47787575513,0.337812005006214
21363,524585.823,5330991.945,168,94,74,41.223,6,2016,2,114,327,209,0.852209033631154,45.5,18.8857142857143,95,1099.47787575513,0.337812005006214
21363,524585.823,5330991.945,143,93,50,37.886,7,2017,1,107,307,177,0.86303911424137,-10.8,19.7879120879121,70,1099.47787575513,0.337812005006214
21363,524585.823,5330991.945,166,75,91,37.829,0,2018,2,108,304,185,0.854427230260808,-154,20.578021978022,77,1099.47787575513,0.337812005006214
21363,524585.823,5330991.945,163,99,64,37.578,4,2019,1,111,321,177,0.863679978983845,-79.8,20.6626373626374,66,1099.47787575513,0.337812005006214
21363,524585.823,5330991.945,0,0,0,27.122,0,2020,0,110,310,185,0.837678472089364,-19.2,19.0648351648352,75,1099.47787575513,0.337812005006214
21372,524585.823,5328907.037,93,83,10,39.272,1,2001,4,113,288,185,0.857505958763492,103.5,18.1120879120879,72,1216.99626367676,1.38809332889796
21372,524585.823,5328907.037,86,61,25,24.05,0,2002,1,126,288,193,0.854288353482016,46.4,18.2428571428571,67,1216.99626367676,1.38809332889796
21372,524585.823,5328907.037,168,57,111,30.907,0,2003,2,117,300,170,0.837953172334148,-203.8,22.9692307692308,53,1216.99626367676,1.38809332889796
21372,524585.823,5328907.037,178,111,67,24.906,0,2004,1,126,321,185,0.822863637786437,196.1,17.7461538461538,59,1216.99626367676,1.38809332889796
21372,524585.823,5328907.037,168,116,52,39.638,0,2005,1,115,311,184,0.850893989458356,38.9,17.9032967032967,69,1216.99626367676,1.38809332889796
21372,524585.823,5328907.037,190,65,125,35.281,1,2006,2,119,328,170,0.833496683387378,82.6,18.867032967033,51,1216.99626367676,1.38809332889796
21372,524585.823,5328907.037,0,0,0,39.224,0,2007,0,104,291,184,0.860428910402746,317.9,17.0824175824176,80,1216.99626367676,1.38809332889796
21372,524585.823,5328907.037,135,51,84,17.249,0,2008,3,129,300,193,0.827175678926219,40.8,17.6131868131868,64,1216.99626367676,1.38809332889796
21372,524585.823,5328907.037,175,62,113,39.629,0,2009,2,105,291,176,0.867844979508461,41,18.5230769230769,71,1216.99626367676,1.38809332889796
21372,524585.823,5328907.037,171,73,98,23.268,0,2010,2,126,299,193,0.835024636000769,122,18.3626373626374,67,1216.99626367676,1.38809332889796
21372,524585.823,5328907.037,118,60,58,29.021,0,2011,2,106,314,161,0.811360362249302,127.1,17.5,55,1216.99626367676,1.38809332889796
21372,524585.823,5328907.037,158,81,77,31.344,0,2012,3,121,300,185,0.817038512421691,82.8,18.7043956043956,64,1216.99626367676,1.38809332889796
21372,524585.823,5328907.037,187,44,143,30.119,0,2013,2,125,288,185,0.846348037039009,-163.1,19.2582417582418,60,1216.99626367676,1.38809332889796
21372,524585.823,5328907.037,156,41,115,32.779,0,2014,2,111,331,177,0.813853331284809,176.9,17.856043956044,66,1216.99626367676,1.38809332889796
21372,524585.823,5328907.037,163,127,36,34.844,0,2015,1,115,303,169,0.830357557475001,-158.6,20.9142857142857,54,1216.99626367676,1.38809332889796
21372,524585.823,5328907.037,170,144,26,32.703,0,2016,1,122,317,169,0.868315916672911,45.5,18.8857142857143,47,1216.99626367676,1.38809332889796
21372,524585.823,5328907.037,138,105,33,27.161,0,2017,1,121,296,185,0.799277960814007,-10.8,19.7879120879121,64,1216.99626367676,1.38809332889796
21372,524585.823,5328907.037,172,64,108,34.006,0,2018,2,112,304,169,0.854558466816429,-154,20.578021978022,57,1216.99626367676,1.38809332889796
21372,524585.823,5328907.037,162,93,69,24.54,2,2019,1,126,324,170,0.771613116604107,-79.8,20.6626373626374,44,1216.99626367676,1.38809332889796
21372,524585.823,5328907.037,93,93,0,19.703,1,2020,2,123,301,201,0.783461191169113,-19.2,19.0648351648352,78,1216.99626367676,1.38809332889796
21373,524585.823,5328675.381,86,84,2,40.363,2,2001,2,112,284,178,0.843249039820369,103.5,18.1120879120879,66,1206.71728789262,-0.184023073287618
21373,524585.823,5328675.381,86,64,22,28.013,0,2002,1,122,291,177,0.813015615665817,46.4,18.2428571428571,55,1206.71728789262,-0.184023073287618
21373,524585.823,5328675.381,170,58,112,30.907,0,2003,2,117,302,170,0.838109485632427,-203.8,22.9692307692308,53,1206.71728789262,-0.184023073287618
21373,524585.823,5328675.381,181,93,88,24.906,0,2004,2,126,321,194,0.830550497117207,196.1,17.7461538461538,68,1206.71728789262,-0.184023073287618
21373,524585.823,5328675.381,172,93,79,40.722,0,2005,3,114,305,185,0.850589510907135,38.9,17.9032967032967,71,1206.71728789262,-0.184023073287618
21373,524585.823,5328675.381,189,64,125,38.802,1,2006,2,116,332,176,0.827558947813275,82.6,18.867032967033,60,1206.71728789262,-0.184023073287618
21373,524585.823,5328675.381,0,0,0,40.881,0,2007,0,102,294,216,0.81310794424865,317.9,17.0824175824176,114,1206.71728789262,-0.184023073287618
21373,524585.823,5328675.381,120,54,66,17.249,0,2008,3,129,299,193,0.862989543777019,40.8,17.6131868131868,64,1206.71728789262,-0.184023073287618
21373,524585.823,5328675.381,181,62,119,27.734,0,2009,2,117,289,170,0.868086450808073,41,18.5230769230769,53,1206.71728789262,-0.184023073287618
21373,524585.823,5328675.381,172,73,99,21.571,0,2010,3,128,299,193,0.848835736220986,122,18.3626373626374,65,1206.71728789262,-0.184023073287618
21373,524585.823,5328675.381,102,58,44,30.631,0,2011,2,104,317,168,0.815562871605492,127.1,17.5,64,1206.71728789262,-0.184023073287618
21373,524585.823,5328675.381,158,82,76,31.344,0,2012,3,121,298,193,0.827824856807911,82.8,18.7043956043956,72,1206.71728789262,-0.184023073287618
21373,524585.823,5328675.381,183,44,139,31.278,0,2013,2,124,288,185,0.844816004086867,-163.1,19.2582417582418,61,1206.71728789262,-0.184023073287618
21373,524585.823,5328675.381,155,40,115,35.971,2,2014,3,106,318,202,0.8564682863244,176.9,17.856043956044,96,1206.71728789262,-0.184023073287618
21373,524585.823,5328675.381,161,93,68,34.05,0,2015,1,116,292,176,0.851725272989869,-158.6,20.9142857142857,60,1206.71728789262,-0.184023073287618
21373,524585.823,5328675.381,163,94,69,40.162,6,2016,1,115,316,177,0.871903050345253,45.5,18.8857142857143,62,1206.71728789262,-0.184023073287618
21373,524585.823,5328675.381,137,99,38,26.361,0,2017,1,122,293,186,0.811228039339294,-10.8,19.7879120879121,64,1206.71728789262,-0.184023073287618
21373,524585.823,5328675.381,171,62,109,33.134,0,2018,2,113,308,169,0.845107657771056,-154,20.578021978022,56,1206.71728789262,-0.184023073287618
21373,524585.823,5328675.381,159,93,66,29,4,2019,2,121,323,184,0.833838947758901,-79.8,20.6626373626374,63,1206.71728789262,-0.184023073287618
21373,524585.823,5328675.381,93,93,0,23.11,1,2020,2,117,299,194,0.768218851709232,-19.2,19.0648351648352,77,1206.71728789262,-0.184023073287618
21420,524585.823,5317787.532,0,0,0,52.097,0,2001,1,101,317,177,0.878852391128156,-26.7,20.3989010989011,76,1151.54062383351,1.37009888343082
21420,524585.823,5317787.532,125,77,48,46.653,0,2002,3,100,323,218,0.853523204710696,-5.6,20.2901098901099,118,1151.54062383351,1.37009888343082
21420,524585.823,5317787.532,153,93,60,34.026,0,2003,1,109,279,162,0.838667201527178,-214.1,25.0835164835165,53,1151.54062383351,1.37009888343082
21420,524585.823,5317787.532,148,99,49,30.487,0,2004,1,118,321,169,0.763898644248485,90.8,19.910989010989,51,1151.54062383351,1.37009888343082
21420,524585.823,5317787.532,148,108,40,58.607,1,2005,1,95,304,169,0.871317649942491,-56.5,19.9923076923077,74,1151.54062383351,1.37009888343082
21420,524585.823,5317787.532,191,63,128,30.086,0,2006,2,121,330,169,0.85006815149889,16.2,20.9538461538462,48,1151.54062383351,1.37009888343082
21420,524585.823,5317787.532,0,0,0,47.22,0,2007,0,93,296,168,0.864593117365839,213,19.1032967032967,75,1151.54062383351,1.37009888343082
21420,524585.823,5317787.532,84,71,13,36.518,0,2008,1,111,298,178,0.844185936296672,-1.79999999999999,19.6,67,1151.54062383351,1.37009888343082
21420,524585.823,5317787.532,170,60,110,44.458,0,2009,2,96,303,169,0.88435660822881,-2.8,20.5450549450549,73,1151.54062383351,1.37009888343082
21420,524585.823,5317787.532,168,96,72,29.035,0,2010,1,116,300,178,0.840308068429015,50.5,20.2241758241758,62,1151.54062383351,1.37009888343082
21420,524585.823,5317787.532,111,61,50,34.527,0,2011,2,96,351,169,0.80753602812975,90.7,19.4164835164835,73,1151.54062383351,1.37009888343082
21420,524585.823,5317787.532,134,94,40,45.105,1,2012,2,107,299,184,0.890136703348116,-6,20.743956043956,77,1151.54062383351,1.37009888343082
21420,524585.823,5317787.532,170,65,105,34.717,0,2013,2,119,312,177,0.838175484786202,-200.2,21.3494505494505,58,1151.54062383351,1.37009888343082
21420,524585.823,5317787.532,148,93,55,41.713,0,2014,1,95,317,178,0.857648969204023,51.4,19.8307692307692,83,1151.54062383351,1.37009888343082
21420,524585.823,5317787.532,93,86,7,51.15,1,2015,2,97,338,162,0.842603556959023,-218.4,23.0318681318681,65,1151.54062383351,1.37009888343082
21420,524585.823,5317787.532,169,106,63,50.947,1,2016,1,104,325,194,0.843929270692808,-39.8,20.9813186813187,90,1151.54062383351,1.37009888343082
21420,524585.823,5317787.532,130,100,30,41.797,3,2017,1,99,306,161,0.79907408249055,-77.9,22.0516483516484,62,1151.54062383351,1.37009888343082
21420,524585.823,5317787.532,151,64,87,54.888,0,2018,2,90,329,154,0.834711124790383,-139.3,22.7065934065934,64,1151.54062383351,1.37009888343082
21420,524585.823,5317787.532,157,101,56,39.468,1,2019,1,108,301,162,0.804174624928681,-118.9,22.7472527472527,54,1151.54062383351,1.37009888343082
21420,524585.823,5317787.532,93,93,0,36.014,0,2020,2,96,307,185,0.779124725763726,-119,21.1252747252747,89,1151.54062383351,1.37009888343082
21421,524585.823,5317555.876,0,0,0,48.591,0,2001,2,104,323,170,0.839482062641913,-26.7,20.3989010989011,66,1134.93237387615,-1.25573754871361
21421,524585.823,5317555.876,126,77,49,44.18,0,2002,3,103,336,209,0.809661498961209,-5.6,20.2901098901099,106,1134.93237387615,-1.25573754871361
21421,524585.823,5317555.876,154,93,61,30.987,0,2003,1,113,286,161,0.821785380039471,-214.1,25.0835164835165,48,1134.93237387615,-1.25573754871361
21421,524585.823,5317555.876,151,100,51,31.346,0,2004,2,117,333,193,0.760669609270915,90.8,19.910989010989,76,1134.93237387615,-1.25573754871361
21421,524585.823,5317555.876,148,108,40,64.56,1,2005,1,89,307,160,0.865822390769999,-56.5,19.9923076923077,71,1134.93237387615,-1.25573754871361
21421,524585.823,5317555.876,189,61,128,34.734,0,2006,2,116,332,169,0.822293513596946,16.2,20.9538461538462,53,1134.93237387615,-1.25573754871361
21421,524585.823,5317555.876,0,0,0,45.262,0,2007,0,95,306,169,0.834893486116986,213,19.1032967032967,74,1134.93237387615,-1.25573754871361
21421,524585.823,5317555.876,86,75,11,48.118,1,2008,1,101,308,177,0.821959567165958,-1.79999999999999,19.6,76,1134.93237387615,-1.25573754871361
21421,524585.823,5317555.876,168,64,104,53.258,0,2009,2,88,304,176,0.871822620127614,-2.8,20.5450549450549,88,1134.93237387615,-1.25573754871361
21421,524585.823,5317555.876,168,93,75,30.589,0,2010,2,114,306,184,0.821081935749287,50.5,20.2241758241758,70,1134.93237387615,-1.25573754871361
21421,524585.823,5317555.876,112,63,49,37.912,0,2011,3,92,335,250,0.738831261458221,90.7,19.4164835164835,158,1134.93237387615,-1.25573754871361
21421,524585.823,5317555.876,137,105,32,50.397,2,2012,1,100,303,176,0.870570105919339,-6,20.743956043956,76,1134.93237387615,-1.25573754871361
21421,524585.823,5317555.876,169,64,105,37.687,0,2013,2,116,314,162,0.808500188737153,-200.2,21.3494505494505,46,1134.93237387615,-1.25573754871361
21421,524585.823,5317555.876,148,93,55,44.754,0,2014,1,91,323,170,0.796175475117531,51.4,19.8307692307692,79,1134.93237387615,-1.25573754871361
21421,524585.823,5317555.876,93,86,7,53.44,3,2015,2,95,340,160,0.811050668290221,-218.4,23.0318681318681,65,1134.93237387615,-1.25573754871361
21421,524585.823,5317555.876,166,93,73,61.852,1,2016,1,93,328,170,0.850288270587964,-39.8,20.9813186813187,77,1134.93237387615,-1.25573754871361
21421,524585.823,5317555.876,129,93,36,48.605,3,2017,1,91,311,153,0.7366473899246,-77.9,22.0516483516484,62,1134.93237387615,-1.25573754871361
21421,524585.823,5317555.876,154,65,89,50.602,0,2018,2,94,335,153,0.817450289673854,-139.3,22.7065934065934,59,1134.93237387615,-1.25573754871361
21421,524585.823,5317555.876,156,102,54,45.145,2,2019,1,102,306,161,0.775772651901812,-118.9,22.7472527472527,59,1134.93237387615,-1.25573754871361
21421,524585.823,5317555.876,0,0,0,38.515,0,2020,0,93,313,170,0.730586027544483,-119,21.1252747252747,77,1134.93237387615,-1.25573754871361
21499,524817.48,5350219.422,0,0,0,132.691,0,2001,2,31,280,194,0.856263426278986,-10.6,19.1659340659341,163,1247.87576503044,0.325193158060179
21499,524817.48,5350219.422,84,52,32,27.086,0,2002,1,123,317,201,0.837543224756352,6.29999999999999,19.1637362637363,78,1247.87576503044,0.325193158060179
21499,524817.48,5350219.422,173,132,41,24.355,0,2003,1,122,337,209,0.822642821289478,-207.1,23.9516483516484,87,1247.87576503044,0.325193158060179
21499,524817.48,5350219.422,173,131,42,21.057,0,2004,1,129,338,178,0.782835691463541,109,18.7549450549451,49,1247.87576503044,0.325193158060179
21499,524817.48,5350219.422,183,93,90,37.415,0,2005,2,115,314,193,0.843154262978689,-46.2,18.9098901098901,78,1247.87576503044,0.325193158060179
21499,524817.48,5350219.422,196,93,103,14.153,0,2006,2,139,326,200,0.831294947362134,29.4,19.8868131868132,61,1247.87576503044,0.325193158060179
21499,524817.48,5350219.422,136,93,43,34.208,0,2007,2,108,300,193,0.83844794188058,236.4,18.0659340659341,85,1247.87576503044,0.325193158060179
21499,524817.48,5350219.422,86,66,20,27.252,0,2008,1,119,296,176,0.784669056041001,13.4,18.4934065934066,57,1247.87576503044,0.325193158060179
21499,524817.48,5350219.422,180,95,85,25.218,0,2009,2,119,296,224,0.839199675673845,14,19.4461538461538,105,1247.87576503044,0.325193158060179
21499,524817.48,5350219.422,174,71,103,15.639,0,2010,3,134,301,194,0.818538847681325,69.3,19.1879120879121,60,1247.87576503044,0.325193158060179
21499,524817.48,5350219.422,151,63,88,22.712,0,2011,3,112,320,200,0.812030939970408,108.7,18.4846153846154,88,1247.87576503044,0.325193158060179
21499,524817.48,5350219.422,167,94,73,25.34,0,2012,2,127,313,202,0.837176980359437,6.9,19.8923076923077,75,1247.87576503044,0.325193158060179
21499,524817.48,5350219.422,181,62,119,16.591,0,2013,3,137,304,225,0.866086523609626,-187.7,20.2681318681319,88,1247.87576503044,0.325193158060179
21499,524817.48,5350219.422,147,45,102,26.156,0,2014,3,120,324,224,0.846756108389087,71,18.9736263736264,104,1247.87576503044,0.325193158060179
21499,524817.48,5350219.422,173,79,94,35.668,0,2015,3,113,334,194,0.868753826482494,-210.3,22.0318681318681,81,1247.87576503044,0.325193158060179
21499,524817.48,5350219.422,166,94,72,34.416,1,2016,2,119,341,210,0.893743480012925,-28.3,20.1868131868132,91,1247.87576503044,0.325193158060179
21499,524817.48,5350219.422,157,110,47,29.713,2,2017,1,116,302,184,0.854196416463577,-67,20.9692307692308,68,1247.87576503044,0.325193158060179
21499,524817.48,5350219.422,180,132,48,25.077,0,2018,1,121,300,210,0.834082246029618,-134,21.621978021978,89,1247.87576503044,0.325193158060179
21499,524817.48,5350219.422,164,80,84,33.311,2,2019,3,115,306,200,0.83776789363504,-110.8,21.721978021978,85,1247.87576503044,0.325193158060179
21499,524817.48,5350219.422,0,0,0,120.976,0,2020,0,18,324,225,0.836749586521059,-108.6,20.0032967032967,207,1247.87576503044,0.325193158060179
21500,524817.48,5349987.766,0,0,0,130.494,0,2001,1,33,281,201,0.845175435617154,-10.6,19.1659340659341,168,1251.8053435607,-0.363779675632653
21500,524817.48,5349987.766,84,52,32,20.88,0,2002,1,129,316,240,0.815126555780761,6.29999999999999,19.1637362637363,111,1251.8053435607,-0.363779675632653
21500,524817.48,5349987.766,174,135,39,22.708,0,2003,1,124,333,209,0.814413684186963,-207.1,23.9516483516484,85,1251.8053435607,-0.363779675632653
21500,524817.48,5349987.766,172,121,51,22.778,0,2004,1,127,337,185,0.778892367339115,109,18.7549450549451,58,1251.8053435607,-0.363779675632653
21500,524817.48,5349987.766,186,93,93,28.354,0,2005,2,124,315,217,0.820965608764393,-46.2,18.9098901098901,93,1251.8053435607,-0.363779675632653
21500,524817.48,5349987.766,195,106,89,15.117,0,2006,1,138,325,194,0.813478374878056,29.4,19.8868131868132,56,1251.8053435607,-0.363779675632653
21500,524817.48,5349987.766,138,93,45,29.603,0,2007,2,115,302,201,0.837223228743496,236.4,18.0659340659341,86,1251.8053435607,-0.363779675632653
21500,524817.48,5349987.766,86,66,20,24.247,0,2008,1,122,307,192,0.821899813222882,13.4,18.4934065934066,70,1251.8053435607,-0.363779675632653
21500,524817.48,5349987.766,182,106,76,23.016,0,2009,2,122,299,225,0.819521619269971,14,19.4461538461538,103,1251.8053435607,-0.363779675632653
21500,524817.48,5349987.766,179,71,108,16.547,0,2010,2,133,306,201,0.809161228364186,69.3,19.1879120879121,68,1251.8053435607,-0.363779675632653
21500,524817.48,5349987.766,142,64,78,21.494,0,2011,5,114,320,200,0.806573547991016,108.7,18.4846153846154,86,1251.8053435607,-0.363779675632653
21500,524817.48,5349987.766,168,94,74,23.299,0,2012,2,129,311,209,0.832748782567108,6.9,19.8923076923077,80,1251.8053435607,-0.363779675632653
21500,524817.48,5349987.766,181,62,119,7.369,0,2013,3,146,302,216,0.850919680868553,-187.7,20.2681318681319,70,1251.8053435607,-0.363779675632653
21500,524817.48,5349987.766,151,44,107,26.786,0,2014,3,119,324,216,0.860142890291829,71,18.9736263736264,97,1251.8053435607,-0.363779675632653
21500,524817.48,5349987.766,180,79,101,28.273,0,2015,2,122,338,208,0.848692482814919,-210.3,22.0318681318681,86,1251.8053435607,-0.363779675632653
21500,524817.48,5349987.766,166,94,72,40.713,4,2016,2,113,342,210,0.870431954845216,-28.3,20.1868131868132,97,1251.8053435607,-0.363779675632653
21500,524817.48,5349987.766,154,100,54,33.915,4,2017,2,110,304,192,0.827939085664508,-67,20.9692307692308,82,1251.8053435607,-0.363779675632653
21500,524817.48,5349987.766,179,131,48,26.659,0,2018,1,119,301,193,0.834186898464092,-134,21.621978021978,74,1251.8053435607,-0.363779675632653
21500,524817.48,5349987.766,170,80,90,29.823,2,2019,3,119,308,201,0.837714906709031,-110.8,21.721978021978,82,1251.8053435607,-0.363779675632653
21500,524817.48,5349987.766,0,0,0,120.976,0,2020,0,18,325,226,0.829839155759879,-108.6,20.0032967032967,208,1251.8053435607,-0.363779675632653
21502,524817.48,5349524.453,0,0,0,49.231,0,2001,2,103,300,194,0.826007694009821,-10.6,19.1659340659341,91,1253.37261216956,0.788176970627097
21502,524817.48,5349524.453,86,49,37,20.88,0,2002,1,129,317,273,0.769156341639072,6.29999999999999,19.1637362637363,144,1253.37261216956,0.788176970627097
21502,524817.48,5349524.453,176,83,93,26.028,0,2003,3,120,308,194,0.822791571275869,-207.1,23.9516483516484,74,1253.37261216956,0.788176970627097
21502,524817.48,5349524.453,173,58,115,21.92,0,2004,3,128,315,210,0.833925393902662,109,18.7549450549451,82,1253.37261216956,0.788176970627097
21502,524817.48,5349524.453,171,94,77,28.354,0,2005,2,124,312,192,0.81926210770859,-46.2,18.9098901098901,68,1253.37261216956,0.788176970627097
21502,524817.48,5349524.453,198,93,105,19.617,0,2006,3,133,335,186,0.806545194719029,29.4,19.8868131868132,53,1253.37261216956,0.788176970627097
21502,524817.48,5349524.453,93,93,0,34.208,0,2007,1,108,296,177,0.835361047249676,236.4,18.0659340659341,69,1253.37261216956,0.788176970627097
21502,524817.48,5349524.453,86,61,25,23.277,0,2008,1,123,290,177,0.829728293190026,13.4,18.4934065934066,54,1253.37261216956,0.788176970627097
21502,524817.48,5349524.453,183,67,116,24.474,0,2009,3,120,297,226,0.817231115346073,14,19.4461538461538,106,1253.37261216956,0.788176970627097
21502,524817.48,5349524.453,172,62,110,14.73,0,2010,2,135,303,193,0.803139246870153,69.3,19.1879120879121,58,1253.37261216956,0.788176970627097
21502,524817.48,5349524.453,157,98,59,22.097,0,2011,2,113,319,193,0.815644142121081,108.7,18.4846153846154,80,1253.37261216956,0.788176970627097
21502,524817.48,5349524.453,181,93,88,24.313,0,2012,1,128,317,178,0.829493828112669,6.9,19.8923076923077,50,1253.37261216956,0.788176970627097
21502,524817.48,5349524.453,184,113,71,19.429,0,2013,2,134,297,217,0.833436324579675,-187.7,20.2681318681319,83,1253.37261216956,0.788176970627097
21502,524817.48,5349524.453,159,48,111,28.593,0,2014,3,116,314,193,0.849347077953319,71,18.9736263736264,77,1253.37261216956,0.788176970627097
21502,524817.48,5349524.453,174,118,56,27.111,0,2015,1,123,334,194,0.848616741027023,-210.3,22.0318681318681,71,1253.37261216956,0.788176970627097
21502,524817.48,5349524.453,172,121,51,3.145,0,2016,2,155,340,216,0.870794674553011,-28.3,20.1868131868132,61,1253.37261216956,0.788176970627097
21502,524817.48,5349524.453,149,94,55,31.078,2,2017,1,114,295,178,0.824361385486579,-67,20.9692307692308,64,1253.37261216956,0.788176970627097
21502,524817.48,5349524.453,182,53,129,29.103,0,2018,2,116,313,193,0.833973060741673,-134,21.621978021978,77,1253.37261216956,0.788176970627097
21502,524817.48,5349524.453,169,96,73,22.028,0,2019,2,128,300,200,0.843244061249941,-110.8,21.721978021978,72,1253.37261216956,0.788176970627097
21502,524817.48,5349524.453,0,0,0,24.883,0,2020,0,113,321,210,0.819364875626529,-108.6,20.0032967032967,97,1253.37261216956,0.788176970627097
21503,524817.48,5349292.797,86,86,0,44.734,4,2001,3,107,296,193,0.825977941420502,-10.6,19.1659340659341,86,1275.46566198692,-1.27323717703138
21503,524817.48,5349292.797,148,66,82,18.934,0,2002,3,131,319,209,0.796094675677587,6.29999999999999,19.1637362637363,78,1275.46566198692,-1.27323717703138
21503,524817.48,5349292.797,173,83,90,29.969,0,2003,3,115,313,225,0.777246932448275,-207.1,23.9516483516484,110,1275.46566198692,-1.27323717703138
21503,524817.48,5349292.797,175,110,65,22.778,0,2004,2,127,329,217,0.818637177245912,109,18.7549450549451,90,1275.46566198692,-1.27323717703138
21503,524817.48,5349292.797,165,139,26,32.183,0,2005,1,120,311,192,0.825299053596864,-46.2,18.9098901098901,72,1275.46566198692,-1.27323717703138
21503,524817.48,5349292.797,190,61,129,30.118,0,2006,3,121,333,193,0.804703777044108,29.4,19.8868131868132,72,1275.46566198692,-1.27323717703138
21503,524817.48,5349292.797,132,93,39,34.927,0,2007,3,107,296,200,0.813749440893045,236.4,18.0659340659341,93,1275.46566198692,-1.27323717703138
21503,524817.48,5349292.797,135,61,74,18.773,0,2008,3,128,290,193,0.808475640932186,13.4,18.4934065934066,65,1275.46566198692,-1.27323717703138
21503,524817.48,5349292.797,186,64,122,17.051,0,2009,4,130,295,209,0.816328950209595,14,19.4461538461538,79,1275.46566198692,-1.27323717703138
21503,524817.48,5349292.797,165,75,90,19.826,0,2010,3,129,291,193,0.808895432559917,69.3,19.1879120879121,64,1275.46566198692,-1.27323717703138
21503,524817.48,5349292.797,150,63,87,23.343,0,2011,3,111,318,194,0.79998176442274,108.7,18.4846153846154,83,1275.46566198692,-1.27323717703138
21503,524817.48,5349292.797,178,93,85,25.34,0,2012,2,127,307,193,0.811433805738367,6.9,19.8923076923077,66,1275.46566198692,-1.27323717703138
21503,524817.48,5349292.797,198,61,137,6.324,0,2013,3,147,296,209,0.846538848935211,-187.7,20.2681318681319,62,1275.46566198692,-1.27323717703138
21503,524817.48,5349292.797,151,44,107,26.786,0,2014,3,119,311,193,0.842348920000235,71,18.9736263736264,74,1275.46566198692,-1.27323717703138
21503,524817.48,5349292.797,174,95,79,27.111,0,2015,2,123,331,200,0.834744341343453,-210.3,22.0318681318681,77,1275.46566198692,-1.27323717703138
21503,524817.48,5349292.797,167,94,73,4.243,0,2016,2,156,338,217,0.836641846778225,-28.3,20.1868131868132,61,1275.46566198692,-1.27323717703138
21503,524817.48,5349292.797,152,101,51,27.363,0,2017,2,119,298,208,0.81708029409733,-67,20.9692307692308,89,1275.46566198692,-1.27323717703138
21503,524817.48,5349292.797,177,55,122,31.613,0,2018,2,113,315,176,0.839787489985679,-134,21.621978021978,63,1275.46566198692,-1.27323717703138
21503,524817.48,5349292.797,169,93,76,23.749,1,2019,2,126,289,194,0.816015489634783,-110.8,21.721978021978,68,1275.46566198692,-1.27323717703138
21503,524817.48,5349292.797,145,85,60,21.283,0,2020,3,120,313,210,0.808147963037087,-108.6,20.0032967032967,90,1275.46566198692,-1.27323717703138
21504,524817.48,5349061.14,86,85,1,20.478,0,2001,3,130,298,193,0.822293245929906,-10.6,19.1659340659341,63,1280.96981286854,1.05378747010406
21504,524817.48,5349061.14,150,66,84,16.005,0,2002,3,134,314,233,0.773163650397699,6.29999999999999,19.1637362637363,99,1280.96981286854,1.05378747010406
21504,524817.48,5349061.14,175,83,92,26.819,0,2003,3,119,311,218,0.775083899126491,-207.1,23.9516483516484,99,1280.96981286854,1.05378747010406
21504,524817.48,5349061.14,175,107,68,17.066,0,2004,2,133,325,225,0.848543892365812,109,18.7549450549451,92,1280.96981286854,1.05378747010406
21504,524817.48,5349061.14,165,136,29,28.354,0,2005,1,124,313,185,0.820719815393475,-46.2,18.9098901098901,61,1280.96981286854,1.05378747010406
21504,524817.48,5349061.14,190,63,127,32.89,0,2006,3,118,335,193,0.8145099023165,29.4,19.8868131868132,75,1280.96981286854,1.05378747010406
21504,524817.48,5349061.14,132,93,39,34.927,0,2007,3,107,294,193,0.79915337801271,236.4,18.0659340659341,86,1280.96981286854,1.05378747010406
21504,524817.48,5349061.14,136,61,75,17.951,0,2008,2,129,289,178,0.801840269352698,13.4,18.4934065934066,49,1280.96981286854,1.05378747010406
21504,524817.48,5349061.14,181,61,120,17.785,0,2009,3,129,284,194,0.817133513908463,14,19.4461538461538,65,1280.96981286854,1.05378747010406
21504,524817.48,5349061.14,167,73,94,16.547,0,2010,2,133,287,186,0.792094894996495,69.3,19.1879120879121,53,1280.96981286854,1.05378747010406
21504,524817.48,5349061.14,155,66,89,23.343,0,2011,2,111,313,185,0.802180000480534,108.7,18.4846153846154,74,1280.96981286854,1.05378747010406
21504,524817.48,5349061.14,178,94,84,20.296,0,2012,2,132,302,193,0.823192745522961,6.9,19.8923076923077,61,1280.96981286854,1.05378747010406
21504,524817.48,5349061.14,191,59,132,17.553,0,2013,3,136,299,208,0.833220344448611,-187.7,20.2681318681319,72,1280.96981286854,1.05378747010406
21504,524817.48,5349061.14,154,45,109,27.4,0,2014,2,118,309,202,0.803525637256094,71,18.9736263736264,84,1280.96981286854,1.05378747010406
21504,524817.48,5349061.14,175,96,79,28.273,0,2015,2,122,325,193,0.83385104978606,-210.3,22.0318681318681,71,1280.96981286854,1.05378747010406
21504,524817.48,5349061.14,173,139,34,5.943,0,2016,1,148,331,210,0.833891083954805,-28.3,20.1868131868132,62,1280.96981286854,1.05378747010406
21504,524817.48,5349061.14,148,94,54,21.923,0,2017,2,126,296,201,0.822215098012485,-67,20.9692307692308,75,1280.96981286854,1.05378747010406
21504,524817.48,5349061.14,178,54,124,29.934,0,2018,3,115,313,177,0.819873775137841,-134,21.621978021978,62,1280.96981286854,1.05378747010406
21504,524817.48,5349061.14,170,98,72,20.159,0,2019,2,130,296,194,0.8333141749734,-110.8,21.721978021978,64,1280.96981286854,1.05378747010406
21504,524817.48,5349061.14,146,86,60,17.124,0,2020,3,127,313,209,0.801241753976474,-108.6,20.0032967032967,82,1280.96981286854,1.05378747010406
21505,524817.48,5348829.484,86,82,4,18.62,0,2001,2,132,302,193,0.826957443709847,-10.6,19.1659340659341,61,1281.82731562414,0.47590629009579
21505,524817.48,5348829.484,107,76,31,16.974,0,2002,3,133,300,194,0.818126488978746,6.29999999999999,19.1637362637363,61,1281.82731562414,0.47590629009579
21505,524817.48,5348829.484,174,77,97,25.196,0,2003,3,121,289,210,0.782864484844601,-207.1,23.9516483516484,89,1281.82731562414,0.47590629009579
21505,524817.48,5348829.484,175,31,144,12.329,0,2004,3,138,301,226,0.832681458943707,109,18.7549450549451,88,1281.82731562414,0.47590629009579
21505,524817.48,5348829.484,167,93,74,26.383,0,2005,2,126,309,186,0.826918794930223,-46.2,18.9098901098901,60,1281.82731562414,0.47590629009579
21505,524817.48,5348829.484,189,61,128,34.766,0,2006,2,116,335,177,0.773864819211671,29.4,19.8868131868132,61,1281.82731562414,0.47590629009579
21505,524817.48,5348829.484,146,93,53,30.837,0,2007,2,113,294,169,0.830039329568929,236.4,18.0659340659341,56,1281.82731562414,0.47590629009579
21505,524817.48,5348829.484,118,57,61,17.155,0,2008,2,130,296,177,0.805095016612107,13.4,18.4934065934066,47,1281.82731562414,0.47590629009579
21505,524817.48,5348829.484,190,63,127,17.785,0,2009,4,129,297,193,0.818752599129751,14,19.4461538461538,64,1281.82731562414,0.47590629009579
21505,524817.48,5348829.484,176,68,108,17.398,0,2010,2,132,289,193,0.809356552348232,69.3,19.1879120879121,61,1281.82731562414,0.47590629009579
21505,524817.48,5348829.484,136,95,41,24.647,0,2011,1,109,313,160,0.768453681538782,108.7,18.4846153846154,51,1281.82731562414,0.47590629009579
21505,524817.48,5348829.484,166,95,71,28.402,0,2012,2,124,304,186,0.832414647582342,6.9,19.8923076923077,62,1281.82731562414,0.47590629009579
21505,524817.48,5348829.484,183,68,115,13.643,0,2013,3,140,301,208,0.845083238379195,-187.7,20.2681318681319,68,1281.82731562414,0.47590629009579
21505,524817.48,5348829.484,151,45,106,28.593,0,2014,3,116,309,217,0.824874914517922,71,18.9736263736264,101,1281.82731562414,0.47590629009579
21505,524817.48,5348829.484,172,72,100,27.111,0,2015,3,123,315,194,0.833535892526776,-210.3,22.0318681318681,71,1281.82731562414,0.47590629009579
21505,524817.48,5348829.484,178,153,25,23.216,0,2016,1,130,329,216,0.831279568012053,-28.3,20.1868131868132,86,1281.82731562414,0.47590629009579
21505,524817.48,5348829.484,154,108,46,32.477,2,2017,1,112,297,178,0.797015629459156,-67,20.9692307692308,66,1281.82731562414,0.47590629009579
21505,524817.48,5348829.484,170,65,105,33.29,0,2018,3,111,316,186,0.812402598932517,-134,21.621978021978,75,1281.82731562414,0.47590629009579
21505,524817.48,5348829.484,170,93,77,18.153,0,2019,2,132,299,194,0.801141343438165,-110.8,21.721978021978,62,1281.82731562414,0.47590629009579
21505,524817.48,5348829.484,86,72,14,21.782,0,2020,1,119,314,209,0.801042054736724,-108.6,20.0032967032967,90,1281.82731562414,0.47590629009579
21506,524817.48,5348597.828,86,82,4,17.734,0,2001,2,133,302,200,0.821535038430852,-10.6,19.1659340659341,67,1286.08871788248,0.994902907337696
21506,524817.48,5348597.828,107,75,32,17.948,0,2002,3,132,308,194,0.816508365216832,6.29999999999999,19.1637362637363,62,1286.08871788248,0.994902907337696
21506,524817.48,5348597.828,176,82,94,24.355,0,2003,3,122,290,209,0.772797631742696,-207.1,23.9516483516484,87,1286.08871788248,0.994902907337696
21506,524817.48,5348597.828,179,31,148,21.92,0,2004,3,128,300,193,0.764577352201228,109,18.7549450549451,65,1286.08871788248,0.994902907337696
21506,524817.48,5348597.828,162,93,69,25.385,0,2005,2,127,307,192,0.806118513594761,-46.2,18.9098901098901,65,1286.08871788248,0.994902907337696
21506,524817.48,5348597.828,189,59,130,35.699,0,2006,2,115,336,178,0.777281828873457,29.4,19.8868131868132,63,1286.08871788248,0.994902907337696
21506,524817.48,5348597.828,145,93,52,32.138,0,2007,2,111,297,169,0.823158142984332,236.4,18.0659340659341,58,1286.08871788248,0.994902907337696
21506,524817.48,5348597.828,116,57,59,15.633,0,2008,3,132,302,185,0.796728664900191,13.4,18.4934065934066,53,1286.08871788248,0.994902907337696
21506,524817.48,5348597.828,190,64,126,19.99,0,2009,4,126,298,193,0.819781240622266,14,19.4461538461538,67,1286.08871788248,0.994902907337696
21506,524817.48,5348597.828,172,68,104,17.398,0,2010,3,132,287,194,0.806791562019525,69.3,19.1879120879121,62,1286.08871788248,0.994902907337696
21506,524817.48,5348597.828,137,96,41,26.013,0,2011,1,107,317,161,0.766136289351606,108.7,18.4846153846154,54,1286.08871788248,0.994902907337696
21506,524817.48,5348597.828,166,97,69,32.481,0,2012,2,120,310,193,0.81983512325863,6.9,19.8923076923077,73,1286.08871788248,0.994902907337696
21506,524817.48,5348597.828,186,68,118,12.636,0,2013,2,141,301,209,0.837685579312462,-187.7,20.2681318681319,68,1286.08871788248,0.994902907337696
21506,524817.48,5348597.828,156,45,111,30.342,0,2014,3,113,311,217,0.837455642270269,71,18.9736263736264,104,1286.08871788248,0.994902907337696
21506,524817.48,5348597.828,172,73,99,29.285,0,2015,3,121,329,201,0.833304136934936,-210.3,22.0318681318681,80,1286.08871788248,0.994902907337696
21506,524817.48,5348597.828,177,146,31,24.129,0,2016,1,129,328,209,0.833300774734203,-28.3,20.1868131868132,80,1286.08871788248,0.994902907337696
21506,524817.48,5348597.828,151,94,57,31.773,2,2017,2,113,297,184,0.79018651263001,-67,20.9692307692308,71,1286.08871788248,0.994902907337696
21506,524817.48,5348597.828,169,65,104,39.929,0,2018,2,104,318,170,0.831415741396295,-134,21.621978021978,66,1286.08871788248,0.994902907337696
21506,524817.48,5348597.828,170,93,77,20.159,0,2019,2,130,294,200,0.794066206101915,-110.8,21.721978021978,70,1286.08871788248,0.994902907337696
21506,524817.48,5348597.828,83,66,17,25.443,0,2020,1,112,316,209,0.805173664421125,-108.6,20.0032967032967,97,1286.08871788248,0.994902907337696
21507,524817.48,5348366.171,0,0,0,21.444,0,2001,2,129,290,193,0.845455301486593,-10.6,19.1659340659341,64,1249.05145852243,-1.074855229978
21507,524817.48,5348366.171,86,66,20,18.934,0,2002,1,131,310,226,0.811212075726591,6.29999999999999,19.1637362637363,95,1249.05145852243,-1.074855229978
21507,524817.48,5348366.171,171,115,56,25.196,0,2003,1,121,287,184,0.84295849766154,-207.1,23.9516483516484,63,1249.05145852243,-1.074855229978
21507,524817.48,5348366.171,180,30,150,15.105,0,2004,3,135,331,185,0.822216434066397,109,18.7549450549451,50,1249.05145852243,-1.074855229978
21507,524817.48,5348366.171,172,94,78,24.325,0,2005,2,128,311,192,0.816336593292296,-46.2,18.9098901098901,64,1249.05145852243,-1.074855229978
21507,524817.48,5348366.171,192,93,99,31.026,0,2006,2,120,329,185,0.815822007068577,29.4,19.8868131868132,65,1249.05145852243,-1.074855229978
21507,524817.48,5348366.171,136,93,43,45.084,0,2007,3,95,297,185,0.83753338660642,236.4,18.0659340659341,90,1249.05145852243,-1.074855229978
21507,524817.48,5348366.171,86,58,28,13.48,0,2008,1,135,301,194,0.849273566457838,13.4,18.4934065934066,59,1249.05145852243,-1.074855229978
21507,524817.48,5348366.171,175,63,112,25.218,0,2009,2,119,306,192,0.841523383396796,14,19.4461538461538,73,1249.05145852243,-1.074855229978
21507,524817.48,5348366.171,173,74,99,19.063,0,2010,3,130,296,201,0.835820045645131,69.3,19.1879120879121,71,1249.05145852243,-1.074855229978
21507,524817.48,5348366.171,93,93,0,26.716,0,2011,1,106,316,178,0.791792398006177,108.7,18.4846153846154,72,1249.05145852243,-1.074855229978
21507,524817.48,5348366.171,169,93,76,29.461,0,2012,2,123,308,201,0.837622475935648,6.9,19.8923076923077,78,1249.05145852243,-1.074855229978
21507,524817.48,5348366.171,185,81,104,12.636,0,2013,3,141,297,209,0.848851728041285,-187.7,20.2681318681319,68,1249.05145852243,-1.074855229978
21507,524817.48,5348366.171,152,42,110,30.942,0,2014,3,112,310,200,0.784317687757445,71,18.9736263736264,88,1249.05145852243,-1.074855229978
21507,524817.48,5348366.171,172,93,79,27.111,0,2015,2,123,324,185,0.851496451876822,-210.3,22.0318681318681,62,1249.05145852243,-1.074855229978
21507,524817.48,5348366.171,176,102,74,19.538,0,2016,2,134,329,242,0.798189686058946,-28.3,20.1868131868132,108,1249.05145852243,-1.074855229978
21507,524817.48,5348366.171,151,99,52,30.397,2,2017,2,115,306,209,0.830450718813944,-67,20.9692307692308,94,1249.05145852243,-1.074855229978
21507,524817.48,5348366.171,177,61,116,29.103,0,2018,2,116,305,178,0.837054965973505,-134,21.621978021978,62,1249.05145852243,-1.074855229978
21507,524817.48,5348366.171,173,76,97,18.153,0,2019,3,132,300,194,0.847730958629718,-110.8,21.721978021978,62,1249.05145852243,-1.074855229978
21507,524817.48,5348366.171,93,85,8,23.289,0,2020,3,116,313,208,0.814528924250566,-108.6,20.0032967032967,92,1249.05145852243,-1.074855229978
21508,524817.48,5348134.515,0,0,0,25.485,0,2001,2,125,297,193,0.857251469187619,-10.6,19.1659340659341,68,1232.58103635628,1.38540252186109
21508,524817.48,5348134.515,86,67,19,18.934,0,2002,1,131,308,193,0.817955919187826,6.29999999999999,19.1637362637363,62,1232.58103635628,1.38540252186109
21508,524817.48,5348134.515,170,93,77,26.819,0,2003,2,119,316,185,0.856566744539664,-207.1,23.9516483516484,66,1232.58103635628,1.38540252186109
21508,524817.48,5348134.515,182,98,84,12.329,0,2004,1,138,333,185,0.839198224200168,109,18.7549450549451,47,1232.58103635628,1.38540252186109
21508,524817.48,5348134.515,171,94,77,29.304,0,2005,1,123,311,177,0.82413967234788,-46.2,18.9098901098901,54,1232.58103635628,1.38540252186109
21508,524817.48,5348134.515,192,93,99,31.95,0,2006,2,119,325,200,0.859340413289376,29.4,19.8868131868132,81,1232.58103635628,1.38540252186109
21508,524817.48,5348134.515,136,93,43,44.134,0,2007,2,96,292,177,0.847010926759758,236.4,18.0659340659341,81,1232.58103635628,1.38540252186109
21508,524817.48,5348134.515,86,58,28,12.796,0,2008,1,136,307,200,0.855304680160805,13.4,18.4934065934066,64,1232.58103635628,1.38540252186109
21508,524817.48,5348134.515,181,64,117,21.502,0,2009,4,124,311,192,0.849851533537334,14,19.4461538461538,68,1232.58103635628,1.38540252186109
21508,524817.48,5348134.515,175,75,100,22.734,0,2010,3,125,300,192,0.846135272443084,69.3,19.1879120879121,67,1232.58103635628,1.38540252186109
21508,524817.48,5348134.515,93,93,0,27.432,0,2011,1,105,320,176,0.82798587479976,108.7,18.4846153846154,71,1232.58103635628,1.38540252186109
21508,524817.48,5348134.515,169,93,76,28.402,0,2012,2,124,313,185,0.869497244626633,6.9,19.8923076923077,61,1232.58103635628,1.38540252186109
21508,524817.48,5348134.515,189,82,107,15.597,0,2013,2,138,294,208,0.863407028098751,-187.7,20.2681318681319,70,1232.58103635628,1.38540252186109
21508,524817.48,5348134.515,155,41,114,30.942,0,2014,3,112,306,194,0.789978179784916,71,18.9736263736264,82,1232.58103635628,1.38540252186109
21508,524817.48,5348134.515,173,77,96,29.285,0,2015,2,121,328,186,0.858256899970969,-210.3,22.0318681318681,65,1232.58103635628,1.38540252186109
21508,524817.48,5348134.515,175,93,82,17.584,0,2016,2,136,330,194,0.86042935659301,-28.3,20.1868131868132,58,1232.58103635628,1.38540252186109
21508,524817.48,5348134.515,152,94,58,25.813,0,2017,2,121,304,193,0.837077978607241,-67,20.9692307692308,72,1232.58103635628,1.38540252186109
21508,524817.48,5348134.515,177,58,119,29.103,0,2018,2,116,316,176,0.86469169715765,-134,21.621978021978,60,1232.58103635628,1.38540252186109
21508,524817.48,5348134.515,168,79,89,17.15,0,2019,3,133,303,193,0.851383244901158,-110.8,21.721978021978,60,1232.58103635628,1.38540252186109
21508,524817.48,5348134.515,93,93,0,24.883,0,2020,2,113,312,200,0.819321595999943,-108.6,20.0032967032967,87,1232.58103635628,1.38540252186109
21509,524817.48,5347902.859,0,0,0,32.749,0,2001,2,118,314,193,0.831713991598643,-10.6,19.1659340659341,75,1246.57730196252,1.47419972785991
21509,524817.48,5347902.859,86,72,14,34.717,0,2002,1,114,314,241,0.791169792602655,6.29999999999999,19.1637362637363,127,1246.57730196252,1.47419972785991
21509,524817.48,5347902.859,170,102,68,26.028,0,2003,2,120,326,192,0.82026771400989,-207.1,23.9516483516484,72,1246.57730196252,1.47419972785991
21509,524817.48,5347902.859,174,43,131,16.077,0,2004,3,134,338,193,0.818246886950207,109,18.7549450549451,59,1246.57730196252,1.47419972785991
21509,524817.48,5347902.859,158,99,59,31.193,0,2005,2,121,314,257,0.772651191088979,-46.2,18.9098901098901,136,1246.57730196252,1.47419972785991
21509,524817.48,5347902.859,183,67,116,25.841,0,2006,3,126,334,193,0.839907385964326,29.4,19.8868131868132,67,1246.57730196252,1.47419972785991
21509,524817.48,5347902.859,0,0,0,38.834,0,2007,0,102,307,161,0.854772295706374,236.4,18.0659340659341,59,1246.57730196252,1.47419972785991
21509,524817.48,5347902.859,86,57,29,20.499,0,2008,1,126,304,192,0.826413031059351,13.4,18.4934065934066,66,1246.57730196252,1.47419972785991
21509,524817.48,5347902.859,180,65,115,33.145,0,2009,3,109,314,193,0.832012779927155,14,19.4461538461538,84,1246.57730196252,1.47419972785991
21509,524817.48,5347902.859,165,93,72,29.838,0,2010,2,115,298,194,0.831039881516289,69.3,19.1879120879121,79,1246.57730196252,1.47419972785991
21509,524817.48,5347902.859,136,65,71,32.695,0,2011,2,98,324,161,0.788705783341768,108.7,18.4846153846154,63,1246.57730196252,1.47419972785991
21509,524817.48,5347902.859,177,93,84,29.461,0,2012,2,123,319,184,0.849436695425475,6.9,19.8923076923077,61,1246.57730196252,1.47419972785991
21509,524817.48,5347902.859,180,76,104,15.597,0,2013,3,138,299,200,0.834012115850974,-187.7,20.2681318681319,62,1246.57730196252,1.47419972785991
21509,524817.48,5347902.859,142,56,86,37.831,0,2014,5,101,320,218,0.840665945327201,71,18.9736263736264,117,1246.57730196252,1.47419972785991
21509,524817.48,5347902.859,168,99,69,35.668,0,2015,2,113,342,192,0.845908702591039,-210.3,22.0318681318681,79,1246.57730196252,1.47419972785991
21509,524817.48,5347902.859,169,93,76,26.044,0,2016,2,127,339,200,0.853057831443054,-28.3,20.1868131868132,73,1246.57730196252,1.47419972785991
21509,524817.48,5347902.859,156,94,62,28.158,0,2017,2,118,314,185,0.824082930422396,-67,20.9692307692308,67,1246.57730196252,1.47419972785991
21509,524817.48,5347902.859,167,71,96,37.943,0,2018,2,106,319,170,0.83459245940944,-134,21.621978021978,64,1246.57730196252,1.47419972785991
21509,524817.48,5347902.859,162,94,68,31.597,2,2019,2,117,304,201,0.816766163925269,-110.8,21.721978021978,84,1246.57730196252,1.47419972785991
21509,524817.48,5347902.859,86,66,20,114.435,23,2020,1,25,324,192,0.793109669750604,-108.6,20.0032967032967,167,1246.57730196252,1.47419972785991
21581,524817.48,5331223.601,143,86,57,42.576,4,2001,3,110,291,201,0.868151985220125,103.5,18.1120879120879,91,1157.10140107885,-0.706858369494955
21581,524817.48,5331223.601,152,77,75,27.076,0,2002,3,123,292,193,0.876476879120351,46.4,18.2428571428571,70,1157.10140107885,-0.706858369494955
21581,524817.48,5331223.601,159,61,98,35.971,0,2003,2,111,317,170,0.862438093112905,-203.8,22.9692307692308,59,1157.10140107885,-0.706858369494955
21581,524817.48,5331223.601,166,93,73,27.526,0,2004,2,123,326,184,0.854977303688897,196.1,17.7461538461538,61,1157.10140107885,-0.706858369494955
21581,524817.48,5331223.601,152,94,58,42.902,0,2005,2,112,302,184,0.890727882840043,38.9,17.9032967032967,72,1157.10140107885,-0.706858369494955
21581,524817.48,5331223.601,184,93,91,33.054,0,2006,2,121,334,185,0.865131080600682,82.6,18.867032967033,64,1157.10140107885,-0.706858369494955
21581,524817.48,5331223.601,164,96,68,40.043,0,2007,2,103,291,192,0.869013777884703,317.9,17.0824175824176,89,1157.10140107885,-0.706858369494955
21581,524817.48,5331223.601,86,54,32,22.643,0,2008,1,123,294,186,0.888908034098765,40.8,17.6131868131868,63,1157.10140107885,-0.706858369494955
21581,524817.48,5331223.601,173,64,109,38.55,0,2009,2,106,294,170,0.920469767595701,41,18.5230769230769,64,1157.10140107885,-0.706858369494955
21581,524817.48,5331223.601,164,66,98,28.148,0,2010,3,120,300,186,0.887914262033847,122,18.3626373626374,66,1157.10140107885,-0.706858369494955
21581,524817.48,5331223.601,93,70,23,29.819,0,2011,3,105,313,186,0.853487462987486,127.1,17.5,81,1157.10140107885,-0.706858369494955
21581,524817.48,5331223.601,147,95,52,34.445,0,2012,2,118,272,185,0.896206835084836,82.8,18.7043956043956,67,1157.10140107885,-0.706858369494955
21581,524817.48,5331223.601,180,63,117,4.692,0,2013,3,149,295,208,0.88075976895474,-163.1,19.2582417582418,59,1157.10140107885,-0.706858369494955
21581,524817.48,5331223.601,163,50,113,30.898,0,2014,3,114,338,201,0.855486393576901,176.9,17.856043956044,87,1157.10140107885,-0.706858369494955
21581,524817.48,5331223.601,156,105,51,34.844,0,2015,1,115,271,177,0.879420969825879,-158.6,20.9142857142857,62,1157.10140107885,-0.706858369494955
21581,524817.48,5331223.601,170,93,77,35.915,2,2016,2,119,320,200,0.880554938550938,45.5,18.8857142857143,81,1157.10140107885,-0.706858369494955
21581,524817.48,5331223.601,143,94,49,29.541,1,2017,2,118,300,185,0.8567421311593,-10.8,19.7879120879121,67,1157.10140107885,-0.706858369494955
21581,524817.48,5331223.601,164,76,88,35.844,0,2018,2,110,302,176,0.886885564438482,-154,20.578021978022,66,1157.10140107885,-0.706858369494955
21581,524817.48,5331223.601,167,93,74,28.119,4,2019,1,122,322,177,0.872893762999303,-79.8,20.6626373626374,55,1157.10140107885,-0.706858369494955
21581,524817.48,5331223.601,0,0,0,20.328,0,2020,0,122,304,217,0.815045614549796,-19.2,19.0648351648352,95,1157.10140107885,-0.706858369494955
21582,524817.48,5330991.945,145,86,59,39.272,1,2001,3,113,311,192,0.84579297429507,103.5,18.1120879120879,79,1107.69728575803,0.236746874463977
21582,524817.48,5330991.945,152,79,73,37.538,0,2002,2,111,290,169,0.842123497245363,46.4,18.2428571428571,58,1107.69728575803,0.236746874463977
21582,524817.48,5330991.945,151,60,91,38.54,1,2003,2,108,286,169,0.874099166196429,-203.8,22.9692307692308,61,1107.69728575803,0.236746874463977
21582,524817.48,5330991.945,171,93,78,30.168,0,2004,1,120,325,177,0.863237892765794,196.1,17.7461538461538,57,1107.69728575803,0.236746874463977
21582,524817.48,5330991.945,152,94,58,48.62,0,2005,1,107,309,170,0.880599269820938,38.9,17.9032967032967,63,1107.69728575803,0.236746874463977
21582,524817.48,5330991.945,184,93,91,37.621,1,2006,1,117,337,177,0.840379916659384,82.6,18.867032967033,60,1107.69728575803,0.236746874463977
21582,524817.48,5330991.945,0,0,0,57.788,0,2007,0,85,298,169,0.854935393221392,317.9,17.0824175824176,84,1107.69728575803,0.236746874463977
21582,524817.48,5330991.945,86,54,32,30.024,0,2008,1,116,302,193,0.870361461769021,40.8,17.6131868131868,77,1107.69728575803,0.236746874463977
21582,524817.48,5330991.945,174,68,106,41.881,0,2009,2,103,295,176,0.918065601810733,41,18.5230769230769,73,1107.69728575803,0.236746874463977
21582,524817.48,5330991.945,165,65,100,30.712,0,2010,2,117,305,177,0.858471360887266,122,18.3626373626374,60,1107.69728575803,0.236746874463977
21582,524817.48,5330991.945,86,70,16,34.83,1,2011,1,99,316,169,0.845026338408361,127.1,17.5,70,1107.69728575803,0.236746874463977
21582,524817.48,5330991.945,149,94,55,40.85,0,2012,2,112,293,202,0.860218234597146,82.8,18.7043956043956,90,1107.69728575803,0.236746874463977
21582,524817.48,5330991.945,180,60,120,15.626,0,2013,3,139,298,186,0.864228641931205,-163.1,19.2582417582418,47,1107.69728575803,0.236746874463977
21582,524817.48,5330991.945,160,50,110,35.971,2,2014,2,106,339,170,0.829176363615531,176.9,17.856043956044,64,1107.69728575803,0.236746874463977
21582,524817.48,5330991.945,152,93,59,40.878,0,2015,1,108,279,168,0.873575183391987,-158.6,20.9142857142857,60,1107.69728575803,0.236746874463977
21582,524817.48,5330991.945,168,93,75,43.353,6,2016,2,112,323,202,0.867367156437375,45.5,18.8857142857143,90,1107.69728575803,0.236746874463977
21582,524817.48,5330991.945,143,93,50,35.559,5,2017,1,110,309,177,0.83820606259888,-10.8,19.7879120879121,67,1107.69728575803,0.236746874463977
21582,524817.48,5330991.945,166,75,91,39.97,0,2018,2,106,304,169,0.889268917402812,-154,20.578021978022,63,1107.69728575803,0.236746874463977
21582,524817.48,5330991.945,167,93,74,29.899,4,2019,1,120,320,170,0.851366608572884,-79.8,20.6626373626374,50,1107.69728575803,0.236746874463977
21582,524817.48,5330991.945,0,0,0,27.122,0,2020,0,110,311,178,0.825638284962989,-19.2,19.0648351648352,68,1107.69728575803,0.236746874463977
21591,524817.48,5328907.037,93,84,9,43.705,5,2001,4,109,289,193,0.84756092772843,103.5,18.1120879120879,84,1206.98179977374,0.416826035307107
21591,524817.48,5328907.037,86,63,23,23.03,0,2002,1,127,289,185,0.840353695536338,46.4,18.2428571428571,58,1206.98179977374,0.416826035307107
21591,524817.48,5328907.037,168,57,111,32.562,0,2003,2,115,306,176,0.859477550449776,-203.8,22.9692307692308,61,1206.98179977374,0.416826035307107
21591,524817.48,5328907.037,181,93,88,23.072,0,2004,2,128,320,185,0.844228045544973,196.1,17.7461538461538,57,1206.98179977374,0.416826035307107
21591,524817.48,5328907.037,166,93,73,42.902,0,2005,3,112,302,185,0.856223544437442,38.9,17.9032967032967,73,1206.98179977374,0.416826035307107
21591,524817.48,5328907.037,194,64,130,26.088,0,2006,2,128,324,176,0.850786510236055,82.6,18.867032967033,48,1206.98179977374,0.416826035307107
21591,524817.48,5328907.037,0,0,0,35.449,0,2007,0,109,293,192,0.858594608673937,317.9,17.0824175824176,83,1206.98179977374,0.416826035307107
21591,524817.48,5328907.037,137,52,85,16.445,0,2008,3,130,297,193,0.83305705815787,40.8,17.6131868131868,63,1206.98179977374,0.416826035307107
21591,524817.48,5328907.037,185,60,125,25.203,0,2009,3,120,290,169,0.879570757684683,41,18.5230769230769,49,1206.98179977374,0.416826035307107
21591,524817.48,5328907.037,171,73,98,20.72,0,2010,3,129,298,200,0.842778697509099,122,18.3626373626374,71,1206.98179977374,0.416826035307107
21591,524817.48,5328907.037,117,60,57,29.021,0,2011,2,106,315,169,0.819768904616849,127.1,17.5,63,1206.98179977374,0.416826035307107
21591,524817.48,5328907.037,156,81,75,29.335,0,2012,3,123,303,186,0.832069426301421,82.8,18.7043956043956,63,1206.98179977374,0.416826035307107
21591,524817.48,5328907.037,181,45,136,33.539,0,2013,2,122,298,185,0.861396332793665,-163.1,19.2582417582418,63,1206.98179977374,0.416826035307107
21591,524817.48,5328907.037,158,44,114,30.898,0,2014,3,114,329,209,0.851492528549048,176.9,17.856043956044,95,1206.98179977374,0.416826035307107
21591,524817.48,5328907.037,163,126,37,34.05,0,2015,1,116,311,176,0.842932286370328,-158.6,20.9142857142857,60,1206.98179977374,0.416826035307107
21591,524817.48,5328907.037,168,114,54,30.443,0,2016,1,124,320,177,0.890947863409132,45.5,18.8857142857143,53,1206.98179977374,0.416826035307107
21591,524817.48,5328907.037,138,99,39,23.133,0,2017,1,126,294,178,0.821522604018769,-10.8,19.7879120879121,52,1206.98179977374,0.416826035307107
21591,524817.48,5328907.037,172,64,108,32.25,0,2018,2,114,304,170,0.868726919466715,-154,20.578021978022,56,1206.98179977374,0.416826035307107
21591,524817.48,5328907.037,161,93,68,23.635,1,2019,1,127,320,170,0.789170013581842,-79.8,20.6626373626374,43,1206.98179977374,0.416826035307107
21591,524817.48,5328907.037,93,93,0,20.946,1,2020,2,121,305,201,0.799474246005996,-19.2,19.0648351648352,80,1206.98179977374,0.416826035307107
21592,524817.48,5328675.381,93,84,9,44.831,6,2001,3,108,289,178,0.851593301587296,103.5,18.1120879120879,70,1199.56497240515,-1.31393463904932
21592,524817.48,5328675.381,86,64,22,23.03,0,2002,1,127,290,192,0.861858904256044,46.4,18.2428571428571,65,1199.56497240515,-1.31393463904932
21592,524817.48,5328675.381,172,58,114,30.907,0,2003,2,117,300,170,0.842621708964182,-203.8,22.9692307692308,53,1199.56497240515,-1.31393463904932
21592,524817.48,5328675.381,176,99,77,26.664,0,2004,1,124,322,185,0.843820034015158,196.1,17.7461538461538,61,1199.56497240515,-1.31393463904932
21592,524817.48,5328675.381,167,117,50,42.902,0,2005,1,112,303,185,0.861932299697022,38.9,17.9032967032967,73,1199.56497240515,-1.31393463904932
21592,524817.48,5328675.381,192,64,128,30.925,0,2006,2,123,334,176,0.837523010660883,82.6,18.867032967033,53,1199.56497240515,-1.31393463904932
21592,524817.48,5328675.381,0,0,0,37.648,0,2007,0,106,292,209,0.820974451753726,317.9,17.0824175824176,103,1199.56497240515,-1.31393463904932
21592,524817.48,5328675.381,135,52,83,15.668,0,2008,3,131,299,185,0.862339932548134,40.8,17.6131868131868,54,1199.56497240515,-1.31393463904932
21592,524817.48,5328675.381,173,62,111,45.396,0,2009,2,100,289,177,0.875181989109238,41,18.5230769230769,77,1199.56497240515,-1.31393463904932
21592,524817.48,5328675.381,170,73,97,21.571,0,2010,3,128,297,194,0.842965335825932,122,18.3626373626374,66,1199.56497240515,-1.31393463904932
21592,524817.48,5328675.381,125,57,68,29.021,0,2011,2,106,316,168,0.81371714709942,127.1,17.5,62,1199.56497240515,-1.31393463904932
21592,524817.48,5328675.381,159,81,78,28.294,0,2012,3,124,303,194,0.845315518917062,82.8,18.7043956043956,70,1199.56497240515,-1.31393463904932
21592,524817.48,5328675.381,182,45,137,30.119,0,2013,3,125,289,185,0.856988470022333,-163.1,19.2582417582418,60,1199.56497240515,-1.31393463904932
21592,524817.48,5328675.381,155,42,113,33.407,0,2014,2,110,319,185,0.843414464631802,176.9,17.856043956044,75,1199.56497240515,-1.31393463904932
21592,524817.48,5328675.381,159,93,66,35.641,0,2015,1,114,290,176,0.848883587227394,-158.6,20.9142857142857,62,1199.56497240515,-1.31393463904932
21592,524817.48,5328675.381,164,93,71,32.703,0,2016,1,122,320,177,0.879731885369695,45.5,18.8857142857143,55,1199.56497240515,-1.31393463904932
21592,524817.48,5328675.381,137,100,37,23.949,0,2017,1,125,297,178,0.819187118846857,-10.8,19.7879120879121,53,1199.56497240515,-1.31393463904932
21592,524817.48,5328675.381,171,64,107,33.134,0,2018,2,113,304,169,0.856860440062649,-154,20.578021978022,56,1199.56497240515,-1.31393463904932
21592,524817.48,5328675.381,164,93,71,22.743,0,2019,1,128,322,176,0.798836240960632,-79.8,20.6626373626374,48,1199.56497240515,-1.31393463904932
21592,524817.48,5328675.381,93,93,0,21.533,1,2020,2,120,303,201,0.810196256066135,-19.2,19.0648351648352,81,1199.56497240515,-1.31393463904932
21593,524817.48,5328443.725,147,86,61,37.114,0,2001,4,115,290,185,0.863535889726621,103.5,18.1120879120879,70,1222.28835592342,0.08954843848981
21593,524817.48,5328443.725,102,73,29,23.03,0,2002,3,127,285,193,0.863713430528163,46.4,18.2428571428571,66,1222.28835592342,0.08954843848981
21593,524817.48,5328443.725,165,59,106,27.482,0,2003,2,121,281,170,0.860661499716219,-203.8,22.9692307692308,49,1222.28835592342,0.08954843848981
21593,524817.48,5328443.725,141,48,93,25.797,0,2004,3,125,322,186,0.862373478898885,196.1,17.7461538461538,61,1222.28835592342,0.08954843848981
21593,524817.48,5328443.725,165,106,59,34.089,0,2005,1,120,292,184,0.87236326440293,38.9,17.9032967032967,64,1222.28835592342,0.08954843848981
21593,524817.48,5328443.725,184,64,120,16.147,0,2006,2,138,329,177,0.837687166297228,82.6,18.867032967033,39,1222.28835592342,0.08954843848981
21593,524817.48,5328443.725,172,95,77,39.224,0,2007,2,104,292,185,0.866166090734953,317.9,17.0824175824176,81,1222.28835592342,0.08954843848981
21593,524817.48,5328443.725,0,0,0,14.92,0,2008,0,132,294,193,0.848724225958244,40.8,17.6131868131868,61,1222.28835592342,0.08954843848981
21593,524817.48,5328443.725,150,93,57,30.375,0,2009,1,114,286,170,0.895777278096275,41,18.5230769230769,56,1222.28835592342,0.08954843848981
21593,524817.48,5328443.725,156,93,63,28.148,0,2010,2,120,302,186,0.845104979004012,122,18.3626373626374,66,1222.28835592342,0.08954843848981
21593,524817.48,5328443.725,93,93,0,29.819,0,2011,1,105,312,176,0.843144930578064,127.1,17.5,71,1222.28835592342,0.08954843848981
21593,524817.48,5328443.725,156,106,50,27.277,0,2012,2,125,303,200,0.848858353892746,82.8,18.7043956043956,75,1222.28835592342,0.08954843848981
21593,524817.48,5328443.725,179,100,79,31.278,0,2013,1,124,292,186,0.870349983789428,-163.1,19.2582417582418,62,1222.28835592342,0.08954843848981
21593,524817.48,5328443.725,151,66,85,33.407,0,2014,2,110,315,194,0.861176513048875,176.9,17.856043956044,84,1222.28835592342,0.08954843848981
21593,524817.48,5328443.725,0,0,0,34.05,0,2015,0,116,324,177,0.85590547744476,-158.6,20.9142857142857,61,1222.28835592342,0.08954843848981
21593,524817.48,5328443.725,170,119,51,31.57,0,2016,1,123,326,185,0.889439811323982,45.5,18.8857142857143,62,1222.28835592342,0.08954843848981
21593,524817.48,5328443.725,122,93,29,23.133,0,2017,2,126,303,184,0.846153648356052,-10.8,19.7879120879121,58,1222.28835592342,0.08954843848981
21593,524817.48,5328443.725,86,64,22,33.134,0,2018,1,113,302,169,0.852095246275533,-154,20.578021978022,56,1222.28835592342,0.08954843848981
21593,524817.48,5328443.725,160,93,67,24.54,2,2019,1,126,323,177,0.848441230641442,-79.8,20.6626373626374,51,1222.28835592342,0.08954843848981
21593,524817.48,5328443.725,100,93,7,21.533,1,2020,2,120,307,194,0.78037734807763,-19.2,19.0648351648352,74,1222.28835592342,0.08954843848981
21640,524817.48,5317555.876,0,0,0,55.545,0,2001,2,98,325,170,0.829399793463017,-26.7,20.3989010989011,72,1069.6903705753,0.783040323836197
21640,524817.48,5317555.876,128,77,51,39.028,0,2002,3,109,333,185,0.809348962420363,-5.6,20.2901098901099,76,1069.6903705753,0.783040323836197
21640,524817.48,5317555.876,153,93,60,34.774,0,2003,1,108,285,161,0.834968084574634,-214.1,25.0835164835165,53,1069.6903705753,0.783040323836197
21640,524817.48,5317555.876,152,100,52,31.346,0,2004,1,117,333,169,0.806482686009303,90.8,19.910989010989,52,1069.6903705753,0.783040323836197
21640,524817.48,5317555.876,153,93,60,60.512,1,2005,1,93,303,160,0.860779313151739,-56.5,19.9923076923077,67,1069.6903705753,0.783040323836197
21640,524817.48,5317555.876,184,61,123,38.533,0,2006,2,112,333,169,0.821077044675416,16.2,20.9538461538462,57,1069.6903705753,0.783040323836197
21640,524817.48,5317555.876,0,0,0,48.223,0,2007,0,92,300,162,0.843460461044555,213,19.1032967032967,70,1069.6903705753,0.783040323836197
21640,524817.48,5317555.876,86,74,12,35.43,0,2008,1,112,302,177,0.81722146047822,-1.79999999999999,19.6,65,1069.6903705753,0.783040323836197
21640,524817.48,5317555.876,179,60,119,31.151,0,2009,3,111,304,162,0.872416337925804,-2.8,20.5450549450549,51,1069.6903705753,0.783040323836197
21640,524817.48,5317555.876,168,93,75,29.035,0,2010,1,116,306,178,0.81796054500127,50.5,20.2241758241758,62,1069.6903705753,0.783040323836197
21640,524817.48,5317555.876,111,63,48,37.912,0,2011,3,92,322,242,0.755083485283323,90.7,19.4164835164835,150,1069.6903705753,0.783040323836197
21640,524817.48,5317555.876,133,93,40,48.933,1,2012,1,102,305,177,0.843645903923051,-6,20.743956043956,75,1069.6903705753,0.783040323836197
21640,524817.48,5317555.876,170,68,102,35.767,0,2013,2,118,310,176,0.835937690681747,-200.2,21.3494505494505,58,1069.6903705753,0.783040323836197
21640,524817.48,5317555.876,152,110,42,43.979,0,2014,1,92,324,162,0.786956756443876,51.4,19.8307692307692,70,1069.6903705753,0.783040323836197
21640,524817.48,5317555.876,93,86,7,56.923,4,2015,2,92,339,154,0.822767612806104,-218.4,23.0318681318681,62,1069.6903705753,0.783040323836197
21640,524817.48,5317555.876,173,141,32,49.939,1,2016,1,105,327,185,0.814296584083105,-39.8,20.9813186813187,80,1069.6903705753,0.783040323836197
21640,524817.48,5317555.876,129,93,36,48.605,3,2017,1,91,313,153,0.740391400489485,-77.9,22.0516483516484,62,1069.6903705753,0.783040323836197
21640,524817.48,5317555.876,151,68,83,59.178,1,2018,2,86,334,152,0.819458601693812,-139.3,22.7065934065934,66,1069.6903705753,0.783040323836197
21640,524817.48,5317555.876,156,93,63,44.182,2,2019,1,103,309,161,0.782519425051937,-118.9,22.7472527472527,58,1069.6903705753,0.783040323836197
21640,524817.48,5317555.876,0,0,0,39.375,0,2020,0,92,314,162,0.734960139173287,-119,21.1252747252747,70,1069.6903705753,0.783040323836197
21717,525049.136,5350451.079,0,0,0,124.067,0,2001,2,40,308,218,0.814354242379441,4.09999999999999,18.2296703296703,178,1243.64066167261,-1.22237725486991
21717,525049.136,5350451.079,86,74,12,29.337,0,2002,1,121,320,226,0.813701023293605,18.8,18.3868131868132,105,1243.64066167261,-1.22237725486991
21717,525049.136,5350451.079,171,70,101,30.167,0,2003,3,116,330,202,0.797994225263259,-204,23.121978021978,86,1243.64066167261,-1.22237725486991
21717,525049.136,5350451.079,179,94,85,13.46,0,2004,2,137,305,256,0.778497887969976,123.8,17.9692307692308,119,1243.64066167261,-1.22237725486991
21717,525049.136,5350451.079,159,93,66,27.58,0,2005,2,125,311,202,0.814141502067873,-31.4,18.0615384615385,77,1243.64066167261,-1.22237725486991
21717,525049.136,5350451.079,195,68,127,15.452,0,2006,3,138,342,233,0.796942343162897,43,19.0516483516484,95,1243.64066167261,-1.22237725486991
21717,525049.136,5350451.079,174,93,81,34.966,0,2007,4,108,299,209,0.862144649539375,258.5,17.3142857142857,101,1243.64066167261,-1.22237725486991
21717,525049.136,5350451.079,86,64,22,24.556,0,2008,1,122,299,185,0.824363343868546,29.3,17.7417582417582,63,1243.64066167261,-1.22237725486991
21717,525049.136,5350451.079,188,52,136,18.227,0,2009,3,130,303,201,0.831884591625974,27.1,18.689010989011,71,1243.64066167261,-1.22237725486991
21717,525049.136,5350451.079,173,74,99,18.356,0,2010,3,132,295,208,0.805477029025146,87.4,18.4241758241758,76,1243.64066167261,-1.22237725486991
21717,525049.136,5350451.079,154,53,101,23.052,0,2011,5,114,316,226,0.780002518841869,129,17.5824175824176,112,1243.64066167261,-1.22237725486991
21717,525049.136,5350451.079,164,94,70,27.718,0,2012,2,125,316,201,0.843966959135754,29,18.7703296703297,76,1243.64066167261,-1.22237725486991
21717,525049.136,5350451.079,184,71,113,11.754,0,2013,3,142,292,226,0.844750485633974,-172.4,19.2857142857143,84,1243.64066167261,-1.22237725486991
21717,525049.136,5350451.079,63,40,23,28.558,0,2014,1,118,343,232,0.816953545374204,91.5,17.9450549450549,114,1243.64066167261,-1.22237725486991
21717,525049.136,5350451.079,173,99,74,28.578,0,2015,2,122,321,193,0.893015569890876,-197.8,21,71,1243.64066167261,-1.22237725486991
21717,525049.136,5350451.079,179,94,85,9.003,0,2016,2,145,344,208,0.845225527667196,-13,19.132967032967,63,1243.64066167261,-1.22237725486991
21717,525049.136,5350451.079,150,94,56,32.773,2,2017,2,113,292,209,0.850193135884566,-57.8,20.1032967032967,96,1243.64066167261,-1.22237725486991
21717,525049.136,5350451.079,177,50,127,24.449,0,2018,3,123,299,201,0.848877068834032,-125.4,20.7956043956044,78,1243.64066167261,-1.22237725486991
21717,525049.136,5350451.079,174,71,103,29.394,3,2019,3,120,303,209,0.857360398935945,-108.1,20.8824175824176,89,1243.64066167261,-1.22237725486991
21717,525049.136,5350451.079,86,55,31,124.288,36,2020,1,17,322,217,0.833278699557768,-97.4,19.156043956044,200,1243.64066167261,-1.22237725486991
21718,525049.136,5350219.422,93,93,0,40.249,2,2001,4,111,305,201,0.828296240938066,-10.6,19.1659340659341,90,1257.40069146485,-0.990330995124905
21718,525049.136,5350219.422,0,0,0,12.369,0,2002,0,138,316,202,0.82637073587468,6.29999999999999,19.1637362637363,64,1257.40069146485,-0.990330995124905
21718,525049.136,5350219.422,179,101,78,23.526,0,2003,2,123,290,216,0.816810032099856,-207.1,23.9516483516484,93,1257.40069146485,-0.990330995124905
21718,525049.136,5350219.422,183,29,154,9.792,0,2004,3,141,333,224,0.827719642669182,109,18.7549450549451,83,1257.40069146485,-0.990330995124905
21718,525049.136,5350219.422,170,94,76,25.385,0,2005,2,127,312,201,0.825952228155257,-46.2,18.9098901098901,74,1257.40069146485,-0.990330995124905
21718,525049.136,5350219.422,201,151,50,12.19,0,2006,1,141,334,194,0.794526915327415,29.4,19.8868131868132,53,1257.40069146485,-0.990330995124905
21718,525049.136,5350219.422,93,93,0,29.603,0,2007,2,115,293,185,0.849403077473437,236.4,18.0659340659341,70,1257.40069146485,-0.990330995124905
21718,525049.136,5350219.422,130,54,76,20.499,0,2008,3,126,287,186,0.817385105101583,13.4,18.4934065934066,60,1257.40069146485,-0.990330995124905
21718,525049.136,5350219.422,193,100,93,14.037,0,2009,2,134,301,202,0.830886188341496,14,19.4461538461538,68,1257.40069146485,-0.990330995124905
21718,525049.136,5350219.422,175,84,91,12.931,0,2010,3,137,292,210,0.809684228101797,69.3,19.1879120879121,73,1257.40069146485,-0.990330995124905
21718,525049.136,5350219.422,153,54,99,15.971,0,2011,5,123,316,201,0.77899906911461,108.7,18.4846153846154,78,1257.40069146485,-0.990330995124905
21718,525049.136,5350219.422,183,80,103,25.34,0,2012,3,127,313,186,0.845388236108324,6.9,19.8923076923077,59,1257.40069146485,-0.990330995124905
21718,525049.136,5350219.422,183,93,90,10.535,0,2013,2,143,296,224,0.849917965686834,-187.7,20.2681318681319,81,1257.40069146485,-0.990330995124905
21718,525049.136,5350219.422,147,42,105,14.742,0,2014,3,135,330,217,0.855860009461471,71,18.9736263736264,82,1257.40069146485,-0.990330995124905
21718,525049.136,5350219.422,176,120,56,23.45,0,2015,1,126,328,202,0.844660942451293,-210.3,22.0318681318681,76,1257.40069146485,-0.990330995124905
21718,525049.136,5350219.422,182,143,39,17.584,0,2016,1,136,340,202,0.858496922812444,-28.3,20.1868131868132,66,1257.40069146485,-0.990330995124905
21718,525049.136,5350219.422,150,100,50,25.813,0,2017,2,121,297,234,0.80636434982557,-67,20.9692307692308,113,1257.40069146485,-0.990330995124905
21718,525049.136,5350219.422,182,55,127,31.613,0,2018,2,113,299,184,0.85256494458734,-134,21.621978021978,71,1257.40069146485,-0.990330995124905
21718,525049.136,5350219.422,173,53,120,20.159,0,2019,3,130,299,217,0.834432865272501,-110.8,21.721978021978,87,1257.40069146485,-0.990330995124905
21718,525049.136,5350219.422,86,66,20,20.17,0,2020,1,122,309,216,0.829839393940306,-108.6,20.0032967032967,94,1257.40069146485,-0.990330995124905
21719,525049.136,5349987.766,93,93,0,35.935,0,2001,4,115,303,208,0.821893609386251,-10.6,19.1659340659341,93,1268.03990043457,0.406839499821303
21719,525049.136,5349987.766,85,84,1,16.005,0,2002,1,134,316,202,0.825894750522488,6.29999999999999,19.1637362637363,68,1268.03990043457,0.406839499821303
21719,525049.136,5349987.766,178,93,85,24.355,0,2003,2,122,288,217,0.802379919740912,-207.1,23.9516483516484,95,1268.03990043457,0.406839499821303
21719,525049.136,5349987.766,186,28,158,8.999,0,2004,2,142,337,224,0.826630352585347,109,18.7549450549451,82,1268.03990043457,0.406839499821303
21719,525049.136,5349987.766,175,123,52,23.256,0,2005,2,129,310,233,0.788802781073619,-46.2,18.9098901098901,104,1268.03990043457,0.406839499821303
21719,525049.136,5349987.766,202,157,45,11.204,0,2006,1,142,335,186,0.768709855442844,29.4,19.8868131868132,44,1268.03990043457,0.406839499821303
21719,525049.136,5349987.766,0,0,0,29.603,0,2007,0,115,299,186,0.838260554539882,236.4,18.0659340659341,71,1268.03990043457,0.406839499821303
21719,525049.136,5349987.766,131,55,76,17.951,0,2008,3,129,302,201,0.816774629039427,13.4,18.4934065934066,72,1268.03990043457,0.406839499821303
21719,525049.136,5349987.766,193,93,100,14.037,0,2009,2,134,302,202,0.828503302438322,14,19.4461538461538,68,1268.03990043457,0.406839499821303
21719,525049.136,5349987.766,174,107,67,17.398,0,2010,2,132,288,202,0.803279954243554,69.3,19.1879120879121,70,1268.03990043457,0.406839499821303
21719,525049.136,5349987.766,156,54,102,17.823,0,2011,5,120,317,218,0.775504906295545,108.7,18.4846153846154,98,1268.03990043457,0.406839499821303
21719,525049.136,5349987.766,183,80,103,23.299,0,2012,3,129,311,193,0.841609186004045,6.9,19.8923076923077,64,1268.03990043457,0.406839499821303
21719,525049.136,5349987.766,188,93,95,11.587,0,2013,2,142,298,224,0.842586498269351,-187.7,20.2681318681319,82,1268.03990043457,0.406839499821303
21719,525049.136,5349987.766,148,44,104,21.176,0,2014,3,127,326,217,0.845494156479361,71,18.9736263736264,90,1268.03990043457,0.406839499821303
21719,525049.136,5349987.766,177,119,58,21.218,0,2015,1,128,324,202,0.837558898157329,-210.3,22.0318681318681,74,1268.03990043457,0.406839499821303
21719,525049.136,5349987.766,183,153,30,10.848,0,2016,1,143,341,202,0.84873733122715,-28.3,20.1868131868132,59,1268.03990043457,0.406839499821303
21719,525049.136,5349987.766,150,94,56,33.191,3,2017,2,111,298,234,0.804040735574988,-67,20.9692307692308,123,1268.03990043457,0.406839499821303
21719,525049.136,5349987.766,183,55,128,30.78,0,2018,2,114,298,170,0.867072024264406,-134,21.621978021978,56,1268.03990043457,0.406839499821303
21719,525049.136,5349987.766,177,55,122,22.883,0,2019,2,127,301,208,0.82755473503975,-110.8,21.721978021978,81,1268.03990043457,0.406839499821303
21719,525049.136,5349987.766,86,66,20,29.057,0,2020,1,106,311,218,0.824882504360646,-108.6,20.0032967032967,112,1268.03990043457,0.406839499821303
21720,525049.136,5349756.11,0,0,0,36.991,0,2001,2,114,304,194,0.810787094038741,-10.6,19.1659340659341,80,1264.89404297327,1.35656524448752
21720,525049.136,5349756.11,155,67,88,26.07,0,2002,3,124,319,273,0.760322387315054,6.29999999999999,19.1637362637363,149,1264.89404297327,1.35656524448752
21720,525049.136,5349756.11,175,118,57,24.355,0,2003,2,122,291,210,0.786644896628698,-207.1,23.9516483516484,88,1264.89404297327,1.35656524448752
21720,525049.136,5349756.11,171,25,146,21.92,0,2004,3,128,337,224,0.802107288718786,109,18.7549450549451,96,1264.89404297327,1.35656524448752
21720,525049.136,5349756.11,172,94,78,23.256,0,2005,2,129,307,249,0.769611050221711,-46.2,18.9098901098901,120,1264.89404297327,1.35656524448752
21720,525049.136,5349756.11,192,58,134,18.715,0,2006,3,134,324,210,0.789293651568289,29.4,19.8868131868132,76,1264.89404297327,1.35656524448752
21720,525049.136,5349756.11,93,93,0,32.813,0,2007,2,110,300,201,0.83288515522866,236.4,18.0659340659341,91,1264.89404297327,1.35656524448752
21720,525049.136,5349756.11,129,56,73,24.247,0,2008,3,122,309,202,0.808032370263802,13.4,18.4934065934066,80,1264.89404297327,1.35656524448752
21720,525049.136,5349756.11,193,66,127,14.037,0,2009,2,134,289,208,0.810115110484992,14,19.4461538461538,74,1264.89404297327,1.35656524448752
21720,525049.136,5349756.11,173,74,99,13.826,0,2010,2,136,294,210,0.780980061234666,69.3,19.1879120879121,74,1264.89404297327,1.35656524448752
21720,525049.136,5349756.11,153,98,55,22.712,0,2011,2,112,317,217,0.754559758910481,108.7,18.4846153846154,105,1264.89404297327,1.35656524448752
21720,525049.136,5349756.11,164,81,83,28.402,0,2012,3,124,295,192,0.837227037377727,6.9,19.8923076923077,68,1264.89404297327,1.35656524448752
21720,525049.136,5349756.11,183,93,90,9.487,0,2013,2,144,304,217,0.820174687024678,-187.7,20.2681318681319,73,1264.89404297327,1.35656524448752
21720,525049.136,5349756.11,155,46,109,28.593,0,2014,3,116,311,210,0.835762170047716,71,18.9736263736264,94,1264.89404297327,1.35656524448752
21720,525049.136,5349756.11,176,117,59,24.634,0,2015,2,125,337,208,0.81811468410493,-210.3,22.0318681318681,83,1264.89404297327,1.35656524448752
21720,525049.136,5349756.11,172,121,51,29.133,0,2016,1,124,342,185,0.77104610255888,-28.3,20.1868131868132,61,1264.89404297327,1.35656524448752
21720,525049.136,5349756.11,152,106,46,37.527,6,2017,2,105,297,232,0.791956212350035,-67,20.9692307692308,127,1264.89404297327,1.35656524448752
21720,525049.136,5349756.11,180,79,101,29.103,0,2018,2,116,305,169,0.860027624082211,-134,21.621978021978,53,1264.89404297327,1.35656524448752
21720,525049.136,5349756.11,171,102,69,31.597,2,2019,2,117,296,202,0.824175742266926,-110.8,21.721978021978,85,1264.89404297327,1.35656524448752
21720,525049.136,5349756.11,86,45,41,38.687,2,2020,1,93,318,217,0.815792829277406,-108.6,20.0032967032967,124,1264.89404297327,1.35656524448752
21721,525049.136,5349524.453,0,0,0,105.058,0,2001,2,56,301,201,0.81654978167696,-10.6,19.1659340659341,145,1269.97479165901,-0.609122611686457
21721,525049.136,5349524.453,156,66,90,25.016,0,2002,3,125,319,274,0.772663824634024,6.29999999999999,19.1637362637363,149,1269.97479165901,-0.609122611686457
21721,525049.136,5349524.453,174,118,56,28.4,0,2003,2,117,291,208,0.793898392375078,-207.1,23.9516483516484,91,1269.97479165901,-0.609122611686457
21721,525049.136,5349524.453,175,25,150,29.503,0,2004,2,119,342,216,0.828823255919518,109,18.7549450549451,97,1269.97479165901,-0.609122611686457
21721,525049.136,5349524.453,172,93,79,29.304,0,2005,2,123,310,201,0.807883874560315,-46.2,18.9098901098901,78,1269.97479165901,-0.609122611686457
21721,525049.136,5349524.453,189,60,129,37.593,0,2006,3,113,325,201,0.799081445525435,29.4,19.8868131868132,88,1269.97479165901,-0.609122611686457
21721,525049.136,5349524.453,93,93,0,33.503,0,2007,2,109,299,209,0.827805385633424,236.4,18.0659340659341,100,1269.97479165901,-0.609122611686457
21721,525049.136,5349524.453,130,56,74,25.23,0,2008,2,121,307,177,0.831017554692855,13.4,18.4934065934066,56,1269.97479165901,-0.609122611686457
21721,525049.136,5349524.453,192,66,126,15.566,0,2009,2,132,296,200,0.820775188799795,14,19.4461538461538,68,1269.97479165901,-0.609122611686457
21721,525049.136,5349524.453,169,74,95,19.063,0,2010,3,130,292,200,0.794429368674635,69.3,19.1879120879121,70,1269.97479165901,-0.609122611686457
21721,525049.136,5349524.453,154,97,57,24.647,0,2011,2,109,317,217,0.786027675444697,108.7,18.4846153846154,108,1269.97479165901,-0.609122611686457
21721,525049.136,5349524.453,165,81,84,27.369,0,2012,3,125,293,193,0.832986375109305,6.9,19.8923076923077,68,1269.97479165901,-0.609122611686457
21721,525049.136,5349524.453,183,98,85,12.636,0,2013,2,141,293,208,0.840311377948132,-187.7,20.2681318681319,67,1269.97479165901,-0.609122611686457
21721,525049.136,5349524.453,155,40,115,30.342,0,2014,3,113,313,209,0.80805957672936,71,18.9736263736264,96,1269.97479165901,-0.609122611686457
21721,525049.136,5349524.453,178,135,43,30.127,0,2015,1,120,334,194,0.834956511298352,-210.3,22.0318681318681,74,1269.97479165901,-0.609122611686457
21721,525049.136,5349524.453,168,94,74,20.507,0,2016,2,133,342,201,0.813069864200561,-28.3,20.1868131868132,68,1269.97479165901,-0.609122611686457
21721,525049.136,5349524.453,150,94,56,38.228,6,2017,1,104,297,178,0.798368107812683,-67,20.9692307692308,74,1269.97479165901,-0.609122611686457
21721,525049.136,5349524.453,173,79,94,36.962,0,2018,3,107,312,185,0.851242842626423,-134,21.621978021978,78,1269.97479165901,-0.609122611686457
21721,525049.136,5349524.453,172,102,70,28.055,2,2019,2,121,302,194,0.830065245463325,-110.8,21.721978021978,73,1269.97479165901,-0.609122611686457
21721,525049.136,5349524.453,86,49,37,27.802,0,2020,1,108,320,217,0.818215536204004,-108.6,20.0032967032967,109,1269.97479165901,-0.609122611686457
21722,525049.136,5349292.797,0,0,0,28.505,0,2001,2,122,317,185,0.842498034769453,-10.6,19.1659340659341,63,1264.13403587367,0.477824877479949
21722,525049.136,5349292.797,160,60,100,26.07,0,2002,3,124,310,273,0.731152093418578,6.29999999999999,19.1637362637363,149,1264.13403587367,0.477824877479949
21722,525049.136,5349292.797,171,93,78,28.4,0,2003,2,117,308,210,0.776254544293788,-207.1,23.9516483516484,93,1264.13403587367,0.477824877479949
21722,525049.136,5349292.797,174,99,75,17.066,0,2004,2,133,325,201,0.787231359402607,109,18.7549450549451,68,1264.13403587367,0.477824877479949
21722,525049.136,5349292.797,164,94,70,34.245,0,2005,2,118,309,185,0.797141454299396,-46.2,18.9098901098901,67,1264.13403587367,0.477824877479949
21722,525049.136,5349292.797,197,61,136,17.808,0,2006,4,135,335,208,0.865239168307982,29.4,19.8868131868132,73,1264.13403587367,0.477824877479949
21722,525049.136,5349292.797,132,93,39,37.213,0,2007,2,104,292,170,0.810694298006868,236.4,18.0659340659341,66,1264.13403587367,0.477824877479949
21722,525049.136,5349292.797,108,60,48,18.773,0,2008,3,128,304,200,0.799631347244666,13.4,18.4934065934066,72,1264.13403587367,0.477824877479949
21722,525049.136,5349292.797,180,66,114,34.012,0,2009,3,108,296,209,0.808535592931759,14,19.4461538461538,101,1264.13403587367,0.477824877479949
21722,525049.136,5349292.797,169,70,99,17.398,0,2010,3,132,299,192,0.795387211980787,69.3,19.1879120879121,60,1264.13403587367,0.477824877479949
21722,525049.136,5349292.797,151,69,82,29.639,0,2011,3,102,320,186,0.78293626596819,108.7,18.4846153846154,84,1264.13403587367,0.477824877479949
21722,525049.136,5349292.797,160,99,61,34.532,0,2012,2,118,295,217,0.810967746506851,6.9,19.8923076923077,99,1264.13403587367,0.477824877479949
21722,525049.136,5349292.797,184,39,145,15.597,0,2013,3,138,300,201,0.824387019173906,-187.7,20.2681318681319,63,1264.13403587367,0.477824877479949
21722,525049.136,5349292.797,152,47,105,33.345,0,2014,3,108,314,194,0.837071159339326,71,18.9736263736264,86,1264.13403587367,0.477824877479949
21722,525049.136,5349292.797,176,137,39,30.964,0,2015,1,119,330,193,0.811368963487728,-210.3,22.0318681318681,74,1264.13403587367,0.477824877479949
21722,525049.136,5349292.797,167,94,73,24.129,0,2016,2,129,335,210,0.847896423599346,-28.3,20.1868131868132,81,1264.13403587367,0.477824877479949
21722,525049.136,5349292.797,140,97,43,35.378,6,2017,1,108,296,176,0.788571871587252,-67,20.9692307692308,68,1264.13403587367,0.477824877479949
21722,525049.136,5349292.797,168,56,112,41.91,0,2018,2,102,312,160,0.890799478745142,-134,21.621978021978,58,1264.13403587367,0.477824877479949
21722,525049.136,5349292.797,156,110,46,27.193,2,2019,1,122,296,185,0.822268109984133,-110.8,21.721978021978,63,1264.13403587367,0.477824877479949
21722,525049.136,5349292.797,86,86,0,23.289,0,2020,1,116,311,194,0.77509166218727,-108.6,20.0032967032967,78,1264.13403587367,0.477824877479949
21730,525049.136,5347439.546,0,0,0,148.769,0,2001,1,16,325,250,0.909936911035694,-10.6,19.1659340659341,234,1130.08306444676,-0.876187533474537
21730,525049.136,5347439.546,154,75,79,47.207,1,2002,3,99,311,240,0.839269594004315,6.29999999999999,19.1637362637363,141,1130.08306444676,-0.876187533474537
21730,525049.136,5347439.546,160,93,67,37.008,1,2003,1,106,311,178,0.766258139418683,-207.1,23.9516483516484,72,1130.08306444676,-0.876187533474537
21730,525049.136,5347439.546,151,45,106,40.324,0,2004,3,107,337,210,0.801186619144527,109,18.7549450549451,103,1130.08306444676,-0.876187533474537
21730,525049.136,5347439.546,0,0,0,75.517,0,2005,0,78,317,265,0.789023243453585,-46.2,18.9098901098901,187,1130.08306444676,-0.876187533474537
21730,525049.136,5347439.546,191,67,124,31.95,0,2006,3,119,349,290,0.827804407740191,29.4,19.8868131868132,171,1130.08306444676,-0.876187533474537
21730,525049.136,5347439.546,165,96,69,53.198,1,2007,1,87,307,145,0.873452149118898,236.4,18.0659340659341,58,1130.08306444676,-0.876187533474537
21730,525049.136,5347439.546,132,55,77,46.427,1,2008,3,102,319,225,0.912994580801101,13.4,18.4934065934066,123,1130.08306444676,-0.876187533474537
21730,525049.136,5347439.546,178,69,109,29.007,0,2009,2,114,321,178,0.973138734755278,14,19.4461538461538,64,1130.08306444676,-0.876187533474537
21730,525049.136,5347439.546,168,93,75,33.916,0,2010,1,110,316,169,0.819626335456116,69.3,19.1879120879121,59,1130.08306444676,-0.876187533474537
21730,525049.136,5347439.546,0,0,0,56.094,0,2011,0,70,326,160,0.796990270250186,108.7,18.4846153846154,90,1130.08306444676,-0.876187533474537
21730,525049.136,5347439.546,150,93,57,45.786,1,2012,1,106,320,168,0.867450381881281,6.9,19.8923076923077,62,1130.08306444676,-0.876187533474537
21730,525049.136,5347439.546,177,93,84,40.148,0,2013,2,113,310,194,0.823383456581888,-187.7,20.2681318681319,81,1130.08306444676,-0.876187533474537
21730,525049.136,5347439.546,86,67,19,70.408,6,2014,1,62,321,226,0.833915671860988,71,18.9736263736264,164,1130.08306444676,-0.876187533474537
21730,525049.136,5347439.546,159,94,65,46.281,0,2015,1,101,345,160,0.84106885961664,-210.3,22.0318681318681,59,1130.08306444676,-0.876187533474537
21730,525049.136,5347439.546,163,93,70,56.391,4,2016,2,98,339,193,0.8567356781272,-28.3,20.1868131868132,95,1130.08306444676,-0.876187533474537
21730,525049.136,5347439.546,128,93,35,51.333,6,2017,1,88,305,169,0.811226258162902,-67,20.9692307692308,81,1130.08306444676,-0.876187533474537
21730,525049.136,5347439.546,162,102,60,48.096,0,2018,1,96,327,178,0.844147609754279,-134,21.621978021978,82,1130.08306444676,-0.876187533474537
21730,525049.136,5347439.546,142,93,49,54.223,8,2019,2,92,328,248,0.771732916907891,-110.8,21.721978021978,156,1130.08306444676,-0.876187533474537
21730,525049.136,5347439.546,0,0,0,124.805,0,2020,0,14,323,169,0.804153746484009,-108.6,20.0032967032967,155,1130.08306444676,-0.876187533474537
21731,525049.136,5347207.89,0,0,0,142.711,0,2001,1,22,332,226,0.83678090742133,-10.6,19.1659340659341,204,1094.63124388869,0.776013334981471
21731,525049.136,5347207.89,152,77,75,53.43,2,2002,3,92,328,242,0.857501218162703,6.29999999999999,19.1637362637363,150,1094.63124388869,0.776013334981471
21731,525049.136,5347207.89,156,93,63,45.717,6,2003,1,96,336,145,0.771058730126477,-207.1,23.9516483516484,49,1094.63124388869,0.776013334981471
21731,525049.136,5347207.89,149,93,56,46.365,0,2004,2,101,340,273,0.882912272838967,109,18.7549450549451,172,1094.63124388869,0.776013334981471
21731,525049.136,5347207.89,0,0,0,92.026,0,2005,0,62,318,152,0.818699779742879,-46.2,18.9098901098901,90,1094.63124388869,0.776013334981471
21731,525049.136,5347207.89,191,67,124,32.89,0,2006,3,118,349,289,0.841169170269064,29.4,19.8868131868132,171,1094.63124388869,0.776013334981471
21731,525049.136,5347207.89,0,0,0,84.602,0,2007,0,59,308,153,0.8453035545408,236.4,18.0659340659341,94,1094.63124388869,0.776013334981471
21731,525049.136,5347207.89,125,55,70,65.95,7,2008,3,84,320,226,0.873223461284973,13.4,18.4934065934066,142,1094.63124388869,0.776013334981471
21731,525049.136,5347207.89,167,69,98,44.687,0,2009,3,96,315,225,0.834021230363922,14,19.4461538461538,129,1094.63124388869,0.776013334981471
21731,525049.136,5347207.89,166,86,80,39.373,0,2010,3,104,319,272,0.828582919323541,69.3,19.1879120879121,168,1094.63124388869,0.776013334981471
21731,525049.136,5347207.89,0,0,0,52.731,0,2011,0,74,327,258,0.824003835243333,108.7,18.4846153846154,184,1094.63124388869,0.776013334981471
21731,525049.136,5347207.89,146,93,53,51.794,3,2012,1,98,321,170,0.858359139684974,6.9,19.8923076923077,72,1094.63124388869,0.776013334981471
21731,525049.136,5347207.89,177,93,84,45.056,0,2013,2,108,313,185,0.842235302042135,-187.7,20.2681318681319,77,1094.63124388869,0.776013334981471
21731,525049.136,5347207.89,85,65,20,73.615,7,2014,1,59,323,249,0.851067989738596,71,18.9736263736264,190,1094.63124388869,0.776013334981471
21731,525049.136,5347207.89,153,97,56,61.269,4,2015,1,87,349,146,0.831814481616631,-210.3,22.0318681318681,59,1094.63124388869,0.776013334981471
21731,525049.136,5347207.89,161,100,61,65.27,4,2016,1,89,337,162,0.870605337214141,-28.3,20.1868131868132,73,1094.63124388869,0.776013334981471
21731,525049.136,5347207.89,128,93,35,54.254,6,2017,1,85,326,169,0.815383543288441,-67,20.9692307692308,84,1094.63124388869,0.776013334981471
21731,525049.136,5347207.89,161,97,64,50.25,0,2018,1,94,333,145,0.846191620225861,-134,21.621978021978,51,1094.63124388869,0.776013334981471
21731,525049.136,5347207.89,138,93,45,62.786,8,2019,2,83,329,242,0.808871870421605,-110.8,21.721978021978,159,1094.63124388869,0.776013334981471
21731,525049.136,5347207.89,0,0,0,60.313,0,2020,0,71,327,168,0.802098982842604,-108.6,20.0032967032967,97,1094.63124388869,0.776013334981471
21811,525049.136,5328675.381,93,93,0,43.705,5,2001,4,109,288,185,0.884317465007114,103.5,18.1120879120879,76,1134.65398877965,1.35120300792131
21811,525049.136,5328675.381,86,76,10,24.05,0,2002,1,126,293,233,0.850554603409794,46.4,18.2428571428571,107,1134.65398877965,1.35120300792131
21811,525049.136,5328675.381,152,60,92,42.224,1,2003,2,104,325,169,0.84090949043045,-203.8,22.9692307692308,65,1134.65398877965,1.35120300792131
21811,525049.136,5328675.381,159,96,63,27.526,0,2004,1,123,328,185,0.852384337587717,196.1,17.7461538461538,62,1134.65398877965,1.35120300792131
21811,525049.136,5328675.381,158,94,64,55.388,0,2005,1,101,301,170,0.862964825806049,38.9,17.9032967032967,69,1134.65398877965,1.35120300792131
21811,525049.136,5328675.381,195,93,102,21.947,0,2006,2,132,333,177,0.837390543258417,82.6,18.867032967033,45,1134.65398877965,1.35120300792131
21811,525049.136,5328675.381,93,93,0,45.373,0,2007,2,97,297,217,0.818957531049007,317.9,17.0824175824176,120,1134.65398877965,1.35120300792131
21811,525049.136,5328675.381,86,57,29,18.936,0,2008,1,127,297,200,0.868543248590466,40.8,17.6131868131868,73,1134.65398877965,1.35120300792131
21811,525049.136,5328675.381,171,60,111,58.767,1,2009,2,89,295,170,0.901466229533306,41,18.5230769230769,81,1134.65398877965,1.35120300792131
21811,525049.136,5328675.381,169,99,70,24.072,0,2010,2,125,294,193,0.857969177385996,122,18.3626373626374,68,1134.65398877965,1.35120300792131
21811,525049.136,5328675.381,93,50,43,33.958,1,2011,2,100,316,169,0.853890769126127,127.1,17.5,69,1134.65398877965,1.35120300792131
21811,525049.136,5328675.381,161,93,68,30.335,0,2012,2,122,312,202,0.847401793830277,82.8,18.7043956043956,80,1134.65398877965,1.35120300792131
21811,525049.136,5328675.381,177,78,99,32.431,0,2013,3,123,298,185,0.871428477986017,-163.1,19.2582417582418,62,1134.65398877965,1.35120300792131
21811,525049.136,5328675.381,151,62,89,34.679,1,2014,3,108,339,218,0.987697964336688,176.9,17.856043956044,110,1134.65398877965,1.35120300792131
21811,525049.136,5328675.381,157,93,64,37.296,0,2015,1,112,326,176,0.854577810969059,-158.6,20.9142857142857,64,1134.65398877965,1.35120300792131
21811,525049.136,5328675.381,164,97,67,42.271,6,2016,1,113,337,178,0.881839666798606,45.5,18.8857142857143,65,1134.65398877965,1.35120300792131
21811,525049.136,5328675.381,126,97,29,30.32,2,2017,1,117,300,178,0.842871191153576,-10.8,19.7879120879121,61,1134.65398877965,1.35120300792131
21811,525049.136,5328675.381,174,72,102,27.023,0,2018,2,120,301,185,0.868908194384097,-154,20.578021978022,65,1134.65398877965,1.35120300792131
21811,525049.136,5328675.381,152,78,74,35.128,4,2019,2,114,327,169,0.826717360906419,-79.8,20.6626373626374,55,1134.65398877965,1.35120300792131
21811,525049.136,5328675.381,106,94,12,29.692,2,2020,2,106,312,201,0.827632525353799,-19.2,19.0648351648352,95,1134.65398877965,1.35120300792131
21812,525049.136,5328443.725,117,86,31,41.461,3,2001,4,111,295,186,0.877163500140994,103.5,18.1120879120879,75,1186.29501822799,1.45299010165239
21812,525049.136,5328443.725,86,76,10,22.032,0,2002,1,128,293,194,0.85850508090521,46.4,18.2428571428571,66,1186.29501822799,1.45299010165239
21812,525049.136,5328443.725,162,61,101,31.737,0,2003,2,116,305,176,0.850527361544321,-203.8,22.9692307692308,60,1186.29501822799,1.45299010165239
21812,525049.136,5328443.725,170,93,77,23.99,0,2004,2,127,327,192,0.862464162713953,196.1,17.7461538461538,65,1186.29501822799,1.45299010165239
21812,525049.136,5328443.725,168,93,75,34.089,0,2005,1,120,299,177,0.878739921592002,38.9,17.9032967032967,57,1186.29501822799,1.45299010165239
21812,525049.136,5328443.725,199,62,137,18.037,0,2006,2,136,322,177,0.856413176654736,82.6,18.867032967033,41,1186.29501822799,1.45299010165239
21812,525049.136,5328443.725,168,95,73,38.424,0,2007,2,105,285,185,0.865316538439064,317.9,17.0824175824176,80,1186.29501822799,1.45299010165239
21812,525049.136,5328443.725,86,66,20,12.797,0,2008,1,135,296,186,0.851160279011869,40.8,17.6131868131868,51,1186.29501822799,1.45299010165239
21812,525049.136,5328443.725,168,56,112,41.881,0,2009,3,103,298,201,0.856532786550941,41,18.5230769230769,98,1186.29501822799,1.45299010165239
21812,525049.136,5328443.725,171,143,28,21.571,0,2010,1,128,299,185,0.851134820229546,122,18.3626373626374,57,1186.29501822799,1.45299010165239
21812,525049.136,5328443.725,86,68,18,30.631,0,2011,1,104,309,170,0.84511962355317,127.1,17.5,66,1186.29501822799,1.45299010165239
21812,525049.136,5328443.725,155,80,75,25.279,0,2012,3,127,305,194,0.858388468077076,82.8,18.7043956043956,67,1186.29501822799,1.45299010165239
21812,525049.136,5328443.725,174,64,110,32.431,0,2013,3,123,296,185,0.870793569384395,-163.1,19.2582417582418,62,1186.29501822799,1.45299010165239
21812,525049.136,5328443.725,143,53,90,32.15,0,2014,3,112,335,217,0.976154431312335,176.9,17.856043956044,105,1186.29501822799,1.45299010165239
21812,525049.136,5328443.725,153,93,60,34.844,0,2015,1,115,299,177,0.8562535290951,-158.6,20.9142857142857,62,1186.29501822799,1.45299010165239
21812,525049.136,5328443.725,167,93,74,31.57,0,2016,2,123,332,185,0.889194010102724,45.5,18.8857142857143,62,1186.29501822799,1.45299010165239
21812,525049.136,5328443.725,128,93,35,32.535,3,2017,1,114,300,178,0.843143236394756,-10.8,19.7879120879121,64,1186.29501822799,1.45299010165239
21812,525049.136,5328443.725,146,97,49,32.25,0,2018,1,114,304,178,0.861931842756259,-154,20.578021978022,64,1186.29501822799,1.45299010165239
21812,525049.136,5328443.725,169,93,76,26.352,4,2019,1,124,324,176,0.841534870399165,-79.8,20.6626373626374,52,1186.29501822799,1.45299010165239
21812,525049.136,5328443.725,105,94,11,26.508,1,2020,2,111,308,201,0.805879402788304,-19.2,19.0648351648352,90,1186.29501822799,1.45299010165239
21813,525049.136,5328212.068,113,93,20,38.195,0,2001,4,114,302,186,0.854003184318849,103.5,18.1120879120879,72,1226.50085681975,0.451634065266762
21813,525049.136,5328212.068,86,76,10,25.084,0,2002,1,125,285,186,0.867221179101467,46.4,18.2428571428571,61,1226.50085681975,0.451634065266762
21813,525049.136,5328212.068,165,56,109,30.069,0,2003,2,118,302,170,0.871990300998369,-203.8,22.9692307692308,52,1226.50085681975,0.451634065266762
21813,525049.136,5328212.068,174,93,81,25.797,0,2004,2,125,319,186,0.873085884243211,196.1,17.7461538461538,61,1226.50085681975,0.451634065266762
21813,525049.136,5328212.068,162,104,58,34.089,0,2005,1,120,299,184,0.875486072673864,38.9,17.9032967032967,64,1226.50085681975,0.451634065266762
21813,525049.136,5328212.068,197,62,135,19,0,2006,2,135,319,177,0.85626290212497,82.6,18.867032967033,42,1226.50085681975,0.451634065266762
21813,525049.136,5328212.068,168,95,73,38.424,0,2007,2,105,283,185,0.88964493736199,317.9,17.0824175824176,80,1226.50085681975,0.451634065266762
21813,525049.136,5328212.068,86,66,20,10.127,0,2008,1,139,295,201,0.883006332195127,40.8,17.6131868131868,62,1226.50085681975,0.451634065266762
21813,525049.136,5328212.068,167,56,111,43.036,0,2009,2,102,297,169,0.867846732505418,41,18.5230769230769,67,1226.50085681975,0.451634065266762
21813,525049.136,5328212.068,167,99,68,20.72,0,2010,1,129,299,185,0.872461221851949,122,18.3626373626374,56,1226.50085681975,0.451634065266762
21813,525049.136,5328212.068,86,67,19,30.631,0,2011,1,104,310,168,0.855749596314549,127.1,17.5,64,1226.50085681975,0.451634065266762
21813,525049.136,5328212.068,155,79,76,29.335,0,2012,3,123,297,185,0.874902945623768,82.8,18.7043956043956,62,1226.50085681975,0.451634065266762
21813,525049.136,5328212.068,181,61,120,27.909,0,2013,3,127,290,186,0.885606214737108,-163.1,19.2582417582418,59,1226.50085681975,0.451634065266762
21813,525049.136,5328212.068,147,54,93,29.689,0,2014,3,116,330,217,0.979262623964158,176.9,17.856043956044,101,1226.50085681975,0.451634065266762
21813,525049.136,5328212.068,155,93,62,32.407,0,2015,1,118,308,177,0.858390844565837,-158.6,20.9142857142857,59,1226.50085681975,0.451634065266762
21813,525049.136,5328212.068,171,97,74,29.319,0,2016,1,125,320,186,0.908403768526641,45.5,18.8857142857143,61,1226.50085681975,0.451634065266762
21813,525049.136,5328212.068,128,93,35,31.805,3,2017,1,115,300,178,0.855276480855936,-10.8,19.7879120879121,63,1226.50085681975,0.451634065266762
21813,525049.136,5328212.068,136,121,15,17.286,0,2018,1,133,303,200,0.82844981096278,-154,20.578021978022,67,1226.50085681975,0.451634065266762
21813,525049.136,5328212.068,166,93,73,25.45,3,2019,1,125,324,177,0.858476839041223,-79.8,20.6626373626374,52,1226.50085681975,0.451634065266762
21813,525049.136,5328212.068,105,94,11,23.643,1,2020,2,116,307,201,0.791183480627587,-19.2,19.0648351648352,85,1226.50085681975,0.451634065266762
21814,525049.136,5327980.412,134,93,41,45.967,6,2001,2,107,290,177,0.873386434246289,103.5,18.1120879120879,70,1212.47322155729,-0.610895381218211
21814,525049.136,5327980.412,86,61,25,29.741,0,2002,1,120,290,194,0.878957915233671,46.4,18.2428571428571,74,1212.47322155729,-0.610895381218211
21814,525049.136,5327980.412,154,93,61,32.562,0,2003,1,115,312,162,0.855102833518898,-203.8,22.9692307692308,47,1212.47322155729,-0.610895381218211
21814,525049.136,5327980.412,167,93,74,27.526,0,2004,2,123,306,185,0.878881185569657,196.1,17.7461538461538,62,1212.47322155729,-0.610895381218211
21814,525049.136,5327980.412,166,103,63,39.638,0,2005,1,115,301,178,0.88701753133882,38.9,17.9032967032967,63,1212.47322155729,-0.610895381218211
21814,525049.136,5327980.412,187,62,125,27.01,0,2006,2,127,320,176,0.868372607945992,82.6,18.867032967033,49,1212.47322155729,-0.610895381218211
21814,525049.136,5327980.412,161,96,65,45.373,0,2007,1,97,295,178,0.873277131577979,317.9,17.0824175824176,81,1212.47322155729,-0.610895381218211
21814,525049.136,5327980.412,86,65,21,15.668,0,2008,1,131,298,186,0.880257571960396,40.8,17.6131868131868,55,1212.47322155729,-0.610895381218211
21814,525049.136,5327980.412,166,66,100,46.599,0,2009,2,99,302,170,0.899852479833292,41,18.5230769230769,71,1212.47322155729,-0.610895381218211
21814,525049.136,5327980.412,156,76,80,24.877,0,2010,3,124,302,185,0.881792894549864,122,18.3626373626374,61,1212.47322155729,-0.610895381218211
21814,525049.136,5327980.412,86,63,23,33.111,1,2011,1,101,306,169,0.873604673382337,127.1,17.5,68,1212.47322155729,-0.610895381218211
21814,525049.136,5327980.412,156,99,57,33.376,0,2012,1,119,299,178,0.900483196036844,82.8,18.7043956043956,59,1212.47322155729,-0.610895381218211
21814,525049.136,5327980.412,185,60,125,18.716,0,2013,3,136,292,193,0.894193669003119,-163.1,19.2582417582418,57,1212.47322155729,-0.610895381218211
21814,525049.136,5327980.412,151,83,68,35.319,1,2014,3,107,329,241,0.820333833093859,176.9,17.856043956044,134,1212.47322155729,-0.610895381218211
21814,525049.136,5327980.412,93,93,0,35.641,0,2015,2,114,298,193,0.852820550808297,-158.6,20.9142857142857,79,1212.47322155729,-0.610895381218211
21814,525049.136,5327980.412,167,100,67,33.772,0,2016,1,121,321,185,0.911449454365898,45.5,18.8857142857143,64,1212.47322155729,-0.610895381218211
21814,525049.136,5327980.412,118,94,24,25.564,0,2017,1,123,315,178,0.869438989094659,-10.8,19.7879120879121,55,1212.47322155729,-0.610895381218211
21814,525049.136,5327980.412,0,0,0,36.816,0,2018,0,109,307,176,0.884289952214831,-154,20.578021978022,67,1212.47322155729,-0.610895381218211
21814,525049.136,5327980.412,151,93,58,27.244,4,2019,1,123,329,177,0.876991670308986,-79.8,20.6626373626374,54,1212.47322155729,-0.610895381218211
21814,525049.136,5327980.412,0,0,0,28.381,0,2020,0,108,306,201,0.79608018179475,-19.2,19.0648351648352,93,1212.47322155729,-0.610895381218211
21931,525280.792,5351609.36,0,0,0,145.208,0,2001,2,21,305,193,0.870336236765568,4.09999999999999,18.2296703296703,172,1186.84951422482,0.656990505108652
21931,525280.792,5351609.36,112,82,30,46,1,2002,3,102,327,209,0.85341700088549,18.8,18.3868131868132,107,1186.84951422482,0.656990505108652
21931,525280.792,5351609.36,162,93,69,32.701,0,2003,1,113,337,169,0.891989902844623,-204,23.121978021978,56,1186.84951422482,0.656990505108652
21931,525280.792,5351609.36,149,94,55,33.568,0,2004,2,115,321,225,0.847537349496627,123.8,17.9692307692308,110,1186.84951422482,0.656990505108652
21931,525280.792,5351609.36,156,93,63,44.09,0,2005,3,109,311,184,0.870056736491775,-31.4,18.0615384615385,75,1186.84951422482,0.656990505108652
21931,525280.792,5351609.36,182,65,117,25.95,0,2006,3,127,346,217,0.837175304373637,43,19.0516483516484,90,1186.84951422482,0.656990505108652
21931,525280.792,5351609.36,0,0,0,41.437,0,2007,0,100,300,224,0.840301782167571,258.5,17.3142857142857,124,1186.84951422482,0.656990505108652
21931,525280.792,5351609.36,0,0,0,33.14,0,2008,0,114,307,224,0.92238311102723,29.3,17.7417582417582,110,1186.84951422482,0.656990505108652
21931,525280.792,5351609.36,175,68,107,36.142,0,2009,3,109,284,216,0.865629433424996,27.1,18.689010989011,107,1186.84951422482,0.656990505108652
21931,525280.792,5351609.36,163,69,94,32.311,0,2010,3,115,306,193,0.854964723581223,87.4,18.4241758241758,78,1186.84951422482,0.656990505108652
21931,525280.792,5351609.36,135,60,75,35.021,0,2011,4,98,321,185,0.840629405636656,129,17.5824175824176,87,1186.84951422482,0.656990505108652
21931,525280.792,5351609.36,154,94,60,26.695,0,2012,1,126,320,177,0.837582162152177,29,18.7703296703297,51,1186.84951422482,0.656990505108652
21931,525280.792,5351609.36,181,94,87,23.7,0,2013,2,130,308,208,0.873129674716611,-172.4,19.2857142857143,78,1186.84951422482,0.656990505108652
21931,525280.792,5351609.36,86,58,28,66.244,7,2014,1,69,344,201,0.856370133970605,91.5,17.9450549450549,132,1186.84951422482,0.656990505108652
21931,525280.792,5351609.36,168,93,75,33.002,0,2015,2,117,335,209,0.852711299822034,-197.8,21,92,1186.84951422482,0.656990505108652
21931,525280.792,5351609.36,170,94,76,44.531,5,2016,1,110,344,176,0.821208984209707,-13,19.132967032967,66,1186.84951422482,0.656990505108652
21931,525280.792,5351609.36,138,94,44,43.242,6,2017,2,99,315,186,0.854182624517241,-57.8,20.1032967032967,87,1186.84951422482,0.656990505108652
21931,525280.792,5351609.36,153,98,55,47.414,0,2018,2,99,308,192,0.852581964811448,-125.4,20.7956043956044,93,1186.84951422482,0.656990505108652
21931,525280.792,5351609.36,147,78,69,32.979,3,2019,3,116,313,193,0.840309504203923,-108.1,20.8824175824176,77,1186.84951422482,0.656990505108652
21931,525280.792,5351609.36,0,0,0,67.535,0,2020,0,67,336,224,0.815154247212972,-97.4,19.156043956044,157,1186.84951422482,0.656990505108652
21932,525280.792,5351377.704,0,0,0,145.208,0,2001,2,21,307,193,0.880121016500788,4.09999999999999,18.2296703296703,172,1187.78138271912,1.29184238394667
21932,525280.792,5351377.704,111,85,26,52.327,4,2002,3,95,327,192,0.847210755164053,18.8,18.3868131868132,97,1187.78138271912,1.29184238394667
21932,525280.792,5351377.704,172,93,79,26.84,0,2003,2,120,339,185,0.864481994410391,-204,23.121978021978,65,1187.78138271912,1.29184238394667
21932,525280.792,5351377.704,149,94,55,34.495,0,2004,2,114,299,202,0.850510212924077,123.8,17.9692307692308,88,1187.78138271912,1.29184238394667
21932,525280.792,5351377.704,149,93,56,53.89,1,2005,3,100,310,184,0.884890856876402,-31.4,18.0615384615385,84,1187.78138271912,1.29184238394667
21932,525280.792,5351377.704,185,64,121,24.15,0,2006,3,129,346,193,0.84165951385545,43,19.0516483516484,64,1187.78138271912,1.29184238394667
21932,525280.792,5351377.704,0,0,0,66.762,0,2007,0,75,300,216,0.863662651888602,258.5,17.3142857142857,141,1187.78138271912,1.29184238394667
21932,525280.792,5351377.704,0,0,0,20.783,0,2008,0,126,309,177,0.864690354838117,29.3,17.7417582417582,51,1187.78138271912,1.29184238394667
21932,525280.792,5351377.704,176,70,106,29.685,0,2009,3,116,283,193,0.877238313010293,27.1,18.689010989011,77,1187.78138271912,1.29184238394667
21932,525280.792,5351377.704,170,69,101,28.924,0,2010,3,119,303,186,0.861497750406113,87.4,18.4241758241758,67,1187.78138271912,1.29184238394667
21932,525280.792,5351377.704,139,57,82,34.174,0,2011,4,99,321,185,0.845425886480259,129,17.5824175824176,86,1187.78138271912,1.29184238394667
21932,525280.792,5351377.704,155,93,62,29.839,0,2012,1,123,320,177,0.860134530164995,29,18.7703296703297,54,1187.78138271912,1.29184238394667
21932,525280.792,5351377.704,189,93,96,16.849,0,2013,2,137,308,209,0.87898465229243,-172.4,19.2857142857143,72,1187.78138271912,1.29184238394667
21932,525280.792,5351377.704,86,59,27,43.911,3,2014,1,95,347,209,0.865228099068476,91.5,17.9450549450549,114,1187.78138271912,1.29184238394667
21932,525280.792,5351377.704,164,95,69,40.364,0,2015,2,108,334,218,0.851972569407694,-197.8,21,110,1187.78138271912,1.29184238394667
21932,525280.792,5351377.704,165,95,70,48.062,5,2016,2,107,346,256,0.826412461157848,-13,19.132967032967,149,1187.78138271912,1.29184238394667
21932,525280.792,5351377.704,134,93,41,47.442,6,2017,2,94,316,209,0.858945308611664,-57.8,20.1032967032967,115,1187.78138271912,1.29184238394667
21932,525280.792,5351377.704,164,98,66,38.612,0,2018,2,107,322,193,0.863249096863651,-125.4,20.7956043956044,86,1187.78138271912,1.29184238394667
21932,525280.792,5351377.704,149,81,68,32.979,3,2019,3,116,313,208,0.832104284405232,-108.1,20.8824175824176,92,1187.78138271912,1.29184238394667
21932,525280.792,5351377.704,0,0,0,66.265,0,2020,0,68,316,208,0.780391043254308,-97.4,19.156043956044,140,1187.78138271912,1.29184238394667
21933,525280.792,5351146.048,0,0,0,141.062,0,2001,2,25,311,186,0.885305655096291,4.09999999999999,18.2296703296703,161,1202.56664356714,-0.98972801983001
21933,525280.792,5351146.048,0,0,0,39.757,0,2002,0,109,317,201,0.862009719492258,18.8,18.3868131868132,92,1202.56664356714,-0.98972801983001
21933,525280.792,5351146.048,166,96,70,25.972,0,2003,2,121,329,185,0.874567384224983,-204,23.121978021978,64,1202.56664356714,-0.98972801983001
21933,525280.792,5351146.048,165,93,72,25.762,0,2004,2,124,298,194,0.857122466655765,123.8,17.9692307692308,70,1202.56664356714,-0.98972801983001
21933,525280.792,5351146.048,142,113,29,69.68,2,2005,1,86,313,185,0.881205747826531,-31.4,18.0615384615385,99,1202.56664356714,-0.98972801983001
21933,525280.792,5351146.048,183,71,112,21.12,0,2006,3,132,346,185,0.826729037316405,43,19.0516483516484,53,1202.56664356714,-0.98972801983001
21933,525280.792,5351146.048,0,0,0,42.333,0,2007,0,99,291,208,0.869069905073978,258.5,17.3142857142857,109,1202.56664356714,-0.98972801983001
21933,525280.792,5351146.048,103,93,10,23.58,0,2008,1,123,308,177,0.889511737678531,29.3,17.7417582417582,54,1202.56664356714,-0.98972801983001
21933,525280.792,5351146.048,179,73,106,20.622,0,2009,3,127,295,192,0.881686779363192,27.1,18.689010989011,65,1202.56664356714,-0.98972801983001
21933,525280.792,5351146.048,165,79,86,31.436,0,2010,3,116,301,186,0.877668109329851,87.4,18.4241758241758,70,1202.56664356714,-0.98972801983001
21933,525280.792,5351146.048,146,66,80,32.539,0,2011,3,101,319,177,0.856367888881886,129,17.5824175824176,76,1202.56664356714,-0.98972801983001
21933,525280.792,5351146.048,167,83,84,30.864,0,2012,3,122,323,210,0.873681698906794,29,18.7703296703297,88,1202.56664356714,-0.98972801983001
21933,525280.792,5351146.048,186,93,93,22.706,0,2013,2,131,304,209,0.879749170282436,-172.4,19.2857142857143,78,1202.56664356714,-0.98972801983001
21933,525280.792,5351146.048,0,0,0,31.03,0,2014,0,114,317,217,0.893494699528924,91.5,17.9450549450549,103,1202.56664356714,-0.98972801983001
21933,525280.792,5351146.048,169,93,76,36.914,0,2015,2,112,310,186,0.8911442632175,-197.8,21,74,1202.56664356714,-0.98972801983001
21933,525280.792,5351146.048,165,93,72,14.889,0,2016,2,139,346,234,0.835588305526244,-13,19.132967032967,95,1202.56664356714,-0.98972801983001
21933,525280.792,5351146.048,134,93,41,38.712,6,2017,2,105,299,186,0.870552902294446,-57.8,20.1032967032967,81,1202.56664356714,-0.98972801983001
21933,525280.792,5351146.048,171,70,101,38.612,0,2018,3,107,306,193,0.867191202158392,-125.4,20.7956043956044,86,1202.56664356714,-0.98972801983001
21933,525280.792,5351146.048,153,85,68,31.206,3,2019,3,118,300,194,0.861734577071553,-108.1,20.8824175824176,76,1202.56664356714,-0.98972801983001
21933,525280.792,5351146.048,0,0,0,32.456,0,2020,0,103,308,226,0.806931118426613,-97.4,19.156043956044,123,1202.56664356714,-0.98972801983001
21935,525280.792,5350682.735,0,0,0,132.128,0,2001,2,33,302,194,0.859820492213828,4.09999999999999,18.2296703296703,161,1254.28719398776,0.45270797248098
21935,525280.792,5350682.735,86,75,11,32.84,0,2002,1,117,318,201,0.849733041579903,18.8,18.3868131868132,84,1254.28719398776,0.45270797248098
21935,525280.792,5350682.735,173,70,103,25.096,0,2003,3,122,337,202,0.819082550728119,-204,23.121978021978,80,1254.28719398776,0.45270797248098
21935,525280.792,5350682.735,177,93,84,22.298,0,2004,2,128,301,192,0.780710225981571,123.8,17.9692307692308,64,1254.28719398776,0.45270797248098
21935,525280.792,5350682.735,158,93,65,27.58,0,2005,2,125,311,194,0.830565438398917,-31.4,18.0615384615385,69,1254.28719398776,0.45270797248098
21935,525280.792,5350682.735,197,69,128,15.452,0,2006,3,138,340,186,0.804083590625589,43,19.0516483516484,48,1254.28719398776,0.45270797248098
21935,525280.792,5350682.735,175,93,82,30.869,0,2007,3,114,299,194,0.860620614922375,258.5,17.3142857142857,80,1254.28719398776,0.45270797248098
21935,525280.792,5350682.735,86,64,22,26.553,0,2008,1,120,304,184,0.825034516621663,29.3,17.7417582417582,64,1254.28719398776,0.45270797248098
21935,525280.792,5350682.735,183,54,129,37.162,0,2009,3,108,306,201,0.851089648983166,27.1,18.689010989011,93,1254.28719398776,0.45270797248098
21935,525280.792,5350682.735,176,75,101,21.83,0,2010,3,128,296,202,0.829032701027481,87.4,18.4241758241758,74,1254.28719398776,0.45270797248098
21935,525280.792,5350682.735,152,53,99,25.722,0,2011,2,110,318,208,0.817470120509787,129,17.5824175824176,98,1254.28719398776,0.45270797248098
21935,525280.792,5350682.735,165,93,72,27.718,0,2012,2,125,318,193,0.853013237926415,29,18.7703296703297,68,1254.28719398776,0.45270797248098
21935,525280.792,5350682.735,187,71,116,4.342,0,2013,3,149,303,217,0.866579640865342,-172.4,19.2857142857143,68,1254.28719398776,0.45270797248098
21935,525280.792,5350682.735,86,47,39,32.281,0,2014,1,112,344,240,0.811204261316992,91.5,17.9450549450549,128,1254.28719398776,0.45270797248098
21935,525280.792,5350682.735,174,101,73,30.467,0,2015,2,120,318,201,0.874580385348168,-197.8,21,81,1254.28719398776,0.45270797248098
21935,525280.792,5350682.735,182,100,82,2.1,0,2016,2,154,345,201,0.830979618982719,-13,19.132967032967,47,1254.28719398776,0.45270797248098
21935,525280.792,5350682.735,154,98,56,30.642,2,2017,2,116,294,210,0.867357006277511,-57.8,20.1032967032967,94,1254.28719398776,0.45270797248098
21935,525280.792,5350682.735,176,51,125,25.251,0,2018,3,122,302,194,0.860113611886411,-125.4,20.7956043956044,72,1254.28719398776,0.45270797248098
21935,525280.792,5350682.735,174,72,102,30.298,3,2019,3,119,305,209,0.867658785842839,-108.1,20.8824175824176,90,1254.28719398776,0.45270797248098
21935,525280.792,5350682.735,86,59,27,26.656,1,2020,1,112,319,218,0.834964119078189,-97.4,19.156043956044,106,1254.28719398776,0.45270797248098
21936,525280.792,5350451.079,0,0,0,124.067,0,2001,3,40,307,209,0.811053965643261,4.09999999999999,18.2296703296703,169,1262.59358809301,1.42998467497133
21936,525280.792,5350451.079,86,74,12,24.24,0,2002,1,126,318,209,0.827680835644113,18.8,18.3868131868132,83,1262.59358809301,1.42998467497133
21936,525280.792,5350451.079,173,70,103,25.972,0,2003,3,121,328,217,0.806275530808958,-204,23.121978021978,96,1262.59358809301,1.42998467497133
21936,525280.792,5350451.079,181,93,88,8.343,0,2004,2,143,301,224,0.814902130765891,123.8,17.9692307692308,81,1262.59358809301,1.42998467497133
21936,525280.792,5350451.079,159,93,66,25.574,0,2005,2,127,312,202,0.814991412921119,-31.4,18.0615384615385,75,1262.59358809301,1.42998467497133
21936,525280.792,5350451.079,196,69,127,15.452,0,2006,3,138,340,232,0.794364614461749,43,19.0516483516484,94,1262.59358809301,1.42998467497133
21936,525280.792,5350451.079,176,93,83,30.869,0,2007,3,114,301,194,0.84653591567287,258.5,17.3142857142857,80,1262.59358809301,1.42998467497133
21936,525280.792,5350451.079,86,64,22,23.58,0,2008,1,123,298,184,0.805817633600319,29.3,17.7417582417582,61,1262.59358809301,1.42998467497133
21936,525280.792,5350451.079,194,52,142,14.967,0,2009,4,134,299,200,0.827591453982196,27.1,18.689010989011,66,1262.59358809301,1.42998467497133
21936,525280.792,5350451.079,173,74,99,22.656,0,2010,3,127,292,202,0.796361937346872,87.4,18.4241758241758,75,1262.59358809301,1.42998467497133
21936,525280.792,5350451.079,152,52,100,23.052,0,2011,5,114,320,218,0.785672580767538,129,17.5824175824176,104,1262.59358809301,1.42998467497133
21936,525280.792,5350451.079,163,94,69,28.765,0,2012,2,124,316,194,0.838695603688021,29,18.7703296703297,70,1262.59358809301,1.42998467497133
21936,525280.792,5350451.079,186,71,115,8.547,0,2013,3,145,303,217,0.842385564759543,-172.4,19.2857142857143,72,1262.59358809301,1.42998467497133
21936,525280.792,5350451.079,86,47,39,27.912,0,2014,1,119,337,226,0.806754066021413,91.5,17.9450549450549,107,1262.59358809301,1.42998467497133
21936,525280.792,5350451.079,174,102,72,27.397,0,2015,2,123,322,194,0.845917210957906,-197.8,21,71,1262.59358809301,1.42998467497133
21936,525280.792,5350451.079,182,117,65,9.003,0,2016,2,145,342,258,0.784648181761884,-13,19.132967032967,113,1262.59358809301,1.42998467497133
21936,525280.792,5350451.079,151,99,52,29.117,0,2017,2,118,301,209,0.841100481376261,-57.8,20.1032967032967,91,1262.59358809301,1.42998467497133
21936,525280.792,5350451.079,171,55,116,27.72,0,2018,3,119,299,201,0.844261337849839,-125.4,20.7956043956044,82,1262.59358809301,1.42998467497133
21936,525280.792,5350451.079,177,71,106,24.122,1,2019,3,126,302,217,0.846101755429274,-108.1,20.8824175824176,91,1262.59358809301,1.42998467497133
21936,525280.792,5350451.079,86,54,32,24.951,1,2020,1,115,323,217,0.824686412036964,-97.4,19.156043956044,102,1262.59358809301,1.42998467497133
21937,525280.792,5350219.422,93,93,0,31.707,0,2001,4,119,300,200,0.838910699565954,-10.6,19.1659340659341,81,1273.07782495812,0.267136257133158
21937,525280.792,5350219.422,86,84,2,11.501,0,2002,1,139,315,201,0.831090331751112,6.29999999999999,19.1637362637363,62,1273.07782495812,0.267136257133158
21937,525280.792,5350219.422,180,113,67,23.526,0,2003,2,123,289,217,0.805450849943025,-207.1,23.9516483516484,94,1273.07782495812,0.267136257133158
21937,525280.792,5350219.422,180,29,151,10.61,0,2004,3,140,334,217,0.838739068126568,109,18.7549450549451,77,1273.07782495812,0.267136257133158
21937,525280.792,5350219.422,174,128,46,29.304,0,2005,1,123,312,210,0.804305336723441,-46.2,18.9098901098901,87,1273.07782495812,0.267136257133158
21937,525280.792,5350219.422,195,94,101,16.914,0,2006,2,136,332,241,0.778123080137165,29.4,19.8868131868132,105,1273.07782495812,0.267136257133158
21937,525280.792,5350219.422,0,0,0,29.007,0,2007,0,116,287,192,0.84031765327333,236.4,18.0659340659341,76,1273.07782495812,0.267136257133158
21937,525280.792,5350219.422,130,53,77,17.951,0,2008,3,129,289,208,0.81824246258315,13.4,18.4934065934066,79,1273.07782495812,0.267136257133158
21937,525280.792,5350219.422,193,97,96,14.802,0,2009,2,133,299,201,0.838678542225573,14,19.4461538461538,68,1273.07782495812,0.267136257133158
21937,525280.792,5350219.422,174,102,72,20.565,0,2010,2,128,297,202,0.799508892448696,69.3,19.1879120879121,74,1273.07782495812,0.267136257133158
21937,525280.792,5350219.422,154,55,99,19.052,0,2011,5,118,317,233,0.772206241857172,108.7,18.4846153846154,115,1273.07782495812,0.267136257133158
21937,525280.792,5350219.422,183,81,102,22.299,0,2012,3,130,310,194,0.841325786674061,6.9,19.8923076923077,64,1273.07782495812,0.267136257133158
21937,525280.792,5350219.422,185,101,84,6.324,0,2013,2,147,302,217,0.837021600013898,-187.7,20.2681318681319,70,1273.07782495812,0.267136257133158
21937,525280.792,5350219.422,148,47,101,26.786,0,2014,3,119,321,209,0.871408953056221,71,18.9736263736264,90,1273.07782495812,0.267136257133158
21937,525280.792,5350219.422,179,136,43,20.159,0,2015,1,129,330,208,0.838349131345269,-210.3,22.0318681318681,79,1273.07782495812,0.267136257133158
21937,525280.792,5350219.422,183,151,32,5.943,0,2016,1,148,340,209,0.84938989824292,-28.3,20.1868131868132,61,1273.07782495812,0.267136257133158
21937,525280.792,5350219.422,150,94,56,27.363,0,2017,2,119,298,233,0.795356782134444,-67,20.9692307692308,114,1273.07782495812,0.267136257133158
21937,525280.792,5350219.422,181,55,126,28.274,0,2018,3,117,297,193,0.844484333649292,-134,21.621978021978,76,1273.07782495812,0.267136257133158
21937,525280.792,5350219.422,173,52,121,22.028,0,2019,3,128,300,209,0.826190943617027,-110.8,21.721978021978,81,1273.07782495812,0.267136257133158
21937,525280.792,5350219.422,86,66,20,19.577,0,2020,1,123,313,217,0.820516935280174,-108.6,20.0032967032967,94,1273.07782495812,0.267136257133158
21938,525280.792,5349987.766,93,93,0,23.442,0,2001,4,127,279,202,0.840567210246224,-10.6,19.1659340659341,75,1283.05015357635,1.39379859920748
21938,525280.792,5349987.766,51,51,0,16.005,0,2002,1,134,316,194,0.840503822236778,6.29999999999999,19.1637362637363,60,1283.05015357635,1.39379859920748
21938,525280.792,5349987.766,177,93,84,26.819,0,2003,2,119,289,216,0.807129502618718,-207.1,23.9516483516484,97,1283.05015357635,1.39379859920748
21938,525280.792,5349987.766,187,28,159,9.792,0,2004,3,141,335,225,0.82824329248144,109,18.7549450549451,84,1283.05015357635,1.39379859920748
21938,525280.792,5349987.766,174,126,48,25.385,0,2005,1,127,314,194,0.804695887763025,-46.2,18.9098901098901,67,1283.05015357635,1.39379859920748
21938,525280.792,5349987.766,194,94,100,19.617,0,2006,2,133,333,248,0.764601892403314,29.4,19.8868131868132,115,1283.05015357635,1.39379859920748
21938,525280.792,5349987.766,0,0,0,29.007,0,2007,0,116,296,186,0.841187379700067,236.4,18.0659340659341,70,1283.05015357635,1.39379859920748
21938,525280.792,5349987.766,130,55,75,17.951,0,2008,3,129,289,210,0.826959772332323,13.4,18.4934065934066,81,1283.05015357635,1.39379859920748
21938,525280.792,5349987.766,193,93,100,14.802,0,2009,2,133,297,201,0.838551970497734,14,19.4461538461538,68,1283.05015357635,1.39379859920748
21938,525280.792,5349987.766,174,84,90,20.565,0,2010,3,128,287,194,0.80615277217155,69.3,19.1879120879121,66,1283.05015357635,1.39379859920748
21938,525280.792,5349987.766,156,53,103,20.245,0,2011,3,116,320,225,0.780222203198556,108.7,18.4846153846154,109,1283.05015357635,1.39379859920748
21938,525280.792,5349987.766,183,81,102,21.286,0,2012,3,131,312,193,0.840424330967175,6.9,19.8923076923077,62,1283.05015357635,1.39379859920748
21938,525280.792,5349987.766,187,133,54,15.597,0,2013,1,138,301,216,0.844567048496236,-187.7,20.2681318681319,78,1283.05015357635,1.39379859920748
21938,525280.792,5349987.766,148,47,101,26.156,0,2014,3,120,324,224,0.822396410368286,71,18.9736263736264,104,1283.05015357635,1.39379859920748
21938,525280.792,5349987.766,177,119,58,19.127,0,2015,2,130,321,209,0.830150555461732,-210.3,22.0318681318681,79,1283.05015357635,1.39379859920748
21938,525280.792,5349987.766,184,153,31,9.906,0,2016,1,144,339,209,0.835271089734318,-28.3,20.1868131868132,65,1283.05015357635,1.39379859920748
21938,525280.792,5349987.766,150,94,56,24.274,0,2017,1,123,298,178,0.782862260148039,-67,20.9692307692308,55,1283.05015357635,1.39379859920748
21938,525280.792,5349987.766,183,55,128,29.934,0,2018,2,115,296,169,0.867590550554086,-134,21.621978021978,54,1283.05015357635,1.39379859920748
21938,525280.792,5349987.766,177,52,125,20.159,0,2019,2,130,300,216,0.821433171309168,-110.8,21.721978021978,86,1283.05015357635,1.39379859920748
21938,525280.792,5349987.766,86,66,20,16.529,0,2020,1,128,313,217,0.813353070505271,-108.6,20.0032967032967,89,1283.05015357635,1.39379859920748
21939,525280.792,5349756.11,0,0,0,25.485,0,2001,3,125,302,208,0.816993449216843,-10.6,19.1659340659341,83,1279.68717759672,-1.28837475946718
21939,525280.792,5349756.11,156,66,90,16.974,0,2002,3,133,317,266,0.750748222742772,6.29999999999999,19.1637362637363,133,1279.68717759672,-1.28837475946718
21939,525280.792,5349756.11,176,120,56,22.708,0,2003,2,124,313,216,0.790364894269068,-207.1,23.9516483516484,92,1279.68717759672,-1.28837475946718
21939,525280.792,5349756.11,173,28,145,11.455,0,2004,3,139,334,217,0.809017538257418,109,18.7549450549451,78,1279.68717759672,-1.28837475946718
21939,525280.792,5349756.11,175,127,48,30.236,0,2005,1,122,309,209,0.800894433311536,-46.2,18.9098901098901,87,1279.68717759672,-1.28837475946718
21939,525280.792,5349756.11,195,60,135,23.372,0,2006,2,129,323,210,0.784483069297253,29.4,19.8868131868132,81,1279.68717759672,-1.28837475946718
21939,525280.792,5349756.11,93,93,0,32.813,0,2007,2,110,298,202,0.816694609867268,236.4,18.0659340659341,92,1279.68717759672,-1.28837475946718
21939,525280.792,5349756.11,130,55,75,18.773,0,2008,3,128,302,210,0.805294733677799,13.4,18.4934065934066,82,1279.68717759672,-1.28837475946718
21939,525280.792,5349756.11,192,65,127,14.037,0,2009,2,134,298,209,0.815555627177802,14,19.4461538461538,75,1279.68717759672,-1.28837475946718
21939,525280.792,5349756.11,171,75,96,16.547,0,2010,2,133,294,202,0.792209805354282,69.3,19.1879120879121,69,1279.68717759672,-1.28837475946718
21939,525280.792,5349756.11,152,98,54,25.323,0,2011,2,108,320,226,0.767184852109962,108.7,18.4846153846154,118,1279.68717759672,-1.28837475946718
21939,525280.792,5349756.11,163,82,81,32.481,0,2012,3,120,294,208,0.814601454757989,6.9,19.8923076923077,88,1279.68717759672,-1.28837475946718
21939,525280.792,5349756.11,186,131,55,10.535,0,2013,1,143,302,209,0.822809574770626,-187.7,20.2681318681319,66,1279.68717759672,-1.28837475946718
21939,525280.792,5349756.11,154,46,108,29.751,0,2014,3,114,312,217,0.826016128097647,71,18.9736263736264,103,1279.68717759672,-1.28837475946718
21939,525280.792,5349756.11,176,106,70,20.159,0,2015,2,129,331,208,0.804711967798173,-210.3,22.0318681318681,79,1279.68717759672,-1.28837475946718
21939,525280.792,5349756.11,173,123,50,26.044,0,2016,1,127,341,201,0.775993854456555,-28.3,20.1868131868132,74,1279.68717759672,-1.28837475946718
21939,525280.792,5349756.11,150,94,56,28.158,0,2017,2,118,296,224,0.782400074468693,-67,20.9692307692308,106,1279.68717759672,-1.28837475946718
21939,525280.792,5349756.11,180,78,102,25.077,0,2018,3,121,301,185,0.837671561531259,-134,21.621978021978,64,1279.68717759672,-1.28837475946718
21939,525280.792,5349756.11,173,102,71,21.132,0,2019,2,129,301,216,0.814241078424825,-110.8,21.721978021978,87,1279.68717759672,-1.28837475946718
21939,525280.792,5349756.11,84,48,36,22.782,0,2020,1,117,320,218,0.80246704457744,-108.6,20.0032967032967,101,1279.68717759672,-1.28837475946718
21940,525280.792,5349524.453,0,0,0,106.133,0,2001,3,55,301,201,0.823771533400388,-10.6,19.1659340659341,146,1284.72610095108,1.38192150537693
21940,525280.792,5349524.453,158,66,92,27.086,0,2002,3,123,319,274,0.755947401550019,6.29999999999999,19.1637362637363,151,1284.72610095108,1.38192150537693
21940,525280.792,5349524.453,175,117,58,27.604,0,2003,2,118,291,210,0.796989307718354,-207.1,23.9516483516484,92,1284.72610095108,1.38192150537693
21940,525280.792,5349524.453,171,25,146,27.828,0,2004,3,121,338,216,0.826321185920544,109,18.7549450549451,95,1284.72610095108,1.38192150537693
21940,525280.792,5349524.453,171,93,78,34.245,0,2005,2,118,313,202,0.816835112081422,-46.2,18.9098901098901,84,1284.72610095108,1.38192150537693
21940,525280.792,5349524.453,195,61,134,24.241,0,2006,2,128,325,193,0.808678972847673,29.4,19.8868131868132,65,1284.72610095108,1.38192150537693
21940,525280.792,5349524.453,93,93,0,32.813,0,2007,2,110,299,209,0.822826803012723,236.4,18.0659340659341,99,1284.72610095108,1.38192150537693
21940,525280.792,5349524.453,128,56,72,22.329,0,2008,3,124,297,192,0.811849635052348,13.4,18.4934065934066,68,1284.72610095108,1.38192150537693
21940,525280.792,5349524.453,192,64,128,14.802,0,2009,2,133,297,194,0.834821228708837,14,19.4461538461538,61,1284.72610095108,1.38192150537693
21940,525280.792,5349524.453,167,75,92,23.426,0,2010,3,124,296,193,0.793447229834676,69.3,19.1879120879121,69,1284.72610095108,1.38192150537693
21940,525280.792,5349524.453,154,100,54,25.323,0,2011,2,108,318,193,0.806542134019709,108.7,18.4846153846154,85,1284.72610095108,1.38192150537693
21940,525280.792,5349524.453,163,81,82,40.698,0,2012,3,112,294,201,0.815223102198099,6.9,19.8923076923077,89,1284.72610095108,1.38192150537693
21940,525280.792,5349524.453,185,125,60,16.591,0,2013,2,137,305,216,0.829840545695291,-187.7,20.2681318681319,79,1284.72610095108,1.38192150537693
21940,525280.792,5349524.453,153,47,106,38.515,0,2014,3,100,315,209,0.809075725434053,71,18.9736263736264,109,1284.72610095108,1.38192150537693
21940,525280.792,5349524.453,173,94,79,32.617,0,2015,2,117,337,186,0.832760254798589,-210.3,22.0318681318681,69,1284.72610095108,1.38192150537693
21940,525280.792,5349524.453,171,102,69,28.08,0,2016,1,125,342,185,0.816009125069097,-28.3,20.1868131868132,60,1284.72610095108,1.38192150537693
21940,525280.792,5349524.453,150,94,56,40.401,6,2017,1,101,297,178,0.778938667060125,-67,20.9692307692308,77,1284.72610095108,1.38192150537693
21940,525280.792,5349524.453,173,78,95,33.29,0,2018,3,111,306,186,0.847096616232516,-134,21.621978021978,75,1284.72610095108,1.38192150537693
21940,525280.792,5349524.453,170,100,70,34.973,2,2019,2,113,301,210,0.819937139955173,-110.8,21.721978021978,97,1284.72610095108,1.38192150537693
21940,525280.792,5349524.453,86,49,37,31.038,0,2020,1,103,324,209,0.818092510263327,-108.6,20.0032967032967,106,1284.72610095108,1.38192150537693
21941,525280.792,5349292.797,0,0,0,43.59,0,2001,2,108,319,185,0.836492293202872,-10.6,19.1659340659341,77,1243.00911371196,1.06108234690061
21941,525280.792,5349292.797,160,61,99,28.923,0,2002,2,121,312,184,0.80238828625819,6.29999999999999,19.1637362637363,63,1243.00911371196,1.06108234690061
21941,525280.792,5349292.797,172,93,79,29.188,0,2003,2,116,320,209,0.773525651475027,-207.1,23.9516483516484,93,1243.00911371196,1.06108234690061
21941,525280.792,5349292.797,173,103,70,28.665,0,2004,1,120,334,177,0.778463731866141,109,18.7549450549451,57,1243.00911371196,1.06108234690061
21941,525280.792,5349292.797,164,93,71,38.435,0,2005,2,114,312,185,0.820891507792269,-46.2,18.9098901098901,71,1243.00911371196,1.06108234690061
21941,525280.792,5349292.797,195,62,133,25.841,0,2006,4,126,339,193,0.817405645750549,29.4,19.8868131868132,67,1243.00911371196,1.06108234690061
21941,525280.792,5349292.797,132,93,39,36.428,0,2007,2,105,301,170,0.810306510275477,236.4,18.0659340659341,65,1243.00911371196,1.06108234690061
21941,525280.792,5349292.797,108,61,47,24.247,0,2008,3,122,308,194,0.797344144719494,13.4,18.4934065934066,72,1243.00911371196,1.06108234690061
21941,525280.792,5349292.797,188,66,122,23.74,0,2009,4,121,305,200,0.820654493634818,14,19.4461538461538,79,1243.00911371196,1.06108234690061
21941,525280.792,5349292.797,172,72,100,26.193,0,2010,3,120,307,185,0.79804240772418,69.3,19.1879120879121,65,1243.00911371196,1.06108234690061
21941,525280.792,5349292.797,150,69,81,33.503,0,2011,3,97,319,185,0.787749616719802,108.7,18.4846153846154,88,1243.00911371196,1.06108234690061
21941,525280.792,5349292.797,161,93,68,34.532,0,2012,2,118,296,201,0.813582548786149,6.9,19.8923076923077,83,1243.00911371196,1.06108234690061
21941,525280.792,5349292.797,184,39,145,21.368,0,2013,3,132,297,200,0.838969568834957,-187.7,20.2681318681319,68,1243.00911371196,1.06108234690061
21941,525280.792,5349292.797,153,46,107,38.515,0,2014,3,100,317,193,0.82152314091518,71,18.9736263736264,93,1243.00911371196,1.06108234690061
21941,525280.792,5349292.797,171,93,78,35.668,0,2015,2,113,330,193,0.827380369844249,-210.3,22.0318681318681,80,1243.00911371196,1.06108234690061
21941,525280.792,5349292.797,165,94,71,42.876,4,2016,2,111,339,192,0.81766796712981,-28.3,20.1868131868132,81,1243.00911371196,1.06108234690061
21941,525280.792,5349292.797,140,94,46,41.92,6,2017,1,99,299,177,0.808119099398467,-67,20.9692307692308,78,1243.00911371196,1.06108234690061
21941,525280.792,5349292.797,168,56,112,41.91,0,2018,2,102,314,162,0.840667066804013,-134,21.621978021978,60,1243.00911371196,1.06108234690061
21941,525280.792,5349292.797,149,94,55,34.161,2,2019,2,114,295,194,0.813051023296131,-110.8,21.721978021978,80,1243.00911371196,1.06108234690061
21941,525280.792,5349292.797,0,0,0,31.724,0,2020,0,102,315,193,0.792450805032082,-108.6,20.0032967032967,91,1243.00911371196,1.06108234690061
21943,525280.792,5348829.484,0,0,0,128.31,0,2001,2,35,303,185,0.799889449973363,-10.6,19.1659340659341,150,1091.81821104186,1.41849149111847
21943,525280.792,5348829.484,154,56,98,30.618,0,2002,2,119,301,177,0.792227682940569,6.29999999999999,19.1637362637363,58,1091.81821104186,1.41849149111847
21943,525280.792,5348829.484,163,93,70,33.911,0,2003,1,110,284,178,0.773569685325277,-207.1,23.9516483516484,68,1091.81821104186,1.41849149111847
21943,525280.792,5348829.484,165,26,139,32.058,0,2004,3,116,338,232,0.806163302951444,109,18.7549450549451,116,1091.81821104186,1.41849149111847
21943,525280.792,5348829.484,164,101,63,39.442,0,2005,1,113,311,168,0.793921895971543,-46.2,18.9098901098901,55,1091.81821104186,1.41849149111847
21943,525280.792,5348829.484,183,59,124,37.593,0,2006,2,113,326,162,0.786890788404593,29.4,19.8868131868132,49,1091.81821104186,1.41849149111847
21943,525280.792,5348829.484,93,93,0,63.741,8,2007,1,77,298,162,0.812436867040652,236.4,18.0659340659341,85,1091.81821104186,1.41849149111847
21943,525280.792,5348829.484,117,56,61,37.15,0,2008,2,110,310,162,0.797123494131623,13.4,18.4934065934066,52,1091.81821104186,1.41849149111847
21943,525280.792,5348829.484,174,65,109,39.949,0,2009,3,101,314,185,0.876017199390809,14,19.4461538461538,84,1091.81821104186,1.41849149111847
21943,525280.792,5348829.484,173,93,80,29.838,0,2010,1,115,312,177,0.783828896986603,69.3,19.1879120879121,62,1091.81821104186,1.41849149111847
21943,525280.792,5348829.484,147,96,51,38.535,0,2011,1,91,324,152,0.769669275546375,108.7,18.4846153846154,61,1091.81821104186,1.41849149111847
21943,525280.792,5348829.484,162,93,69,51.054,3,2012,2,99,322,218,0.787824418332038,6.9,19.8923076923077,119,1091.81821104186,1.41849149111847
21943,525280.792,5348829.484,182,82,100,20.394,0,2013,3,133,299,192,0.804273568811813,-187.7,20.2681318681319,59,1091.81821104186,1.41849149111847
21943,525280.792,5348829.484,148,46,102,49.925,1,2014,3,85,328,225,0.807719158992825,71,18.9736263736264,140,1091.81821104186,1.41849149111847
21943,525280.792,5348829.484,171,79,92,48.309,0,2015,2,99,330,162,0.800071779248537,-210.3,22.0318681318681,63,1091.81821104186,1.41849149111847
21943,525280.792,5348829.484,172,118,54,48.517,4,2016,1,106,337,184,0.778958141186322,-28.3,20.1868131868132,78,1091.81821104186,1.41849149111847
21943,525280.792,5348829.484,143,93,50,46.849,6,2017,1,93,305,169,0.804846274534112,-67,20.9692307692308,76,1091.81821104186,1.41849149111847
21943,525280.792,5348829.484,165,93,72,43.902,0,2018,1,100,320,154,0.841150371741492,-134,21.621978021978,54,1091.81821104186,1.41849149111847
21943,525280.792,5348829.484,160,94,66,45.906,6,2019,2,101,310,192,0.786803690778721,-110.8,21.721978021978,91,1091.81821104186,1.41849149111847
21943,525280.792,5348829.484,0,0,0,115.345,0,2020,0,24,322,170,0.761361539724276,-108.6,20.0032967032967,146,1091.81821104186,1.41849149111847
22084,525280.792,5316165.938,0,0,0,137.74,0,2001,0,28,334,154,0.839817174284135,-26.7,20.3989010989011,126,818.156520155054,-0.98443142073582
22084,525280.792,5316165.938,0,0,0,76.037,0,2002,0,72,333,160,0.828694061493269,-5.6,20.2901098901099,88,818.156520155054,-0.98443142073582
22084,525280.792,5316165.938,0,0,0,110.295,0,2003,0,31,332,152,0.794841426853416,-214.1,25.0835164835165,121,818.156520155054,-0.98443142073582
22084,525280.792,5316165.938,0,0,0,86.938,0,2004,0,60,339,168,0.79298614270116,90.8,19.910989010989,108,818.156520155054,-0.98443142073582
22084,525280.792,5316165.938,148,118,30,67.675,1,2005,1,86,324,154,0.842227588980122,-56.5,19.9923076923077,68,818.156520155054,-0.98443142073582
22084,525280.792,5316165.938,0,0,0,50.682,0,2006,0,101,349,266,0.821773575653319,16.2,20.9538461538462,165,818.156520155054,-0.98443142073582
22084,525280.792,5316165.938,0,0,0,110.569,0,2007,0,37,344,178,0.858691509504527,213,19.1032967032967,141,818.156520155054,-0.98443142073582
22084,525280.792,5316165.938,0,0,0,97.548,0,2008,0,56,314,169,0.853046362707208,-1.79999999999999,19.6,113,818.156520155054,-0.98443142073582
22084,525280.792,5316165.938,86,78,8,54.478,0,2009,1,87,319,177,0.876434847757614,-2.8,20.5450549450549,90,818.156520155054,-0.98443142073582
22084,525280.792,5316165.938,86,86,0,55.41,1,2010,1,89,313,170,0.84712900417487,50.5,20.2241758241758,81,818.156520155054,-0.98443142073582
22084,525280.792,5316165.938,0,0,0,103.106,0,2011,0,22,337,241,0.828992145256464,90.7,19.4164835164835,219,818.156520155054,-0.98443142073582
22084,525280.792,5316165.938,0,0,0,126.046,0,2012,0,22,317,162,0.85699278507451,-6,20.743956043956,140,818.156520155054,-0.98443142073582
22084,525280.792,5316165.938,152,81,71,53.514,0,2013,2,101,338,177,0.843131867315252,-200.2,21.3494505494505,76,818.156520155054,-0.98443142073582
22084,525280.792,5316165.938,0,0,0,106.835,0,2014,0,29,346,184,0.833744081930047,51.4,19.8307692307692,155,818.156520155054,-0.98443142073582
22084,525280.792,5316165.938,0,0,0,74.237,0,2015,0,73,342,160,0.851103458978466,-218.4,23.0318681318681,87,818.156520155054,-0.98443142073582
22084,525280.792,5316165.938,0,0,0,84.604,0,2016,0,70,340,162,0.867715294435908,-39.8,20.9813186813187,92,818.156520155054,-0.98443142073582
22084,525280.792,5316165.938,107,93,14,75.733,4,2017,1,66,321,154,0.814859534212471,-77.9,22.0516483516484,88,818.156520155054,-0.98443142073582
22084,525280.792,5316165.938,0,0,0,120.061,0,2018,0,30,327,152,0.839380937389477,-139.3,22.7065934065934,122,818.156520155054,-0.98443142073582
22084,525280.792,5316165.938,96,93,3,103.889,8,2019,1,46,336,161,0.797013409633497,-118.9,22.7472527472527,115,818.156520155054,-0.98443142073582
22084,525280.792,5316165.938,0,0,0,88.335,0,2020,0,48,324,184,0.820767090034575,-119,21.1252747252747,136,818.156520155054,-0.98443142073582
22150,525512.449,5351609.36,0,0,0,146.215,0,2001,3,20,306,192,0.86847238536664,4.09999999999999,18.2296703296703,172,1213.00301223962,1.28949178029057
22150,525512.449,5351609.36,86,74,12,25.325,0,2002,1,125,292,217,0.847994142755302,18.8,18.3868131868132,92,1213.00301223962,1.28949178029057
22150,525512.449,5351609.36,172,96,76,31.84,0,2003,2,114,331,185,0.851174081145253,-204,23.121978021978,71,1213.00301223962,1.28949178029057
22150,525512.449,5351609.36,162,99,63,19.416,0,2004,2,131,288,224,0.850962958649907,123.8,17.9692307692308,93,1213.00301223962,1.28949178029057
22150,525512.449,5351609.36,164,99,65,36.671,0,2005,2,116,314,193,0.838782281941503,-31.4,18.0615384615385,77,1213.00301223962,1.28949178029057
22150,525512.449,5351609.36,186,94,92,29.579,0,2006,2,123,339,209,0.82974374751134,43,19.0516483516484,86,1213.00301223962,1.28949178029057
22150,525512.449,5351609.36,93,93,0,47.094,0,2007,2,94,302,217,0.838684844012287,258.5,17.3142857142857,123,1213.00301223962,1.28949178029057
22150,525512.449,5351609.36,93,93,0,21.693,0,2008,2,125,278,217,0.861935412087567,29.3,17.7417582417582,92,1213.00301223962,1.28949178029057
22150,525512.449,5351609.36,184,56,128,20.622,0,2009,3,127,288,217,0.860631838633224,27.1,18.689010989011,90,1213.00301223962,1.28949178029057
22150,525512.449,5351609.36,171,101,70,30.577,0,2010,2,117,303,202,0.817528383059259,87.4,18.4241758241758,85,1213.00301223962,1.28949178029057
22150,525512.449,5351609.36,93,61,32,34.174,0,2011,3,99,321,184,0.83154138007833,129,17.5824175824176,85,1213.00301223962,1.28949178029057
22150,525512.449,5351609.36,158,93,65,38.315,0,2012,2,115,318,232,0.823338969838126,29,18.7703296703297,117,1213.00301223962,1.28949178029057
22150,525512.449,5351609.36,174,76,98,36.491,0,2013,3,118,301,209,0.871351880590128,-172.4,19.2857142857143,91,1213.00301223962,1.28949178029057
22150,525512.449,5351609.36,144,49,95,40.201,3,2014,3,100,345,209,0.84925432937405,91.5,17.9450549450549,109,1213.00301223962,1.28949178029057
22150,525512.449,5351609.36,169,94,75,36.106,0,2015,2,113,333,217,0.857473144368186,-197.8,21,104,1213.00301223962,1.28949178029057
22150,525512.449,5351609.36,169,100,69,37.021,3,2016,2,117,342,193,0.867444894211431,-13,19.132967032967,76,1213.00301223962,1.28949178029057
22150,525512.449,5351609.36,146,94,52,29.89,1,2017,2,117,313,194,0.857292595371941,-57.8,20.1032967032967,77,1213.00301223962,1.28949178029057
22150,525512.449,5351609.36,172,94,78,31.155,0,2018,2,115,318,185,0.849627178422714,-125.4,20.7956043956044,70,1213.00301223962,1.28949178029057
22150,525512.449,5351609.36,162,93,69,28.5,3,2019,2,121,299,194,0.825670926024915,-108.1,20.8824175824176,73,1213.00301223962,1.28949178029057
22150,525512.449,5351609.36,86,83,3,21.757,1,2020,1,121,316,233,0.813640525272811,-97.4,19.156043956044,112,1213.00301223962,1.28949178029057
22151,525512.449,5351377.704,0,0,0,144.208,0,2001,3,22,297,193,0.866703446332129,4.09999999999999,18.2296703296703,171,1217.85656591851,0.118784362126463
22151,525512.449,5351377.704,86,74,12,19.154,0,2002,1,131,288,201,0.818808841439164,18.8,18.3868131868132,70,1217.85656591851,0.118784362126463
22151,525512.449,5351377.704,176,129,47,31.84,0,2003,1,114,331,184,0.850755553981615,-204,23.121978021978,70,1217.85656591851,0.118784362126463
22151,525512.449,5351377.704,163,99,64,21.418,0,2004,2,129,306,217,0.855930536518878,123.8,17.9692307692308,88,1217.85656591851,0.118784362126463
22151,525512.449,5351377.704,164,97,67,32.432,0,2005,2,120,314,192,0.850881756968416,-31.4,18.0615384615385,72,1217.85656591851,0.118784362126463
22151,525512.449,5351377.704,187,101,86,28.636,0,2006,2,124,331,201,0.839126419546797,43,19.0516483516484,77,1217.85656591851,0.118784362126463
22151,525512.449,5351377.704,93,93,0,34.966,0,2007,2,108,299,209,0.854981412301589,258.5,17.3142857142857,101,1217.85656591851,0.118784362126463
22151,525512.449,5351377.704,95,93,2,19.899,0,2008,2,127,278,193,0.824110025562633,29.3,17.7417582417582,66,1217.85656591851,0.118784362126463
22151,525512.449,5351377.704,187,55,132,23.928,0,2009,4,123,283,209,0.864626819361635,27.1,18.689010989011,86,1217.85656591851,0.118784362126463
22151,525512.449,5351377.704,170,94,76,28.136,0,2010,2,120,301,208,0.821285930156485,87.4,18.4241758241758,88,1217.85656591851,0.118784362126463
22151,525512.449,5351377.704,93,61,32,33.346,0,2011,3,100,321,185,0.843130703184366,129,17.5824175824176,85,1217.85656591851,0.118784362126463
22151,525512.449,5351377.704,158,93,65,38.315,0,2012,2,115,319,185,0.846373793805957,29,18.7703296703297,70,1217.85656591851,0.118784362126463
22151,525512.449,5351377.704,177,76,101,23.7,0,2013,3,130,299,208,0.874254126191815,-172.4,19.2857142857143,78,1217.85656591851,0.118784362126463
22151,525512.449,5351377.704,152,47,105,32.91,0,2014,3,111,347,225,0.836967715393194,91.5,17.9450549450549,114,1217.85656591851,0.118784362126463
22151,525512.449,5351377.704,169,94,75,33.002,0,2015,2,117,331,210,0.856893774801683,-197.8,21,93,1217.85656591851,0.118784362126463
22151,525512.449,5351377.704,169,94,75,40.148,5,2016,2,114,341,186,0.862913419763515,-13,19.132967032967,72,1217.85656591851,0.118784362126463
22151,525512.449,5351377.704,148,101,47,29.89,1,2017,2,117,312,194,0.851895971598503,-57.8,20.1032967032967,77,1217.85656591851,0.118784362126463
22151,525512.449,5351377.704,173,93,80,32.044,0,2018,2,114,306,200,0.853070978100026,-125.4,20.7956043956044,86,1217.85656591851,0.118784362126463
22151,525512.449,5351377.704,161,94,67,21.455,0,2019,2,129,291,241,0.774592261069562,-108.1,20.8824175824176,112,1217.85656591851,0.118784362126463
22151,525512.449,5351377.704,93,61,32,16.158,1,2020,3,130,297,232,0.781268907686524,-97.4,19.156043956044,102,1217.85656591851,0.118784362126463
22152,525512.449,5351146.048,126,94,32,59.184,8,2001,4,95,301,201,0.863007373797376,4.09999999999999,18.2296703296703,106,1235.26252585111,1.47599253330301
22152,525512.449,5351146.048,86,52,34,37.093,0,2002,1,112,307,201,0.829817608875626,18.8,18.3868131868132,89,1235.26252585111,1.47599253330301
22152,525512.449,5351146.048,170,103,67,25.972,0,2003,2,121,330,209,0.820829720263733,-204,23.121978021978,88,1235.26252585111,1.47599253330301
22152,525512.449,5351146.048,171,100,71,20.457,0,2004,2,130,299,200,0.847700873836272,123.8,17.9692307692308,70,1235.26252585111,1.47599253330301
22152,525512.449,5351146.048,161,98,63,34.522,0,2005,1,118,314,185,0.855504318728037,-31.4,18.0615384615385,67,1235.26252585111,1.47599253330301
22152,525512.449,5351146.048,193,65,128,34.723,0,2006,2,118,339,177,0.834518816691205,43,19.0516483516484,59,1235.26252585111,1.47599253330301
22152,525512.449,5351146.048,0,0,0,36.458,0,2007,0,106,299,185,0.864057951551094,258.5,17.3142857142857,79,1235.26252585111,1.47599253330301
22152,525512.449,5351146.048,120,65,55,24.556,0,2008,2,122,301,178,0.855649279675991,29.3,17.7417582417582,56,1235.26252585111,1.47599253330301
22152,525512.449,5351146.048,182,56,126,36.142,0,2009,3,109,285,217,0.854085539964482,27.1,18.689010989011,108,1235.26252585111,1.47599253330301
22152,525512.449,5351146.048,169,94,75,30.577,0,2010,2,117,299,186,0.859590567544231,87.4,18.4241758241758,69,1235.26252585111,1.47599253330301
22152,525512.449,5351146.048,151,64,87,26.428,0,2011,3,109,320,170,0.845464520548445,129,17.5824175824176,61,1235.26252585111,1.47599253330301
22152,525512.449,5351146.048,168,101,67,38.315,0,2012,2,115,319,202,0.856889215001423,29,18.7703296703297,87,1235.26252585111,1.47599253330301
22152,525512.449,5351146.048,185,84,101,24.695,0,2013,2,129,302,209,0.872197332566527,-172.4,19.2857142857143,80,1235.26252585111,1.47599253330301
22152,525512.449,5351146.048,128,47,81,34.802,1,2014,3,108,316,201,0.861916056869758,91.5,17.9450549450549,93,1235.26252585111,1.47599253330301
22152,525512.449,5351146.048,170,78,92,32.185,0,2015,3,118,311,194,0.879889818646078,-197.8,21,76,1235.26252585111,1.47599253330301
22152,525512.449,5351146.048,167,107,60,32.77,0,2016,1,121,340,185,0.846794848063826,-13,19.132967032967,64,1235.26252585111,1.47599253330301
22152,525512.449,5351146.048,149,96,53,30.642,2,2017,2,116,294,192,0.852410020721207,-57.8,20.1032967032967,76,1235.26252585111,1.47599253330301
22152,525512.449,5351146.048,169,45,124,34.695,0,2018,3,111,304,193,0.863573012941417,-125.4,20.7956043956044,82,1235.26252585111,1.47599253330301
22152,525512.449,5351146.048,161,85,76,21.455,0,2019,3,129,298,242,0.789319297456201,-108.1,20.8824175824176,113,1235.26252585111,1.47599253330301
22152,525512.449,5351146.048,0,0,0,18.61,0,2020,0,126,306,249,0.78079087002537,-97.4,19.156043956044,123,1235.26252585111,1.47599253330301
22153,525512.449,5350914.391,124,94,30,23.825,0,2001,4,127,299,194,0.868417339170856,4.09999999999999,18.2296703296703,67,1265.53300020096,1.4302960097034
22153,525512.449,5350914.391,86,53,33,36.223,0,2002,1,113,300,201,0.840423440673069,18.8,18.3868131868132,88,1265.53300020096,1.4302960097034
22153,525512.449,5350914.391,170,105,65,28.495,0,2003,2,118,336,209,0.832790121114541,-204,23.121978021978,91,1265.53300020096,1.4302960097034
22153,525512.449,5350914.391,169,105,64,19.416,0,2004,1,131,298,193,0.848823255358362,123.8,17.9692307692308,62,1265.53300020096,1.4302960097034
22153,525512.449,5350914.391,158,93,65,31.43,0,2005,1,121,312,177,0.857227324455028,-31.4,18.0615384615385,56,1265.53300020096,1.4302960097034
22153,525512.449,5350914.391,184,65,119,57.977,3,2006,2,99,333,176,0.813368753587741,43,19.0516483516484,77,1265.53300020096,1.4302960097034
22153,525512.449,5350914.391,0,0,0,30.869,0,2007,0,114,299,185,0.870511015173248,258.5,17.3142857142857,71,1265.53300020096,1.4302960097034
22153,525512.449,5350914.391,168,65,103,22.626,0,2008,4,124,297,216,0.886305727944901,29.3,17.7417582417582,92,1265.53300020096,1.4302960097034
22153,525512.449,5350914.391,188,58,130,18.227,0,2009,3,130,300,216,0.845571152693122,27.1,18.689010989011,86,1265.53300020096,1.4302960097034
22153,525512.449,5350914.391,170,94,76,28.136,0,2010,2,120,293,185,0.8555506323328,87.4,18.4241758241758,65,1265.53300020096,1.4302960097034
22153,525512.449,5350914.391,151,64,87,26.428,0,2011,3,109,319,178,0.83270969367109,129,17.5824175824176,69,1265.53300020096,1.4302960097034
22153,525512.449,5350914.391,173,93,80,24.624,0,2012,2,128,314,186,0.886969414526204,29,18.7703296703297,58,1265.53300020096,1.4302960097034
22153,525512.449,5350914.391,181,83,98,24.695,0,2013,3,129,302,209,0.867167272108658,-172.4,19.2857142857143,80,1265.53300020096,1.4302960097034
22153,525512.449,5350914.391,134,48,86,32.91,0,2014,3,111,314,192,0.836052870835328,91.5,17.9450549450549,81,1265.53300020096,1.4302960097034
22153,525512.449,5350914.391,170,78,92,30.467,0,2015,3,120,313,201,0.877953399566083,-197.8,21,81,1265.53300020096,1.4302960097034
22153,525512.449,5350914.391,169,106,63,27.405,0,2016,1,126,341,186,0.813664155769398,-13,19.132967032967,60,1265.53300020096,1.4302960097034
22153,525512.449,5350914.391,153,96,57,28.321,0,2017,2,119,292,209,0.866761345104403,-57.8,20.1032967032967,90,1265.53300020096,1.4302960097034
22153,525512.449,5350914.391,175,44,131,32.921,0,2018,3,113,299,194,0.864257225082848,-125.4,20.7956043956044,81,1265.53300020096,1.4302960097034
22153,525512.449,5350914.391,163,84,79,21.455,0,2019,3,129,298,186,0.835653715249756,-108.1,20.8824175824176,57,1265.53300020096,1.4302960097034
22153,525512.449,5350914.391,0,0,0,23.882,0,2020,0,117,324,224,0.834160094754507,-97.4,19.156043956044,107,1265.53300020096,1.4302960097034
22154,525512.449,5350682.735,0,0,0,19.86,0,2001,2,131,310,209,0.84632340158495,4.09999999999999,18.2296703296703,78,1283.8465566208,-0.757321329766716
22154,525512.449,5350682.735,153,93,60,22.136,0,2002,2,128,287,224,0.834358353349584,18.8,18.3868131868132,96,1283.8465566208,-0.757321329766716
22154,525512.449,5350682.735,177,73,104,24.234,0,2003,2,123,334,193,0.841144703292689,-204,23.121978021978,70,1283.8465566208,-0.757321329766716
22154,525512.449,5350682.735,185,97,88,16.35,0,2004,2,134,299,217,0.846315350665146,123.8,17.9692307692308,83,1283.8465566208,-0.757321329766716
22154,525512.449,5350682.735,168,96,72,25.574,0,2005,2,127,307,193,0.850807144015857,-31.4,18.0615384615385,66,1283.8465566208,-0.757321329766716
22154,525512.449,5350682.735,188,66,122,51.604,0,2006,3,104,330,249,0.772211509409089,43,19.0516483516484,145,1283.8465566208,-0.757321329766716
22154,525512.449,5350682.735,139,119,20,29.032,0,2007,2,117,298,209,0.857442344117416,258.5,17.3142857142857,92,1283.8465566208,-0.757321329766716
22154,525512.449,5350682.735,178,65,113,19.899,0,2008,3,127,294,224,0.845574204525112,29.3,17.7417582417582,97,1283.8465566208,-0.757321329766716
22154,525512.449,5350682.735,186,57,129,24.748,0,2009,3,122,294,192,0.85931410213763,27.1,18.689010989011,70,1283.8465566208,-0.757321329766716
22154,525512.449,5350682.735,172,58,114,21.83,0,2010,3,128,289,194,0.82804134190093,87.4,18.4241758241758,66,1283.8465566208,-0.757321329766716
22154,525512.449,5350682.735,163,50,113,20.447,0,2011,3,118,318,194,0.792454625215817,129,17.5824175824176,76,1283.8465566208,-0.757321329766716
22154,525512.449,5350682.735,169,81,88,31.895,0,2012,3,121,308,185,0.862794823871496,29,18.7703296703297,64,1283.8465566208,-0.757321329766716
22154,525512.449,5350682.735,187,62,125,1.126,0,2013,3,152,298,210,0.86646099389588,-172.4,19.2857142857143,58,1283.8465566208,-0.757321329766716
22154,525512.449,5350682.735,154,48,106,29.812,0,2014,3,116,321,234,0.784784640513049,91.5,17.9450549450549,118,1283.8465566208,-0.757321329766716
22154,525512.449,5350682.735,171,77,94,17.385,0,2015,3,132,313,208,0.84821563480666,-197.8,21,76,1283.8465566208,-0.757321329766716
22154,525512.449,5350682.735,177,94,83,7.985,0,2016,2,146,339,200,0.807039104809989,-13,19.132967032967,54,1283.8465566208,-0.757321329766716
22154,525512.449,5350682.735,150,94,56,24.302,0,2017,2,124,296,232,0.813510207798031,-57.8,20.1032967032967,108,1283.8465566208,-0.757321329766716
22154,525512.449,5350682.735,167,56,111,36.587,0,2018,3,109,299,194,0.853974885591627,-125.4,20.7956043956044,85,1283.8465566208,-0.757321329766716
22154,525512.449,5350682.735,171,95,76,18.418,0,2019,2,132,300,202,0.835093325498206,-108.1,20.8824175824176,70,1283.8465566208,-0.757321329766716
22154,525512.449,5350682.735,0,0,0,15.576,0,2020,0,131,314,225,0.82002824053816,-97.4,19.156043956044,94,1283.8465566208,-0.757321329766716
22155,525512.449,5350451.079,93,93,0,25.901,0,2001,4,125,313,202,0.826659193256045,4.09999999999999,18.2296703296703,77,1285.51692553615,0.80323520796396
22155,525512.449,5350451.079,151,94,57,22.136,0,2002,2,128,288,233,0.829896494496483,18.8,18.3868131868132,105,1285.51692553615,0.80323520796396
22155,525512.449,5350451.079,178,72,106,24.234,0,2003,2,123,329,193,0.8185822005748,-204,23.121978021978,70,1285.51692553615,0.80323520796396
22155,525512.449,5350451.079,182,123,59,13.46,0,2004,2,137,307,225,0.824392542388499,123.8,17.9692307692308,88,1285.51692553615,0.80323520796396
22155,525512.449,5350451.079,168,97,71,25.574,0,2005,2,127,312,202,0.823601744693471,-31.4,18.0615384615385,75,1285.51692553615,0.80323520796396
22155,525512.449,5350451.079,198,69,129,25.087,0,2006,2,128,333,240,0.778632655563846,43,19.0516483516484,112,1285.51692553615,0.80323520796396
22155,525512.449,5350451.079,93,93,0,34.966,0,2007,2,108,298,201,0.843656835703812,258.5,17.3142857142857,93,1285.51692553615,0.80323520796396
22155,525512.449,5350451.079,179,65,114,17.41,0,2008,3,130,293,225,0.852135290097503,29.3,17.7417582417582,95,1285.51692553615,0.80323520796396
22155,525512.449,5350451.079,186,56,130,25.549,0,2009,3,121,288,224,0.820129278956226,27.1,18.689010989011,103,1285.51692553615,0.80323520796396
22155,525512.449,5350451.079,171,56,115,25.018,0,2010,3,124,293,200,0.808062876576995,87.4,18.4241758241758,76,1285.51692553615,0.80323520796396
22155,525512.449,5350451.079,162,51,111,22.38,0,2011,3,115,320,200,0.7967201735454,129,17.5824175824176,85,1285.51692553615,0.80323520796396
22155,525512.449,5350451.079,169,81,88,32.902,0,2012,3,120,309,193,0.840537815433417,29,18.7703296703297,73,1285.51692553615,0.80323520796396
22155,525512.449,5350451.079,185,62,123,8.547,0,2013,3,145,301,217,0.846806743248618,-172.4,19.2857142857143,72,1285.51692553615,0.80323520796396
22155,525512.449,5350451.079,153,48,105,30.417,0,2014,3,115,320,224,0.792666445664966,91.5,17.9450549450549,109,1285.51692553615,0.80323520796396
22155,525512.449,5350451.079,171,77,94,21.464,0,2015,3,128,317,208,0.83674627428859,-197.8,21,80,1285.51692553615,0.80323520796396
22155,525512.449,5350451.079,178,108,70,19.776,0,2016,1,134,340,193,0.80016507171114,-13,19.132967032967,59,1285.51692553615,0.80323520796396
22155,525512.449,5350451.079,153,99,54,27.509,0,2017,1,120,300,185,0.790053138810336,-57.8,20.1032967032967,65,1285.51692553615,0.80323520796396
22155,525512.449,5350451.079,169,59,110,33.794,0,2018,3,112,301,200,0.835865798776808,-125.4,20.7956043956044,88,1285.51692553615,0.80323520796396
22155,525512.449,5350451.079,169,103,66,20.462,0,2019,2,130,302,209,0.827490345893592,-108.1,20.8824175824176,79,1285.51692553615,0.80323520796396
22155,525512.449,5350451.079,0,0,0,22.839,0,2020,0,119,317,218,0.811128935419415,-97.4,19.156043956044,99,1285.51692553615,0.80323520796396
22156,525512.449,5350219.422,93,93,0,31.707,0,2001,4,119,311,201,0.827497061413856,-10.6,19.1659340659341,82,1292.21185123332,-1.36964690360529
22156,525512.449,5350219.422,149,55,94,16.005,0,2002,3,134,287,201,0.889033603932779,6.29999999999999,19.1637362637363,67,1292.21185123332,-1.36964690360529
22156,525512.449,5350219.422,181,72,109,22.708,0,2003,2,124,332,193,0.825277484364629,-207.1,23.9516483516484,69,1292.21185123332,-1.36964690360529
22156,525512.449,5350219.422,179,99,80,17.066,0,2004,2,133,332,209,0.818713606872412,109,18.7549450549451,76,1292.21185123332,-1.36964690360529
22156,525512.449,5350219.422,165,93,72,28.354,0,2005,2,124,309,192,0.806012645577844,-46.2,18.9098901098901,68,1292.21185123332,-1.36964690360529
22156,525512.449,5350219.422,200,62,138,16.015,0,2006,4,137,322,192,0.796855904732133,29.4,19.8868131868132,55,1292.21185123332,-1.36964690360529
22156,525512.449,5350219.422,93,93,0,30.837,0,2007,2,113,292,194,0.833972225818705,236.4,18.0659340659341,81,1292.21185123332,-1.36964690360529
22156,525512.449,5350219.422,179,53,126,18.773,0,2008,3,128,300,218,0.830539820251355,13.4,18.4934065934066,90,1292.21185123332,-1.36964690360529
22156,525512.449,5350219.422,191,66,125,19.99,0,2009,2,126,282,226,0.82629579509471,14,19.4461538461538,100,1292.21185123332,-1.36964690360529
22156,525512.449,5350219.422,172,68,104,25.506,0,2010,3,121,289,201,0.815266216712621,69.3,19.1879120879121,80,1292.21185123332,-1.36964690360529
22156,525512.449,5350219.422,151,51,100,24.647,0,2011,3,109,319,225,0.780439766405496,108.7,18.4846153846154,116,1292.21185123332,-1.36964690360529
22156,525512.449,5350219.422,171,81,90,31.489,0,2012,3,121,315,200,0.836635415572519,6.9,19.8923076923077,79,1292.21185123332,-1.36964690360529
22156,525512.449,5350219.422,187,94,93,7.369,0,2013,2,146,300,216,0.841664927690778,-187.7,20.2681318681319,70,1292.21185123332,-1.36964690360529
22156,525512.449,5350219.422,158,43,115,24.098,0,2014,3,123,333,208,0.86575239534637,71,18.9736263736264,85,1292.21185123332,-1.36964690360529
22156,525512.449,5350219.422,178,93,85,24.634,0,2015,2,125,319,193,0.820842847007496,-210.3,22.0318681318681,68,1292.21185123332,-1.36964690360529
22156,525512.449,5350219.422,176,110,66,21.416,0,2016,2,132,339,208,0.815995399615097,-28.3,20.1868131868132,76,1292.21185123332,-1.36964690360529
22156,525512.449,5350219.422,169,95,74,24.274,0,2017,2,123,306,232,0.7983624513327,-67,20.9692307692308,109,1292.21185123332,-1.36964690360529
22156,525512.449,5350219.422,181,63,118,25.077,0,2018,3,121,302,193,0.85129486635063,-134,21.621978021978,72,1292.21185123332,-1.36964690360529
22156,525512.449,5350219.422,173,93,80,20.159,0,2019,2,130,301,209,0.835724489719765,-110.8,21.721978021978,79,1292.21185123332,-1.36964690360529
22156,525512.449,5350219.422,86,47,39,23.289,0,2020,1,116,319,216,0.820440562413903,-108.6,20.0032967032967,100,1292.21185123332,-1.36964690360529
22157,525512.449,5349987.766,93,93,0,41.352,3,2001,4,110,316,194,0.861183188332067,-10.6,19.1659340659341,84,1300.78305575622,1.00787683462545
22157,525512.449,5349987.766,150,57,93,22.905,0,2002,3,127,288,241,0.797819342190023,6.29999999999999,19.1637362637363,114,1300.78305575622,1.00787683462545
22157,525512.449,5349987.766,180,73,107,25.196,0,2003,2,121,331,193,0.830335613355616,-207.1,23.9516483516484,72,1300.78305575622,1.00787683462545
22157,525512.449,5349987.766,178,94,84,23.638,0,2004,2,126,335,216,0.826917665418233,109,18.7549450549451,90,1300.78305575622,1.00787683462545
22157,525512.449,5349987.766,165,93,72,29.304,0,2005,2,123,314,217,0.808462400605841,-46.2,18.9098901098901,94,1300.78305575622,1.00787683462545
22157,525512.449,5349987.766,194,65,129,18.715,0,2006,2,134,325,186,0.799741696727488,29.4,19.8868131868132,52,1300.78305575622,1.00787683462545
22157,525512.449,5349987.766,0,0,0,34.208,0,2007,0,108,292,209,0.8382878908037,236.4,18.0659340659341,101,1300.78305575622,1.00787683462545
22157,525512.449,5349987.766,179,54,125,22.329,0,2008,3,124,302,218,0.857648032457146,13.4,18.4934065934066,94,1300.78305575622,1.00787683462545
22157,525512.449,5349987.766,184,66,118,29.007,0,2009,3,114,283,216,0.83903407793901,14,19.4461538461538,102,1300.78305575622,1.00787683462545
22157,525512.449,5349987.766,171,68,103,27.596,0,2010,3,118,288,193,0.822767401874407,69.3,19.1879120879121,75,1300.78305575622,1.00787683462545
22157,525512.449,5349987.766,151,50,101,25.323,0,2011,2,108,321,176,0.782629796934902,108.7,18.4846153846154,68,1300.78305575622,1.00787683462545
22157,525512.449,5349987.766,170,81,89,32.481,0,2012,3,120,318,200,0.843427177067949,6.9,19.8923076923077,80,1300.78305575622,1.00787683462545
22157,525512.449,5349987.766,190,146,44,18.485,0,2013,1,135,305,210,0.851410233316106,-187.7,20.2681318681319,75,1300.78305575622,1.00787683462545
22157,525512.449,5349987.766,157,45,112,30.942,0,2014,3,112,338,209,0.80953958868106,71,18.9736263736264,97,1300.78305575622,1.00787683462545
22157,525512.449,5349987.766,182,148,34,25.866,0,2015,1,124,327,193,0.817515576391159,-210.3,22.0318681318681,69,1300.78305575622,1.00787683462545
22157,525512.449,5349987.766,178,117,61,20.507,0,2016,2,133,344,250,0.798693368730276,-28.3,20.1868131868132,117,1300.78305575622,1.00787683462545
22157,525512.449,5349987.766,168,96,72,25.041,0,2017,1,122,311,184,0.811245137484646,-67,20.9692307692308,62,1300.78305575622,1.00787683462545
22157,525512.449,5349987.766,181,64,117,18.612,0,2018,3,130,304,194,0.858635334888659,-134,21.621978021978,64,1300.78305575622,1.00787683462545
22157,525512.449,5349987.766,173,93,80,18.153,0,2019,2,132,300,200,0.838823545610304,-110.8,21.721978021978,68,1300.78305575622,1.00787683462545
22157,525512.449,5349987.766,85,47,38,25.443,0,2020,1,112,319,216,0.818146910150411,-108.6,20.0032967032967,104,1300.78305575622,1.00787683462545
22158,525512.449,5349756.11,0,0,0,28.505,0,2001,3,122,314,200,0.844620170425447,-10.6,19.1659340659341,78,1292.23177434714,1.01025628447107
22158,525512.449,5349756.11,152,53,99,12.369,0,2002,3,138,321,192,0.814782284989352,6.29999999999999,19.1637362637363,54,1292.23177434714,1.01025628447107
22158,525512.449,5349756.11,182,137,45,23.526,0,2003,1,123,323,185,0.835925137753526,-207.1,23.9516483516484,62,1292.23177434714,1.01025628447107
22158,525512.449,5349756.11,177,117,60,15.105,0,2004,1,135,338,192,0.801679874445258,109,18.7549450549451,57,1292.23177434714,1.01025628447107
22158,525512.449,5349756.11,176,93,83,23.256,0,2005,2,129,311,193,0.814487557591368,-46.2,18.9098901098901,64,1292.23177434714,1.01025628447107
22158,525512.449,5349756.11,193,64,129,25.841,0,2006,3,126,346,202,0.813619178549821,29.4,19.8868131868132,76,1292.23177434714,1.01025628447107
22158,525512.449,5349756.11,0,0,0,32.813,0,2007,0,110,301,200,0.831478158839443,236.4,18.0659340659341,90,1292.23177434714,1.01025628447107
22158,525512.449,5349756.11,113,57,56,18.773,0,2008,3,128,307,201,0.814103160353782,13.4,18.4934065934066,73,1292.23177434714,1.01025628447107
22158,525512.449,5349756.11,188,93,95,17.051,0,2009,2,130,298,224,0.81944826768113,14,19.4461538461538,94,1292.23177434714,1.01025628447107
22158,525512.449,5349756.11,174,63,111,21.311,0,2010,2,127,300,208,0.829305036186104,69.3,19.1879120879121,81,1292.23177434714,1.01025628447107
22158,525512.449,5349756.11,149,94,55,22.712,0,2011,2,112,321,226,0.782926166050643,108.7,18.4846153846154,114,1292.23177434714,1.01025628447107
22158,525512.449,5349756.11,168,81,87,24.313,0,2012,3,128,315,209,0.825713577091508,6.9,19.8923076923077,81,1292.23177434714,1.01025628447107
22158,525512.449,5349756.11,190,139,51,15.597,0,2013,1,138,303,216,0.842693287987782,-187.7,20.2681318681319,78,1292.23177434714,1.01025628447107
22158,525512.449,5349756.11,157,53,104,29.751,0,2014,3,114,335,265,0.776325888815661,71,18.9736263736264,151,1292.23177434714,1.01025628447107
22158,525512.449,5349756.11,173,93,80,23.45,0,2015,2,126,322,193,0.821975289237549,-210.3,22.0318681318681,67,1292.23177434714,1.01025628447107
22158,525512.449,5349756.11,170,100,70,21.416,0,2016,2,132,343,201,0.845411138341973,-28.3,20.1868131868132,69,1292.23177434714,1.01025628447107
22158,525512.449,5349756.11,148,94,54,36.827,6,2017,2,106,310,201,0.814239457036913,-67,20.9692307692308,95,1292.23177434714,1.01025628447107
22158,525512.449,5349756.11,183,61,122,17.227,0,2018,3,132,304,193,0.871163343321165,-134,21.621978021978,61,1292.23177434714,1.01025628447107
22158,525512.449,5349756.11,175,104,71,18.153,0,2019,2,132,302,210,0.826595841381927,-110.8,21.721978021978,78,1292.23177434714,1.01025628447107
22158,525512.449,5349756.11,0,0,0,22.281,0,2020,0,118,318,225,0.794923350503224,-108.6,20.0032967032967,107,1292.23177434714,1.01025628447107
22159,525512.449,5349524.453,0,0,0,66.102,0,2001,3,88,313,193,0.852011481720522,-10.6,19.1659340659341,105,1293.83637462998,-0.709170657082005
22159,525512.449,5349524.453,157,53,104,17.948,0,2002,3,132,319,272,0.772674574404134,6.29999999999999,19.1637362637363,140,1293.83637462998,-0.709170657082005
22159,525512.449,5349524.453,176,93,83,26.028,0,2003,2,120,330,185,0.83322333008168,-207.1,23.9516483516484,65,1293.83637462998,-0.709170657082005
22159,525512.449,5349524.453,175,120,55,21.92,0,2004,1,128,342,186,0.819147411907187,109,18.7549450549451,58,1293.83637462998,-0.709170657082005
22159,525512.449,5349524.453,176,93,83,24.325,0,2005,2,128,313,208,0.829641532920387,-46.2,18.9098901098901,80,1293.83637462998,-0.709170657082005
22159,525512.449,5349524.453,193,63,130,30.118,0,2006,2,121,345,186,0.8217035755287,29.4,19.8868131868132,65,1293.83637462998,-0.709170657082005
22159,525512.449,5349524.453,0,0,0,34.208,0,2007,0,108,299,186,0.833732283517626,236.4,18.0659340659341,78,1293.83637462998,-0.709170657082005
22159,525512.449,5349524.453,111,56,55,26.232,0,2008,3,120,306,193,0.827709926501308,13.4,18.4934065934066,73,1293.83637462998,-0.709170657082005
22159,525512.449,5349524.453,192,159,33,17.051,0,2009,1,130,291,217,0.821771817678668,14,19.4461538461538,87,1293.83637462998,-0.709170657082005
22159,525512.449,5349524.453,171,63,108,21.311,0,2010,3,127,306,193,0.827077176197843,69.3,19.1879120879121,66,1293.83637462998,-0.709170657082005
22159,525512.449,5349524.453,152,107,45,27.432,0,2011,1,105,322,177,0.792780900771843,108.7,18.4846153846154,72,1293.83637462998,-0.709170657082005
22159,525512.449,5349524.453,167,81,86,32.481,0,2012,3,120,316,208,0.825751526269505,6.9,19.8923076923077,88,1293.83637462998,-0.709170657082005
22159,525512.449,5349524.453,189,116,73,15.597,0,2013,2,138,303,210,0.847054943232963,-187.7,20.2681318681319,72,1293.83637462998,-0.709170657082005
22159,525512.449,5349524.453,155,53,102,33.955,0,2014,3,107,342,256,0.801587989509641,71,18.9736263736264,149,1293.83637462998,-0.709170657082005
22159,525512.449,5349524.453,172,93,79,30.127,0,2015,2,120,324,192,0.832410836761257,-210.3,22.0318681318681,72,1293.83637462998,-0.709170657082005
22159,525512.449,5349524.453,169,93,76,27.047,0,2016,2,126,345,209,0.835653766633116,-28.3,20.1868131868132,83,1293.83637462998,-0.709170657082005
22159,525512.449,5349524.453,147,94,53,41.92,6,2017,2,99,310,186,0.827368205757208,-67,20.9692307692308,87,1293.83637462998,-0.709170657082005
22159,525512.449,5349524.453,176,61,115,26.659,0,2018,3,119,309,192,0.898520395731112,-134,21.621978021978,73,1293.83637462998,-0.709170657082005
22159,525512.449,5349524.453,175,127,48,24.623,2,2019,1,125,302,202,0.840299786163818,-110.8,21.721978021978,77,1293.83637462998,-0.709170657082005
22159,525512.449,5349524.453,0,0,0,29.705,0,2020,0,105,324,217,0.809836849842532,-108.6,20.0032967032967,112,1293.83637462998,-0.709170657082005
22160,525512.449,5349292.797,0,0,0,38.068,0,2001,3,113,280,192,0.852337363396583,-10.6,19.1659340659341,79,1265.18615785704,-1.12642781832065
22160,525512.449,5349292.797,154,52,102,26.07,0,2002,3,124,323,280,0.777148477374794,6.29999999999999,19.1637362637363,156,1265.18615785704,-1.12642781832065
22160,525512.449,5349292.797,168,93,75,26.028,0,2003,1,120,331,177,0.854042342944863,-207.1,23.9516483516484,57,1265.18615785704,-1.12642781832065
22160,525512.449,5349292.797,165,104,61,30.341,0,2004,2,118,332,210,0.844937670858676,109,18.7549450549451,92,1265.18615785704,-1.12642781832065
22160,525512.449,5349292.797,169,93,76,29.304,0,2005,2,123,314,186,0.857727803809312,-46.2,18.9098901098901,63,1265.18615785704,-1.12642781832065
22160,525512.449,5349292.797,178,62,116,40.618,0,2006,3,110,345,185,0.818581679855938,29.4,19.8868131868132,75,1265.18615785704,-1.12642781832065
22160,525512.449,5349292.797,93,93,0,43.204,0,2007,1,97,301,170,0.841195733487991,236.4,18.0659340659341,73,1265.18615785704,-1.12642781832065
22160,525512.449,5349292.797,86,62,24,21.403,0,2008,1,125,310,201,0.840524310125205,13.4,18.4934065934066,76,1265.18615785704,-1.12642781832065
22160,525512.449,5349292.797,192,66,126,17.785,0,2009,3,129,290,178,0.854718272903225,14,19.4461538461538,49,1265.18615785704,-1.12642781832065
22160,525512.449,5349292.797,158,95,63,12.931,0,2010,2,137,307,192,0.820632023768831,69.3,19.1879120879121,55,1265.18615785704,-1.12642781832065
22160,525512.449,5349292.797,137,68,69,31.13,0,2011,3,100,321,200,0.854640441213713,108.7,18.4846153846154,100,1265.18615785704,-1.12642781832065
22160,525512.449,5349292.797,163,102,61,33.491,0,2012,2,119,315,208,0.821228560832386,6.9,19.8923076923077,89,1265.18615785704,-1.12642781832065
22160,525512.449,5349292.797,186,71,115,20.394,0,2013,3,133,302,201,0.836855302061513,-187.7,20.2681318681319,68,1265.18615785704,-1.12642781832065
22160,525512.449,5349292.797,145,48,97,37.831,0,2014,3,101,342,209,0.79857556769389,71,18.9736263736264,108,1265.18615785704,-1.12642781832065
22160,525512.449,5349292.797,160,94,66,41.605,0,2015,2,106,334,185,0.85541235369839,-210.3,22.0318681318681,79,1265.18615785704,-1.12642781832065
22160,525512.449,5349292.797,168,105,63,55.379,4,2016,2,99,339,201,0.833951212342397,-28.3,20.1868131868132,102,1265.18615785704,-1.12642781832065
22160,525512.449,5349292.797,149,94,55,34.646,5,2017,2,109,308,185,0.830510067281126,-67,20.9692307692308,76,1265.18615785704,-1.12642781832065
22160,525512.449,5349292.797,167,58,109,21.303,0,2018,3,126,314,186,0.843158043086127,-134,21.621978021978,60,1265.18615785704,-1.12642781832065
22160,525512.449,5349292.797,153,93,60,24.623,2,2019,2,125,302,200,0.8339211327186,-110.8,21.721978021978,75,1265.18615785704,-1.12642781832065
22160,525512.449,5349292.797,0,0,0,32.426,0,2020,0,101,314,192,0.800267097801183,-108.6,20.0032967032967,91,1265.18615785704,-1.12642781832065
22161,525512.449,5349061.14,0,0,0,53.863,0,2001,2,99,280,186,0.831097225006883,-10.6,19.1659340659341,87,1156.72074620997,-1.53494790714753
22161,525512.449,5349061.14,158,53,105,39.734,0,2002,2,108,318,161,0.750053087246054,6.29999999999999,19.1637362637363,53,1156.72074620997,-1.53494790714753
22161,525512.449,5349061.14,163,93,70,37.83,1,2003,1,105,335,170,0.821699533894498,-207.1,23.9516483516484,65,1156.72074620997,-1.53494790714753
22161,525512.449,5349061.14,159,94,65,50.72,1,2004,2,97,339,218,0.819627302724262,109,18.7549450549451,121,1156.72074620997,-1.53494790714753
22161,525512.449,5349061.14,162,94,68,57.235,2,2005,2,96,311,185,0.819884122414292,-46.2,18.9098901098901,89,1156.72074620997,-1.53494790714753
22161,525512.449,5349061.14,186,60,126,32.89,0,2006,2,118,344,176,0.788295124071712,29.4,19.8868131868132,58,1156.72074620997,-1.53494790714753
22161,525512.449,5349061.14,93,93,0,51.116,1,2007,1,89,304,168,0.817339254104764,236.4,18.0659340659341,79,1156.72074620997,-1.53494790714753
22161,525512.449,5349061.14,86,62,24,25.23,0,2008,1,121,311,208,0.810318630626339,13.4,18.4934065934066,87,1156.72074620997,-1.53494790714753
22161,525512.449,5349061.14,183,64,119,31.44,0,2009,3,111,295,193,0.821178252239517,14,19.4461538461538,82,1156.72074620997,-1.53494790714753
22161,525512.449,5349061.14,164,93,71,23.426,0,2010,2,124,313,184,0.803332020890199,69.3,19.1879120879121,60,1156.72074620997,-1.53494790714753
22161,525512.449,5349061.14,126,68,58,44.322,0,2011,3,84,322,201,0.830147039644967,108.7,18.4846153846154,117,1156.72074620997,-1.53494790714753
22161,525512.449,5349061.14,159,93,66,55.511,3,2012,2,93,322,209,0.797696338563919,6.9,19.8923076923077,116,1156.72074620997,-1.53494790714753
22161,525512.449,5349061.14,185,72,113,31.366,0,2013,3,122,294,201,0.82106678492619,-187.7,20.2681318681319,79,1156.72074620997,-1.53494790714753
22161,525512.449,5349061.14,145,43,102,42.817,0,2014,5,94,345,201,0.78924072733955,71,18.9736263736264,107,1156.72074620997,-1.53494790714753
22161,525512.449,5349061.14,158,94,64,60.432,4,2015,1,88,338,177,0.815422398433132,-210.3,22.0318681318681,89,1156.72074620997,-1.53494790714753
22161,525512.449,5349061.14,171,95,76,45.182,4,2016,1,109,344,184,0.81017539309597,-28.3,20.1868131868132,75,1156.72074620997,-1.53494790714753
22161,525512.449,5349061.14,148,95,53,45.152,6,2017,1,95,311,177,0.79996060680308,-67,20.9692307692308,82,1156.72074620997,-1.53494790714753
22161,525512.449,5349061.14,170,58,112,43.902,0,2018,3,100,323,185,0.820313033372969,-134,21.621978021978,85,1156.72074620997,-1.53494790714753
22161,525512.449,5349061.14,151,93,58,43.991,5,2019,2,103,322,208,0.79125891310562,-110.8,21.721978021978,105,1156.72074620997,-1.53494790714753
22161,525512.449,5349061.14,0,0,0,41.269,0,2020,0,90,317,178,0.765573344090611,-108.6,20.0032967032967,88,1156.72074620997,-1.53494790714753
22369,525744.105,5351609.36,0,0,0,141.062,0,2001,3,25,297,193,0.858046919902848,4.09999999999999,18.2296703296703,168,1234.21857964484,1.12583647264891
22369,525744.105,5351609.36,86,75,11,24.24,0,2002,1,126,288,201,0.824770287112211,18.8,18.3868131868132,75,1234.21857964484,1.12583647264891
22369,525744.105,5351609.36,174,93,81,28.495,0,2003,2,118,325,185,0.852970316639286,-204,23.121978021978,67,1234.21857964484,1.12583647264891
22369,525744.105,5351609.36,164,94,70,21.418,0,2004,2,129,326,217,0.834166320549962,123.8,17.9692307692308,88,1234.21857964484,1.12583647264891
22369,525744.105,5351609.36,165,96,69,26.581,0,2005,2,126,314,193,0.835127255560569,-31.4,18.0615384615385,67,1234.21857964484,1.12583647264891
22369,525744.105,5351609.36,192,132,60,18.259,0,2006,1,135,331,194,0.825793030116305,43,19.0516483516484,59,1234.21857964484,1.12583647264891
22369,525744.105,5351609.36,0,0,0,26.452,0,2007,0,121,298,218,0.819644181274452,258.5,17.3142857142857,97,1234.21857964484,1.12583647264891
22369,525744.105,5351609.36,94,93,1,22.626,0,2008,2,124,279,210,0.885560650827971,29.3,17.7417582417582,86,1234.21857964484,1.12583647264891
22369,525744.105,5351609.36,184,58,126,21.433,0,2009,3,126,292,224,0.831529939193335,27.1,18.689010989011,98,1234.21857964484,1.12583647264891
22369,525744.105,5351609.36,170,95,75,21.83,0,2010,2,128,304,226,0.785314820763777,87.4,18.4241758241758,98,1234.21857964484,1.12583647264891
22369,525744.105,5351609.36,93,61,32,30.959,0,2011,3,103,316,185,0.825957102237915,129,17.5824175824176,82,1234.21857964484,1.12583647264891
22369,525744.105,5351609.36,159,110,49,33.93,0,2012,2,119,313,216,0.829277285233039,29,18.7703296703297,97,1234.21857964484,1.12583647264891
22369,525744.105,5351609.36,182,76,106,24.695,0,2013,3,129,301,208,0.849271463860849,-172.4,19.2857142857143,79,1234.21857964484,1.12583647264891
22369,525744.105,5351609.36,146,50,96,33.537,0,2014,3,110,339,202,0.839972280486567,91.5,17.9450549450549,92,1234.21857964484,1.12583647264891
22369,525744.105,5351609.36,171,97,74,29.608,0,2015,2,121,329,210,0.847158887987019,-197.8,21,89,1234.21857964484,1.12583647264891
22369,525744.105,5351609.36,169,94,75,39.103,5,2016,1,115,337,177,0.823212521863139,-13,19.132967032967,62,1234.21857964484,1.12583647264891
22369,525744.105,5351609.36,145,94,51,30.642,2,2017,2,116,308,210,0.844014014295354,-57.8,20.1032967032967,94,1234.21857964484,1.12583647264891
22369,525744.105,5351609.36,171,95,76,34.695,0,2018,2,111,307,192,0.821998443914093,-125.4,20.7956043956044,81,1234.21857964484,1.12583647264891
22369,525744.105,5351609.36,165,93,72,20.462,0,2019,2,130,297,225,0.815574812526472,-108.1,20.8824175824176,95,1234.21857964484,1.12583647264891
22369,525744.105,5351609.36,86,69,17,12.764,0,2020,1,135,330,226,0.802162985567992,-97.4,19.156043956044,91,1234.21857964484,1.12583647264891
22370,525744.105,5351377.704,0,0,0,144.208,0,2001,3,22,302,194,0.8616568869923,4.09999999999999,18.2296703296703,172,1245.62646473079,1.45158567470066
22370,525744.105,5351377.704,86,74,12,20.13,0,2002,1,130,288,225,0.843783680260356,18.8,18.3868131868132,95,1245.62646473079,1.45158567470066
22370,525744.105,5351377.704,175,93,82,25.972,0,2003,2,121,324,186,0.856997175988299,-204,23.121978021978,65,1245.62646473079,1.45158567470066
22370,525744.105,5351377.704,165,94,71,10.802,0,2004,2,140,307,217,0.842966863471857,123.8,17.9692307692308,77,1245.62646473079,1.45158567470066
22370,525744.105,5351377.704,165,96,69,24.504,0,2005,2,128,310,192,0.840909313499301,-31.4,18.0615384615385,64,1245.62646473079,1.45158567470066
22370,525744.105,5351377.704,189,106,83,22.108,0,2006,1,131,329,194,0.840461968019405,43,19.0516483516484,63,1245.62646473079,1.45158567470066
22370,525744.105,5351377.704,0,0,0,29.629,0,2007,0,116,300,209,0.853788367184417,258.5,17.3142857142857,93,1245.62646473079,1.45158567470066
22370,525744.105,5351377.704,102,93,9,21.693,0,2008,2,125,270,202,0.852551138135731,29.3,17.7417582417582,77,1245.62646473079,1.45158567470066
22370,525744.105,5351377.704,190,57,133,4.34,0,2009,5,147,299,232,0.836434944598259,27.1,18.689010989011,85,1245.62646473079,1.45158567470066
22370,525744.105,5351377.704,171,94,77,18.356,0,2010,2,132,297,208,0.824659825409751,87.4,18.4241758241758,76,1245.62646473079,1.45158567470066
22370,525744.105,5351377.704,93,57,36,26.428,0,2011,3,109,314,186,0.836817175782832,129,17.5824175824176,77,1245.62646473079,1.45158567470066
22370,525744.105,5351377.704,157,107,50,31.895,0,2012,1,121,313,186,0.83996588799748,29,18.7703296703297,65,1245.62646473079,1.45158567470066
22370,525744.105,5351377.704,178,76,102,22.706,0,2013,3,131,296,209,0.865241558528649,-172.4,19.2857142857143,78,1245.62646473079,1.45158567470066
22370,525744.105,5351377.704,147,46,101,27.25,0,2014,3,120,339,194,0.828627594414069,91.5,17.9450549450549,74,1245.62646473079,1.45158567470066
22370,525744.105,5351377.704,171,93,78,30.467,0,2015,2,120,322,210,0.849671570506821,-197.8,21,90,1245.62646473079,1.45158567470066
22370,525744.105,5351377.704,172,107,65,29.53,0,2016,1,124,338,186,0.850651705672931,-13,19.132967032967,62,1245.62646473079,1.45158567470066
22370,525744.105,5351377.704,148,103,45,27.509,0,2017,2,120,307,202,0.842827015682512,-57.8,20.1032967032967,82,1245.62646473079,1.45158567470066
22370,525744.105,5351377.704,173,93,80,32.921,0,2018,2,113,305,193,0.846582627652617,-125.4,20.7956043956044,80,1245.62646473079,1.45158567470066
22370,525744.105,5351377.704,164,93,71,9.985,0,2019,2,141,290,232,0.767614907895965,-108.1,20.8824175824176,91,1245.62646473079,1.45158567470066
22370,525744.105,5351377.704,86,60,26,16.158,1,2020,1,130,304,201,0.765359898972135,-97.4,19.156043956044,71,1245.62646473079,1.45158567470066
22371,525744.105,5351146.048,130,94,36,33.345,0,2001,5,118,297,193,0.860672838191916,4.09999999999999,18.2296703296703,75,1264.23290896755,1.04679266082533
22371,525744.105,5351146.048,86,51,35,37.093,0,2002,1,112,306,217,0.834811795240605,18.8,18.3868131868132,105,1264.23290896755,1.04679266082533
22371,525744.105,5351146.048,171,106,65,25.972,0,2003,2,121,329,208,0.822183962006919,-204,23.121978021978,87,1264.23290896755,1.04679266082533
22371,525744.105,5351146.048,167,93,74,17.355,0,2004,2,133,302,210,0.845546370525155,123.8,17.9692307692308,77,1264.23290896755,1.04679266082533
22371,525744.105,5351146.048,162,98,64,29.524,0,2005,1,123,313,186,0.845489332640681,-31.4,18.0615384615385,63,1264.23290896755,1.04679266082533
22371,525744.105,5351146.048,194,65,129,26.828,0,2006,2,126,336,177,0.809440406760979,43,19.0516483516484,51,1264.23290896755,1.04679266082533
22371,525744.105,5351146.048,93,93,0,35.702,0,2007,2,107,300,185,0.860836696999407,258.5,17.3142857142857,78,1264.23290896755,1.04679266082533
22371,525744.105,5351146.048,167,65,102,23.58,0,2008,3,123,300,176,0.823954844968712,29.3,17.7417582417582,53,1264.23290896755,1.04679266082533
22371,525744.105,5351146.048,187,58,129,19.828,0,2009,2,128,297,185,1.00259678097152,27.1,18.689010989011,57,1264.23290896755,1.04679266082533
22371,525744.105,5351146.048,169,94,75,27.357,0,2010,2,121,295,193,0.840066311860579,87.4,18.4241758241758,72,1264.23290896755,1.04679266082533
22371,525744.105,5351146.048,150,61,89,27.886,0,2011,3,107,316,177,0.823560775159348,129,17.5824175824176,70,1264.23290896755,1.04679266082533
22371,525744.105,5351146.048,167,94,73,30.864,0,2012,2,122,319,185,0.854784264804632,29,18.7703296703297,63,1264.23290896755,1.04679266082533
22371,525744.105,5351146.048,186,84,102,15.836,0,2013,2,138,303,209,0.86765251470233,-172.4,19.2857142857143,71,1264.23290896755,1.04679266082533
22371,525744.105,5351146.048,132,48,84,32.281,0,2014,3,112,317,201,0.856314200001831,91.5,17.9450549450549,89,1264.23290896755,1.04679266082533
22371,525744.105,5351146.048,175,79,96,30.467,0,2015,2,120,308,194,0.868597600435767,-197.8,21,74,1264.23290896755,1.04679266082533
22371,525744.105,5351146.048,170,111,59,27.405,0,2016,1,126,338,192,0.853887947948279,-13,19.132967032967,66,1264.23290896755,1.04679266082533
22371,525744.105,5351146.048,149,100,49,31.348,2,2017,2,115,292,216,0.843776140827035,-57.8,20.1032967032967,101,1264.23290896755,1.04679266082533
22371,525744.105,5351146.048,176,44,132,29.413,0,2018,3,117,304,193,0.84891142744099,-125.4,20.7956043956044,76,1264.23290896755,1.04679266082533
22371,525744.105,5351146.048,163,85,78,15.441,0,2019,3,135,287,233,0.793476508928965,-108.1,20.8824175824176,98,1264.23290896755,1.04679266082533
22371,525744.105,5351146.048,0,0,0,14.998,0,2020,0,132,284,208,0.780897487632158,-97.4,19.156043956044,76,1264.23290896755,1.04679266082533
22372,525744.105,5350914.391,148,93,55,18.93,0,2001,4,132,300,193,0.867899183844971,4.09999999999999,18.2296703296703,61,1285.999423895,1.03260059640826
22372,525744.105,5350914.391,86,53,33,37.975,0,2002,1,111,305,201,0.839290345447044,18.8,18.3868131868132,90,1285.999423895,1.03260059640826
22372,525744.105,5350914.391,171,106,65,25.972,0,2003,2,121,335,208,0.823649021447806,-204,23.121978021978,87,1285.999423895,1.03260059640826
22372,525744.105,5350914.391,167,93,74,17.355,0,2004,2,133,299,200,0.831378300197746,123.8,17.9692307692308,67,1285.999423895,1.03260059640826
22372,525744.105,5350914.391,158,93,65,29.524,0,2005,2,123,313,192,0.845130746599071,-31.4,18.0615384615385,69,1285.999423895,1.03260059640826
22372,525744.105,5350914.391,194,65,129,25.95,0,2006,2,127,334,177,0.790277617130035,43,19.0516483516484,50,1285.999423895,1.03260059640826
22372,525744.105,5350914.391,93,93,0,37.238,0,2007,2,105,299,186,0.853711993961939,258.5,17.3142857142857,81,1285.999423895,1.03260059640826
22372,525744.105,5350914.391,120,65,55,29.705,0,2008,3,117,296,217,0.858509553315386,29.3,17.7417582417582,100,1285.999423895,1.03260059640826
22372,525744.105,5350914.391,192,58,134,16.617,0,2009,4,132,304,226,0.824822635709211,27.1,18.689010989011,94,1285.999423895,1.03260059640826
22372,525744.105,5350914.391,171,104,67,27.357,0,2010,2,121,292,193,0.846629781122517,87.4,18.4241758241758,72,1285.999423895,1.03260059640826
22372,525744.105,5350914.391,151,64,87,27.15,0,2011,4,108,317,184,0.812614568069881,129,17.5824175824176,76,1285.999423895,1.03260059640826
22372,525744.105,5350914.391,173,143,30,31.895,0,2012,1,121,318,185,0.864784605850619,29,18.7703296703297,64,1285.999423895,1.03260059640826
22372,525744.105,5350914.391,181,83,98,25.701,0,2013,3,128,300,201,0.855143598004471,-172.4,19.2857142857143,73,1285.999423895,1.03260059640826
22372,525744.105,5350914.391,134,47,87,37.418,3,2014,3,104,318,186,0.829438854096052,91.5,17.9450549450549,82,1285.999423895,1.03260059640826
22372,525744.105,5350914.391,171,78,93,32.185,0,2015,3,118,311,201,0.864436599615449,-197.8,21,83,1285.999423895,1.03260059640826
22372,525744.105,5350914.391,172,102,70,22.601,0,2016,2,131,342,210,0.844273421491029,-13,19.132967032967,79,1285.999423895,1.03260059640826
22372,525744.105,5350914.391,146,94,52,34.987,4,2017,2,110,294,218,0.838120018884504,-57.8,20.1032967032967,108,1285.999423895,1.03260059640826
22372,525744.105,5350914.391,176,45,131,30.282,0,2018,3,116,302,194,0.847846007636096,-125.4,20.7956043956044,78,1285.999423895,1.03260059640826
22372,525744.105,5350914.391,161,84,77,22.369,0,2019,3,128,297,193,0.836699411405943,-108.1,20.8824175824176,65,1285.999423895,1.03260059640826
22372,525744.105,5350914.391,0,0,0,19.891,0,2020,0,124,329,210,0.815086768943275,-97.4,19.156043956044,86,1285.999423895,1.03260059640826
22373,525744.105,5350682.735,93,93,0,34.437,0,2001,4,117,311,200,0.846051325837811,4.09999999999999,18.2296703296703,83,1298.10922925149,-1.30921748277079
22373,525744.105,5350682.735,155,93,62,27.446,0,2002,2,123,289,234,0.835092672703791,18.8,18.3868131868132,111,1298.10922925149,-1.30921748277079
22373,525744.105,5350682.735,171,72,99,38.548,1,2003,3,106,330,193,0.832590991592348,-204,23.121978021978,87,1298.10922925149,-1.30921748277079
22373,525744.105,5350682.735,183,101,82,13.46,0,2004,2,137,316,210,0.80841364971761,123.8,17.9692307692308,73,1298.10922925149,-1.30921748277079
22373,525744.105,5350682.735,167,93,74,26.581,0,2005,2,126,312,200,0.828366217575111,-31.4,18.0615384615385,74,1298.10922925149,-1.30921748277079
22373,525744.105,5350682.735,197,69,128,20.16,0,2006,2,133,330,184,0.769979112337335,43,19.0516483516484,51,1298.10922925149,-1.30921748277079
22373,525744.105,5350682.735,93,93,0,38.863,0,2007,2,103,300,208,0.845138861129697,258.5,17.3142857142857,105,1298.10922925149,-1.30921748277079
22373,525744.105,5350682.735,182,65,117,16.63,0,2008,3,131,296,225,0.827891625397659,29.3,17.7417582417582,94,1298.10922925149,-1.30921748277079
22373,525744.105,5350682.735,186,56,130,23.928,0,2009,3,123,289,218,0.831034269543938,27.1,18.689010989011,95,1298.10922925149,-1.30921748277079
22373,525744.105,5350682.735,171,57,114,27.357,0,2010,3,121,292,194,0.822687055008619,87.4,18.4241758241758,73,1298.10922925149,-1.30921748277079
22373,525744.105,5350682.735,162,52,110,25.032,0,2011,3,111,324,185,0.793679452941735,129,17.5824175824176,74,1298.10922925149,-1.30921748277079
22373,525744.105,5350682.735,176,82,94,25.663,0,2012,3,127,312,185,0.848099148561679,29,18.7703296703297,58,1298.10922925149,-1.30921748277079
22373,525744.105,5350682.735,183,62,121,6.411,0,2013,3,147,306,217,0.855536037663593,-172.4,19.2857142857143,70,1298.10922925149,-1.30921748277079
22373,525744.105,5350682.735,153,51,102,36.091,2,2014,3,106,333,305,0.8064289962963,91.5,17.9450549450549,199,1298.10922925149,-1.30921748277079
22373,525744.105,5350682.735,173,80,93,22.563,0,2015,3,127,319,209,0.846100285576539,-197.8,21,82,1298.10922925149,-1.30921748277079
22373,525744.105,5350682.735,183,93,90,13.931,0,2016,2,140,344,194,0.819670624937581,-13,19.132967032967,54,1298.10922925149,-1.30921748277079
22373,525744.105,5350682.735,154,99,55,26.708,0,2017,1,121,299,177,0.827867835969641,-57.8,20.1032967032967,56,1298.10922925149,-1.30921748277079
22373,525744.105,5350682.735,169,56,113,32.921,0,2018,3,113,312,201,0.849367127442258,-125.4,20.7956043956044,88,1298.10922925149,-1.30921748277079
22373,525744.105,5350682.735,175,94,81,15.441,0,2019,2,135,294,233,0.811553425229339,-108.1,20.8824175824176,98,1298.10922925149,-1.30921748277079
22373,525744.105,5350682.735,0,0,0,19.245,0,2020,0,125,320,225,0.816568784846362,-97.4,19.156043956044,100,1298.10922925149,-1.30921748277079
22374,525744.105,5350451.079,93,93,0,53.53,8,2001,4,100,314,202,0.83628983880898,4.09999999999999,18.2296703296703,102,1297.85481755245,0.772982705192896
22374,525744.105,5350451.079,155,95,60,31.091,0,2002,2,119,290,233,0.832183544137091,18.8,18.3868131868132,114,1297.85481755245,0.772982705192896
22374,525744.105,5350451.079,178,73,105,31.84,0,2003,3,114,333,194,0.827460450916648,-204,23.121978021978,80,1297.85481755245,0.772982705192896
22374,525744.105,5350451.079,180,94,86,13.46,0,2004,2,137,319,218,0.823542413455633,123.8,17.9692307692308,81,1297.85481755245,0.772982705192896
22374,525744.105,5350451.079,168,97,71,35.598,0,2005,2,117,316,200,0.819689524556324,-31.4,18.0615384615385,83,1297.85481755245,0.772982705192896
22374,525744.105,5350451.079,198,70,128,20.16,0,2006,3,133,335,192,0.794707575462539,43,19.0516483516484,59,1297.85481755245,0.772982705192896
22374,525744.105,5350451.079,93,93,0,37.238,0,2007,2,105,301,209,0.846411900172871,258.5,17.3142857142857,104,1297.85481755245,0.772982705192896
22374,525744.105,5350451.079,178,65,113,23.58,0,2008,3,123,309,224,0.854057712718164,29.3,17.7417582417582,101,1297.85481755245,0.772982705192896
22374,525744.105,5350451.079,185,60,125,28.845,0,2009,3,117,291,226,0.836940806540647,27.1,18.689010989011,109,1297.85481755245,0.772982705192896
22374,525744.105,5350451.079,175,57,118,31.436,0,2010,3,116,295,194,0.818322431917733,87.4,18.4241758241758,78,1297.85481755245,0.772982705192896
22374,525744.105,5350451.079,160,53,107,27.886,0,2011,3,107,324,200,0.807567738449984,129,17.5824175824176,93,1297.85481755245,0.772982705192896
22374,525744.105,5350451.079,175,82,93,31.895,0,2012,2,121,314,186,0.837430888161407,29,18.7703296703297,65,1297.85481755245,0.772982705192896
22374,525744.105,5350451.079,183,63,120,7.472,0,2013,3,146,297,217,0.849002649899836,-172.4,19.2857142857143,71,1297.85481755245,0.772982705192896
22374,525744.105,5350451.079,153,44,109,36.091,2,2014,3,106,323,200,0.796316827559163,91.5,17.9450549450549,94,1297.85481755245,0.772982705192896
22374,525744.105,5350451.079,176,78,98,23.704,0,2015,3,126,319,202,0.841612780772596,-197.8,21,76,1297.85481755245,0.772982705192896
22374,525744.105,5350451.079,183,96,87,15.852,0,2016,1,138,346,185,0.794730501621447,-13,19.132967032967,47,1297.85481755245,0.772982705192896
22374,525744.105,5350451.079,152,100,52,36.495,6,2017,1,108,305,185,0.802889454414379,-57.8,20.1032967032967,77,1297.85481755245,0.772982705192896
22374,525744.105,5350451.079,169,60,109,32.921,0,2018,3,113,306,201,0.844923789303956,-125.4,20.7956043956044,88,1297.85481755245,0.772982705192896
22374,525744.105,5350451.079,173,93,80,19.443,0,2019,2,131,299,241,0.799094217517644,-108.1,20.8824175824176,110,1297.85481755245,0.772982705192896
22374,525744.105,5350451.079,0,0,0,26.656,0,2020,0,112,325,224,0.815296586967368,-97.4,19.156043956044,112,1297.85481755245,0.772982705192896
22379,525744.105,5349292.797,93,93,0,52.735,7,2001,4,100,280,193,0.839567172257711,-10.6,19.1659340659341,93,1258.61406559424,0.766201143080405
22379,525744.105,5349292.797,157,52,105,28.923,0,2002,3,121,323,274,0.770920542742628,6.29999999999999,19.1637362637363,153,1258.61406559424,0.766201143080405
22379,525744.105,5349292.797,166,93,73,27.604,0,2003,2,118,332,184,0.839619894508325,-207.1,23.9516483516484,66,1258.61406559424,0.766201143080405
22379,525744.105,5349292.797,165,103,62,24.483,0,2004,2,125,336,208,0.836154877590655,109,18.7549450549451,83,1258.61406559424,0.766201143080405
22379,525744.105,5349292.797,168,93,75,32.183,0,2005,2,120,316,186,0.856480022285282,-46.2,18.9098901098901,66,1258.61406559424,0.766201143080405
22379,525744.105,5349292.797,184,63,121,27.494,0,2006,2,124,342,185,0.827526124140418,29.4,19.8868131868132,61,1258.61406559424,0.766201143080405
22379,525744.105,5349292.797,93,93,0,44.134,0,2007,1,96,302,176,0.830077223357083,236.4,18.0659340659341,80,1258.61406559424,0.766201143080405
22379,525744.105,5349292.797,86,62,24,19.622,0,2008,1,127,313,201,0.829797504237831,13.4,18.4934065934066,74,1258.61406559424,0.766201143080405
22379,525744.105,5349292.797,186,67,119,21.502,0,2009,3,124,300,184,0.851590554949156,14,19.4461538461538,60,1258.61406559424,0.766201143080405
22379,525744.105,5349292.797,161,105,56,21.311,0,2010,1,127,309,185,0.822013502959178,69.3,19.1879120879121,58,1258.61406559424,0.766201143080405
22379,525744.105,5349292.797,135,69,66,34.329,0,2011,3,96,322,200,0.856041520556507,108.7,18.4846153846154,104,1258.61406559424,0.766201143080405
22379,525744.105,5349292.797,163,96,67,31.489,0,2012,2,121,317,202,0.815378870124102,6.9,19.8923076923077,81,1258.61406559424,0.766201143080405
22379,525744.105,5349292.797,182,71,111,37.414,0,2013,3,116,299,201,0.847315794864983,-187.7,20.2681318681319,85,1258.61406559424,0.766201143080405
22379,525744.105,5349292.797,148,47,101,39.21,0,2014,2,99,343,160,0.761915983331411,71,18.9736263736264,61,1258.61406559424,0.766201143080405
22379,525744.105,5349292.797,164,93,71,32.617,0,2015,2,117,334,184,0.854017098482447,-210.3,22.0318681318681,67,1258.61406559424,0.766201143080405
22379,525744.105,5349292.797,170,107,63,37.609,4,2016,1,116,340,177,0.834292594269308,-28.3,20.1868131868132,61,1258.61406559424,0.766201143080405
22379,525744.105,5349292.797,147,97,50,35.378,6,2017,1,108,309,185,0.816369499779416,-67,20.9692307692308,77,1258.61406559424,0.766201143080405
22379,525744.105,5349292.797,168,58,110,34.168,0,2018,3,110,312,186,0.842178531893393,-134,21.621978021978,76,1258.61406559424,0.766201143080405
22379,525744.105,5349292.797,156,93,63,22.883,0,2019,2,127,302,201,0.821629871036812,-110.8,21.721978021978,74,1258.61406559424,0.766201143080405
22379,525744.105,5349292.797,0,0,0,29.057,0,2020,0,106,320,194,0.793078093261929,-108.6,20.0032967032967,88,1258.61406559424,0.766201143080405
22380,525744.105,5349061.14,0,0,0,49.231,0,2001,2,103,288,192,0.820860877672608,-10.6,19.1659340659341,89,1193.89135957967,0.916451564713262
22380,525744.105,5349061.14,157,60,97,42.284,0,2002,2,105,319,160,0.750067610155551,6.29999999999999,19.1637362637363,55,1193.89135957967,0.916451564713262
22380,525744.105,5349061.14,162,93,69,38.671,1,2003,1,104,334,177,0.821956903120677,-207.1,23.9516483516484,73,1193.89135957967,0.916451564713262
22380,525744.105,5349061.14,159,94,65,48.539,0,2004,2,99,339,225,0.820472601586856,109,18.7549450549451,126,1193.89135957967,0.916451564713262
22380,525744.105,5349061.14,161,94,67,58.16,2,2005,2,95,313,185,0.816961642357231,-46.2,18.9098901098901,90,1193.89135957967,0.916451564713262
22380,525744.105,5349061.14,185,61,124,33.827,0,2006,2,117,345,177,0.814110959392357,29.4,19.8868131868132,60,1193.89135957967,0.916451564713262
22380,525744.105,5349061.14,93,93,0,50.085,1,2007,1,90,302,177,0.833624252999632,236.4,18.0659340659341,87,1193.89135957967,0.916451564713262
22380,525744.105,5349061.14,86,62,24,48.669,1,2008,1,100,312,202,0.820944672035733,13.4,18.4934065934066,102,1193.89135957967,0.916451564713262
22380,525744.105,5349061.14,181,64,117,39.063,0,2009,3,102,305,186,0.830050639315129,14,19.4461538461538,84,1193.89135957967,0.916451564713262
22380,525744.105,5349061.14,158,95,63,29.838,0,2010,2,115,314,184,0.803017015143633,69.3,19.1879120879121,69,1193.89135957967,0.916451564713262
22380,525744.105,5349061.14,125,71,54,53.578,3,2011,3,73,324,194,0.828012493634694,108.7,18.4846153846154,121,1193.89135957967,0.916451564713262
22380,525744.105,5349061.14,160,93,67,54.047,3,2012,2,95,315,224,0.81158755076521,6.9,19.8923076923077,129,1193.89135957967,0.916451564713262
22380,525744.105,5349061.14,183,71,112,40.148,0,2013,3,113,305,193,0.828569423363955,-187.7,20.2681318681319,80,1193.89135957967,0.916451564713262
22380,525744.105,5349061.14,144,49,95,44.313,0,2014,3,92,345,168,0.787296417224037,71,18.9736263736264,76,1193.89135957967,0.916451564713262
22380,525744.105,5349061.14,157,94,63,64.616,4,2015,1,83,339,178,0.829687167025393,-210.3,22.0318681318681,95,1193.89135957967,0.916451564713262
22380,525744.105,5349061.14,167,101,66,55.379,4,2016,1,99,344,170,0.82158348541168,-28.3,20.1868131868132,71,1193.89135957967,0.916451564713262
22380,525744.105,5349061.14,144,94,50,58.437,6,2017,1,81,314,178,0.804625843216658,-67,20.9692307692308,97,1193.89135957967,0.916451564713262
22380,525744.105,5349061.14,169,59,110,44.913,0,2018,3,99,324,193,0.82277904167873,-134,21.621978021978,94,1193.89135957967,0.916451564713262
22380,525744.105,5349061.14,148,94,54,50.604,6,2019,2,96,335,194,0.803978078466287,-110.8,21.721978021978,98,1193.89135957967,0.916451564713262
22380,525744.105,5349061.14,0,0,0,117.188,0,2020,0,22,318,194,0.77683544275844,-108.6,20.0032967032967,172,1193.89135957967,0.916451564713262
22599,525975.761,5349061.14,0,0,0,137.328,0,2001,2,27,311,200,0.783613179407662,-10.6,19.1659340659341,173,1211.28302999621,-0.667064965320349
22599,525975.761,5349061.14,158,75,83,41.434,0,2002,3,106,310,241,0.795421821451319,6.29999999999999,19.1637362637363,135,1211.28302999621,-0.667064965320349
22599,525975.761,5349061.14,156,94,62,42.145,3,2003,1,100,280,161,0.788059546553203,-207.1,23.9516483516484,61,1211.28302999621,-0.667064965320349
22599,525975.761,5349061.14,169,80,89,31.19,0,2004,3,117,343,224,0.88144160279579,109,18.7549450549451,107,1211.28302999621,-0.667064965320349
22599,525975.761,5349061.14,162,94,68,51.866,0,2005,2,101,314,186,0.794982621215819,-46.2,18.9098901098901,85,1211.28302999621,-0.667064965320349
22599,525975.761,5349061.14,185,102,83,52.249,2,2006,1,100,342,178,0.787775154656081,29.4,19.8868131868132,78,1211.28302999621,-0.667064965320349
22599,525975.761,5349061.14,93,93,0,50.085,1,2007,1,90,297,169,0.806001623667691,236.4,18.0659340659341,79,1211.28302999621,-0.667064965320349
22599,525975.761,5349061.14,98,53,45,112.877,24,2008,3,39,300,225,0.793158103057249,13.4,18.4934065934066,186,1211.28302999621,-0.667064965320349
22599,525975.761,5349061.14,180,61,119,39.063,0,2009,3,102,307,218,0.778508900305241,14,19.4461538461538,116,1211.28302999621,-0.667064965320349
22599,525975.761,5349061.14,168,93,75,28.328,0,2010,2,117,307,185,0.795867288811414,69.3,19.1879120879121,68,1211.28302999621,-0.667064965320349
22599,525975.761,5349061.14,123,64,59,60.46,5,2011,3,65,322,210,0.759668702787872,108.7,18.4846153846154,145,1211.28302999621,-0.667064965320349
22599,525975.761,5349061.14,155,81,74,65.421,4,2012,2,81,314,178,0.838569443725972,6.9,19.8923076923077,97,1211.28302999621,-0.667064965320349
22599,525975.761,5349061.14,189,74,115,32.396,0,2013,4,121,302,194,0.809911682672384,-187.7,20.2681318681319,73,1211.28302999621,-0.667064965320349
22599,525975.761,5349061.14,86,51,35,70.408,6,2014,1,62,323,209,0.803615614701455,71,18.9736263736264,147,1211.28302999621,-0.667064965320349
22599,525975.761,5349061.14,167,93,74,43.404,0,2015,2,104,318,186,0.822320749867909,-210.3,22.0318681318681,82,1211.28302999621,-0.667064965320349
22599,525975.761,5349061.14,174,93,81,54.382,4,2016,1,100,345,177,0.83511801295245,-28.3,20.1868131868132,77,1211.28302999621,-0.667064965320349
22599,525975.761,5349061.14,141,94,47,55.27,6,2017,2,84,301,241,0.801051460336317,-67,20.9692307692308,157,1211.28302999621,-0.667064965320349
22599,525975.761,5349061.14,179,93,86,50.25,0,2018,2,94,330,186,0.825021095745081,-134,21.621978021978,92,1211.28302999621,-0.667064965320349
22599,525975.761,5349061.14,150,94,56,54.223,8,2019,2,92,336,194,0.798604532366759,-110.8,21.721978021978,102,1211.28302999621,-0.667064965320349
22599,525975.761,5349061.14,0,0,0,50.454,0,2020,0,80,337,201,0.747001746470424,-108.6,20.0032967032967,121,1211.28302999621,-0.667064965320349
22804,526207.418,5352304.33,0,0,0,52.345,0,2001,2,101,312,178,0.779701039737058,4.09999999999999,18.2296703296703,77,1116.13884401565,0.987283514445642
22804,526207.418,5352304.33,86,51,35,37.093,0,2002,1,112,289,240,0.777432976597469,18.8,18.3868131868132,128,1116.13884401565,0.987283514445642
22804,526207.418,5352304.33,170,104,66,35.204,0,2003,1,110,284,161,0.805643552259817,-204,23.121978021978,51,1116.13884401565,0.987283514445642
22804,526207.418,5352304.33,146,25,121,39.254,0,2004,2,109,310,184,0.775555212948752,123.8,17.9692307692308,75,1116.13884401565,0.987283514445642
22804,526207.418,5352304.33,158,93,65,45.16,0,2005,1,108,305,161,0.758038048967221,-31.4,18.0615384615385,53,1116.13884401565,0.987283514445642
22804,526207.418,5352304.33,195,60,135,27.722,0,2006,3,125,342,185,0.752052883066771,43,19.0516483516484,60,1116.13884401565,0.987283514445642
22804,526207.418,5352304.33,123,94,29,53.365,1,2007,1,88,304,169,0.757463434710792,258.5,17.3142857142857,81,1116.13884401565,0.987283514445642
22804,526207.418,5352304.33,0,0,0,34.288,0,2008,0,113,307,168,0.804125802568545,29.3,17.7417582417582,55,1116.13884401565,0.987283514445642
22804,526207.418,5352304.33,181,71,110,37.162,0,2009,2,108,296,169,0.801144604268898,27.1,18.689010989011,61,1116.13884401565,0.987283514445642
22804,526207.418,5352304.33,169,66,103,38.023,0,2010,2,109,311,170,0.738211098057115,87.4,18.4241758241758,61,1116.13884401565,0.987283514445642
22804,526207.418,5352304.33,132,68,64,44.114,0,2011,2,88,323,169,0.790193269250248,129,17.5824175824176,81,1116.13884401565,0.987283514445642
22804,526207.418,5352304.33,157,100,57,44.114,0,2012,1,109,310,176,0.807383237544498,29,18.7703296703297,67,1116.13884401565,0.987283514445642
22804,526207.418,5352304.33,176,60,116,53.653,0,2013,3,103,301,184,0.799242883675451,-172.4,19.2857142857143,81,1116.13884401565,0.987283514445642
22804,526207.418,5352304.33,132,50,82,47.836,3,2014,3,90,327,265,0.76538666097633,91.5,17.9450549450549,175,1116.13884401565,0.987283514445642
22804,526207.418,5352304.33,166,78,88,40.364,0,2015,3,108,342,201,0.785380183386146,-197.8,21,93,1116.13884401565,0.987283514445642
22804,526207.418,5352304.33,168,95,73,49.129,5,2016,2,106,337,242,0.783192384490229,-13,19.132967032967,136,1116.13884401565,0.987283514445642
22804,526207.418,5352304.33,146,95,51,45.72,6,2017,2,96,304,242,0.771063834300217,-57.8,20.1032967032967,146,1116.13884401565,0.987283514445642
22804,526207.418,5352304.33,160,69,91,55.675,1,2018,2,92,322,160,0.796158431985668,-125.4,20.7956043956044,68,1116.13884401565,0.987283514445642
22804,526207.418,5352304.33,160,93,67,40.915,3,2019,1,107,315,169,0.799717426481218,-108.1,20.8824175824176,62,1116.13884401565,0.987283514445642
22804,526207.418,5352304.33,0,0,0,46.591,0,2020,0,86,318,176,0.759112899489307,-97.4,19.156043956044,90,1116.13884401565,0.987283514445642
22818,526207.418,5349061.14,0,0,0,145.707,0,2001,2,19,322,224,0.809231936315632,-10.6,19.1659340659341,205,1192.17281411365,-0.566550139236209
22818,526207.418,5349061.14,157,78,79,55.392,2,2002,2,90,309,170,0.806091612123831,6.29999999999999,19.1637362637363,80,1192.17281411365,-0.566550139236209
22818,526207.418,5349061.14,159,98,61,47.569,8,2003,1,94,283,153,0.778887106821354,-207.1,23.9516483516484,59,1192.17281411365,-0.566550139236209
22818,526207.418,5349061.14,166,81,85,45.309,0,2004,3,102,345,210,0.835608956980325,109,18.7549450549451,108,1192.17281411365,-0.566550139236209
22818,526207.418,5349061.14,165,111,54,60.056,2,2005,1,93,317,170,0.806376071068433,-46.2,18.9098901098901,77,1192.17281411365,-0.566550139236209
22818,526207.418,5349061.14,196,93,103,23.372,0,2006,2,129,348,185,0.81132982642935,29.4,19.8868131868132,56,1192.17281411365,-0.566550139236209
22818,526207.418,5349061.14,93,93,0,50.085,1,2007,1,90,300,170,0.82461361813522,236.4,18.0659340659341,80,1192.17281411365,-0.566550139236209
22818,526207.418,5349061.14,97,54,43,109.613,24,2008,3,42,308,209,0.827141180349571,13.4,18.4934065934066,167,1192.17281411365,-0.566550139236209
22818,526207.418,5349061.14,186,63,123,28.229,0,2009,3,115,300,226,0.806236076862742,14,19.4461538461538,111,1192.17281411365,-0.566550139236209
22818,526207.418,5349061.14,166,93,73,37.489,0,2010,1,106,310,170,0.813413160690627,69.3,19.1879120879121,64,1192.17281411365,-0.566550139236209
22818,526207.418,5349061.14,130,65,65,45.955,0,2011,3,82,324,234,0.773572592457878,108.7,18.4846153846154,152,1192.17281411365,-0.566550139236209
22818,526207.418,5349061.14,154,81,73,64.506,4,2012,2,82,321,178,0.82749840887641,6.9,19.8923076923077,96,1192.17281411365,-0.566550139236209
22818,526207.418,5349061.14,187,75,112,35.517,0,2013,3,118,303,200,0.83147108020513,-187.7,20.2681318681319,82,1192.17281411365,-0.566550139236209
22818,526207.418,5349061.14,82,49,33,75.742,8,2014,1,57,325,201,0.836462017371124,71,18.9736263736264,144,1192.17281411365,-0.566550139236209
22818,526207.418,5349061.14,159,93,66,69.857,4,2015,1,77,329,178,0.83089094277011,-210.3,22.0318681318681,101,1192.17281411365,-0.566550139236209
22818,526207.418,5349061.14,170,93,77,62.3,4,2016,2,92,349,216,0.846878771108257,-28.3,20.1868131868132,124,1192.17281411365,-0.566550139236209
22818,526207.418,5349061.14,143,93,50,58.437,6,2017,1,81,310,177,0.822569970663764,-67,20.9692307692308,96,1192.17281411365,-0.566550139236209
22818,526207.418,5349061.14,178,95,83,50.25,0,2018,2,94,332,186,0.831909190819585,-134,21.621978021978,92,1192.17281411365,-0.566550139236209
22818,526207.418,5349061.14,150,93,57,58.793,8,2019,2,87,323,185,0.813211829521972,-110.8,21.721978021978,98,1192.17281411365,-0.566550139236209
22818,526207.418,5349061.14,0,0,0,54.558,0,2020,0,76,341,201,0.777033777189793,-108.6,20.0032967032967,125,1192.17281411365,-0.566550139236209
22819,526207.418,5348829.484,126,94,32,67.307,7,2001,3,87,306,178,0.829666938506525,-10.6,19.1659340659341,91,1130.51304457193,-1.47247638427772
22819,526207.418,5348829.484,86,57,29,49.767,2,2002,1,96,322,256,0.809534461474361,6.29999999999999,19.1637362637363,160,1130.51304457193,-1.47247638427772
22819,526207.418,5348829.484,154,83,71,44.809,6,2003,2,97,336,186,0.799232782549246,-207.1,23.9516483516484,89,1130.51304457193,-1.47247638427772
22819,526207.418,5348829.484,151,98,53,52.647,1,2004,2,95,341,225,0.833933820175553,109,18.7549450549451,130,1130.51304457193,-1.47247638427772
22819,526207.418,5348829.484,0,0,0,77.616,0,2005,0,76,318,177,0.839117626903345,-46.2,18.9098901098901,101,1130.51304457193,-1.47247638427772
22819,526207.418,5348829.484,179,62,117,41.686,0,2006,2,109,349,178,0.819376442246035,29.4,19.8868131868132,69,1130.51304457193,-1.47247638427772
22819,526207.418,5348829.484,114,94,20,49.049,0,2007,2,91,301,200,0.81913803891302,236.4,18.0659340659341,109,1130.51304457193,-1.47247638427772
22819,526207.418,5348829.484,95,50,45,118.42,26,2008,3,34,313,225,0.864788184121872,13.4,18.4934065934066,191,1130.51304457193,-1.47247638427772
22819,526207.418,5348829.484,171,65,106,39.063,0,2009,2,102,328,161,0.84143776741469,14,19.4461538461538,59,1130.51304457193,-1.47247638427772
22819,526207.418,5348829.484,160,93,67,26.884,0,2010,2,119,312,185,0.824716686056307,69.3,19.1879120879121,66,1130.51304457193,-1.47247638427772
22819,526207.418,5348829.484,93,68,25,62.271,7,2011,2,63,326,169,0.836953044420053,108.7,18.4846153846154,106,1130.51304457193,-1.47247638427772
22819,526207.418,5348829.484,141,93,48,58.566,4,2012,2,89,328,209,0.833893960694886,6.9,19.8923076923077,120,1130.51304457193,-1.47247638427772
22819,526207.418,5348829.484,181,93,88,37.414,0,2013,2,116,306,210,0.811762602875974,-187.7,20.2681318681319,94,1130.51304457193,-1.47247638427772
22819,526207.418,5348829.484,129,84,45,49.925,1,2014,5,85,348,209,0.842898081928683,71,18.9736263736264,124,1130.51304457193,-1.47247638427772
22819,526207.418,5348829.484,155,98,57,70.776,4,2015,1,76,332,177,0.825965089712485,-210.3,22.0318681318681,101,1130.51304457193,-1.47247638427772
22819,526207.418,5348829.484,159,93,66,56.391,4,2016,2,98,346,201,0.852736619158263,-28.3,20.1868131868132,103,1130.51304457193,-1.47247638427772
22819,526207.418,5348829.484,130,93,37,60.553,6,2017,1,79,329,169,0.838406472226033,-67,20.9692307692308,90,1130.51304457193,-1.47247638427772
22819,526207.418,5348829.484,163,96,67,48.096,0,2018,2,96,327,185,0.834346154633876,-134,21.621978021978,89,1130.51304457193,-1.47247638427772
22819,526207.418,5348829.484,142,82,60,67.207,9,2019,3,79,328,184,0.829813134773476,-110.8,21.721978021978,105,1130.51304457193,-1.47247638427772
22819,526207.418,5348829.484,0,0,0,123.834,0,2020,0,15,346,184,0.787736456269527,-108.6,20.0032967032967,169,1130.51304457193,-1.47247638427772
22820,526207.418,5348597.828,119,94,25,78.812,8,2001,4,78,308,208,0.835547982053999,-10.6,19.1659340659341,130,1047.17017374021,-1.34669363004756
22820,526207.418,5348597.828,86,57,29,57.438,2,2002,1,88,324,202,0.835805705707034,6.29999999999999,19.1637362637363,114,1047.17017374021,-1.34669363004756
22820,526207.418,5348597.828,148,84,64,49.441,9,2003,3,92,339,200,0.809448849948968,-207.1,23.9516483516484,108,1047.17017374021,-1.34669363004756
22820,526207.418,5348597.828,148,93,55,64.576,6,2004,2,83,339,232,0.834830714837219,109,18.7549450549451,149,1047.17017374021,-1.34669363004756
22820,526207.418,5348597.828,0,0,0,75.517,0,2005,0,78,315,256,0.828817603950415,-46.2,18.9098901098901,178,1047.17017374021,-1.34669363004756
22820,526207.418,5348597.828,175,61,114,42.786,0,2006,2,108,350,177,0.830557518929169,29.4,19.8868131868132,69,1047.17017374021,-1.34669363004756
22820,526207.418,5348597.828,105,93,12,97.785,9,2007,2,47,303,201,0.831644149332959,236.4,18.0659340659341,154,1047.17017374021,-1.34669363004756
22820,526207.418,5348597.828,96,51,45,126.823,31,2008,3,26,316,224,0.863019398449939,13.4,18.4934065934066,198,1047.17017374021,-1.34669363004756
22820,526207.418,5348597.828,160,67,93,57.288,0,2009,2,85,327,169,0.843074868130141,14,19.4461538461538,84,1047.17017374021,-1.34669363004756
22820,526207.418,5348597.828,159,93,66,54.417,2,2010,2,90,312,250,0.848627381268231,69.3,19.1879120879121,160,1047.17017374021,-1.34669363004756
22820,526207.418,5348597.828,93,68,25,67.905,10,2011,2,57,333,169,0.845584031406662,108.7,18.4846153846154,112,1047.17017374021,-1.34669363004756
22820,526207.418,5348597.828,140,93,47,68.194,4,2012,2,78,330,224,0.838292006778679,6.9,19.8923076923077,146,1047.17017374021,-1.34669363004756
22820,526207.418,5348597.828,179,93,86,38.299,0,2013,2,115,312,258,0.865802992639677,-187.7,20.2681318681319,143,1047.17017374021,-1.34669363004756
22820,526207.418,5348597.828,93,93,0,65.348,3,2014,2,67,351,217,0.857356133508994,71,18.9736263736264,150,1047.17017374021,-1.34669363004756
22820,526207.418,5348597.828,158,105,53,62.946,4,2015,2,85,327,217,0.892023400375751,-210.3,22.0318681318681,132,1047.17017374021,-1.34669363004756
22820,526207.418,5348597.828,158,93,65,61.312,4,2016,2,93,349,216,0.865203993701099,-28.3,20.1868131868132,123,1047.17017374021,-1.34669363004756
22820,526207.418,5348597.828,116,93,23,99.613,12,2017,1,44,332,161,0.860428547231358,-67,20.9692307692308,117,1047.17017374021,-1.34669363004756
22820,526207.418,5348597.828,164,93,71,47.006,0,2018,2,97,330,234,0.826177359900651,-134,21.621978021978,137,1047.17017374021,-1.34669363004756
22820,526207.418,5348597.828,139,82,57,73.558,11,2019,3,74,316,192,0.838192020615289,-110.8,21.721978021978,118,1047.17017374021,-1.34669363004756
22820,526207.418,5348597.828,0,0,0,120.017,0,2020,0,19,346,209,0.814367936565784,-108.6,20.0032967032967,190,1047.17017374021,-1.34669363004756
23038,526439.074,5348829.484,0,0,0,142.711,0,2001,2,22,324,169,0.778833289298027,-10.6,19.1659340659341,147,1136.64631767022,1.49599593680577
23038,526439.074,5348829.484,113,94,19,48.899,2,2002,2,97,345,186,0.818308061181065,6.29999999999999,19.1637362637363,89,1136.64631767022,1.49599593680577
23038,526439.074,5348829.484,152,99,53,44.809,6,2003,2,97,335,208,0.734309483507089,-207.1,23.9516483516484,111,1136.64631767022,1.49599593680577
23038,526439.074,5348829.484,164,94,70,36.591,0,2004,2,111,340,232,0.8097377557393,109,18.7549450549451,121,1136.64631767022,1.49599593680577
23038,526439.074,5348829.484,150,109,41,56.3,2,2005,1,97,317,193,0.872047982462635,-46.2,18.9098901098901,96,1136.64631767022,1.49599593680577
23038,526439.074,5348829.484,193,64,129,30.118,0,2006,2,121,348,169,0.808808758781368,29.4,19.8868131868132,48,1136.64631767022,1.49599593680577
23038,526439.074,5348829.484,0,0,0,54.263,0,2007,0,86,308,169,0.828189911140158,236.4,18.0659340659341,83,1136.64631767022,1.49599593680577
23038,526439.074,5348829.484,100,63,37,48.669,1,2008,2,100,310,170,0.824917605851118,13.4,18.4934065934066,70,1136.64631767022,1.49599593680577
23038,526439.074,5348829.484,169,57,112,32.286,0,2009,2,110,319,168,0.832414044606002,14,19.4461538461538,58,1136.64631767022,1.49599593680577
23038,526439.074,5348829.484,153,82,71,37.489,0,2010,2,106,307,177,0.805793361402179,69.3,19.1879120879121,71,1136.64631767022,1.49599593680577
23038,526439.074,5348829.484,83,54,29,64.119,9,2011,1,61,326,177,0.799191469114909,108.7,18.4846153846154,116,1136.64631767022,1.49599593680577
23038,526439.074,5348829.484,143,82,61,67.289,4,2012,3,79,310,201,0.825487528529226,6.9,19.8923076923077,122,1136.64631767022,1.49599593680577
23038,526439.074,5348829.484,164,94,70,51.908,0,2013,2,102,304,184,0.832958331987104,-187.7,20.2681318681319,82,1136.64631767022,1.49599593680577
23038,526439.074,5348829.484,132,52,80,54.84,3,2014,5,79,347,202,0.844851282910359,71,18.9736263736264,123,1136.64631767022,1.49599593680577
23038,526439.074,5348829.484,162,94,68,59.483,4,2015,1,89,343,169,0.835715994300941,-210.3,22.0318681318681,80,1136.64631767022,1.49599593680577
23038,526439.074,5348829.484,162,93,69,53.399,4,2016,2,101,342,194,0.834203370050189,-28.3,20.1868131868132,93,1136.64631767022,1.49599593680577
23038,526439.074,5348829.484,0,0,0,59.492,0,2017,0,80,318,168,0.841090733101861,-67,20.9692307692308,88,1136.64631767022,1.49599593680577
23038,526439.074,5348829.484,167,72,95,50.25,0,2018,2,94,331,168,0.811185099907415,-134,21.621978021978,74,1136.64631767022,1.49599593680577
23038,526439.074,5348829.484,148,93,55,58.793,8,2019,1,87,326,177,0.822957237965747,-110.8,21.721978021978,90,1136.64631767022,1.49599593680577
23038,526439.074,5348829.484,0,0,0,120.976,0,2020,0,18,322,184,0.776439901465432,-108.6,20.0032967032967,166,1136.64631767022,1.49599593680577
23039,526439.074,5348597.828,0,0,0,143.703,0,2001,2,21,331,178,0.806032859944276,-10.6,19.1659340659341,157,1078.62564821652,-1.50357339029728
23039,526439.074,5348597.828,113,94,19,53.43,2,2002,2,92,349,225,0.817712534268517,6.29999999999999,19.1637362637363,133,1078.62564821652,-1.50357339029728
23039,526439.074,5348597.828,154,105,49,43.023,4,2003,1,99,338,160,0.74502228161086,-207.1,23.9516483516484,61,1078.62564821652,-1.50357339029728
23039,526439.074,5348597.828,161,93,68,43.254,0,2004,2,104,338,234,0.821673193036284,109,18.7549450549451,130,1078.62564821652,-1.50357339029728
23039,526439.074,5348597.828,153,93,60,65.126,2,2005,1,88,313,170,0.835997047280904,-46.2,18.9098901098901,82,1078.62564821652,-1.50357339029728
23039,526439.074,5348597.828,191,61,130,33.827,0,2006,2,117,348,161,0.80716248708184,29.4,19.8868131868132,44,1078.62564821652,-1.50357339029728
23039,526439.074,5348597.828,0,0,0,85.765,0,2007,0,58,315,169,0.844008146605276,236.4,18.0659340659341,111,1078.62564821652,-1.50357339029728
23039,526439.074,5348597.828,99,68,31,112.877,24,2008,2,39,307,169,0.84158153750957,13.4,18.4934065934066,130,1078.62564821652,-1.50357339029728
23039,526439.074,5348597.828,166,57,109,45.698,0,2009,3,95,319,209,0.835190904486228,14,19.4461538461538,114,1078.62564821652,-1.50357339029728
23039,526439.074,5348597.828,152,83,69,39.373,0,2010,2,104,310,170,0.811729906048635,69.3,19.1879120879121,66,1078.62564821652,-1.50357339029728
23039,526439.074,5348597.828,86,56,30,73.446,15,2011,1,51,327,224,0.806186024103711,108.7,18.4846153846154,173,1078.62564821652,-1.50357339029728
23039,526439.074,5348597.828,144,83,61,66.351,4,2012,3,80,310,210,0.832791984894861,6.9,19.8923076923077,130,1078.62564821652,-1.50357339029728
23039,526439.074,5348597.828,171,93,78,44.046,0,2013,2,109,307,185,0.838080437909635,-187.7,20.2681318681319,76,1078.62564821652,-1.50357339029728
23039,526439.074,5348597.828,86,54,32,57.296,3,2014,1,76,345,224,0.845963304160437,71,18.9736263736264,148,1078.62564821652,-1.50357339029728
23039,526439.074,5348597.828,165,93,72,53.912,3,2015,1,94,347,154,0.827287811893762,-210.3,22.0318681318681,60,1078.62564821652,-1.50357339029728
23039,526439.074,5348597.828,161,93,68,58.412,4,2016,2,96,343,186,0.852773401833718,-28.3,20.1868131868132,90,1078.62564821652,-1.50357339029728
23039,526439.074,5348597.828,0,0,0,105.166,0,2017,0,39,322,162,0.867416007620704,-67,20.9692307692308,123,1078.62564821652,-1.50357339029728
23039,526439.074,5348597.828,167,72,95,52.349,0,2018,3,92,326,249,0.841128556196895,-134,21.621978021978,157,1078.62564821652,-1.50357339029728
23039,526439.074,5348597.828,147,93,54,58.793,8,2019,1,87,329,169,0.825199527562322,-110.8,21.721978021978,82,1078.62564821652,-1.50357339029728
23039,526439.074,5348597.828,0,0,0,59.094,0,2020,0,72,320,193,0.799283718240248,-108.6,20.0032967032967,121,1078.62564821652,-1.50357339029728
23257,526670.731,5348829.484,0,0,0,142.711,0,2001,2,22,317,161,0.724501905562701,-10.6,19.1659340659341,139,1124.05595191783,1.14251675924856
23257,526670.731,5348829.484,114,94,20,40.585,0,2002,2,107,335,240,0.7768861485612,6.29999999999999,19.1637362637363,133,1124.05595191783,1.14251675924856
23257,526670.731,5348829.484,153,99,54,41.272,2,2003,1,101,332,144,0.727365818956256,-207.1,23.9516483516484,43,1124.05595191783,1.14251675924856
23257,526670.731,5348829.484,168,93,75,34.749,0,2004,1,113,338,176,0.784016307511839,109,18.7549450549451,63,1124.05595191783,1.14251675924856
23257,526670.731,5348829.484,151,108,43,55.241,2,2005,1,98,314,169,0.810814790744561,-46.2,18.9098901098901,71,1124.05595191783,1.14251675924856
23257,526670.731,5348829.484,182,63,119,58.379,5,2006,2,95,345,162,0.815546478598764,29.4,19.8868131868132,67,1124.05595191783,1.14251675924856
23257,526670.731,5348829.484,93,93,0,52.152,1,2007,1,88,309,169,0.832759117647032,236.4,18.0659340659341,81,1124.05595191783,1.14251675924856
23257,526670.731,5348829.484,100,63,37,42.82,1,2008,2,105,303,169,0.845719881803578,13.4,18.4934065934066,64,1124.05595191783,1.14251675924856
23257,526670.731,5348829.484,172,54,118,35.684,0,2009,2,106,311,169,0.847919464108365,14,19.4461538461538,63,1124.05595191783,1.14251675924856
23257,526670.731,5348829.484,154,81,73,37.489,0,2010,2,106,303,170,0.802804134023651,69.3,19.1879120879121,64,1124.05595191783,1.14251675924856
23257,526670.731,5348829.484,82,52,30,60.46,5,2011,1,65,326,240,0.79188172461007,108.7,18.4846153846154,175,1124.05595191783,1.14251675924856
23257,526670.731,5348829.484,145,82,63,57.785,4,2012,3,90,303,210,0.818726170793869,6.9,19.8923076923077,120,1124.05595191783,1.14251675924856
23257,526670.731,5348829.484,170,93,77,46.097,0,2013,1,107,299,177,0.824790667671313,-187.7,20.2681318681319,70,1124.05595191783,1.14251675924856
23257,526670.731,5348829.484,134,49,85,53.262,3,2014,5,81,347,202,0.830212264743737,71,18.9736263736264,121,1124.05595191783,1.14251675924856
23257,526670.731,5348829.484,167,93,74,46.281,0,2015,1,101,341,154,0.828313381424477,-210.3,22.0318681318681,53,1124.05595191783,1.14251675924856
23257,526670.731,5348829.484,164,94,70,53.399,4,2016,1,101,337,177,0.828566622560425,-28.3,20.1868131868132,76,1124.05595191783,1.14251675924856
23257,526670.731,5348829.484,0,0,0,45.994,0,2017,0,94,317,161,0.85518115508725,-67,20.9692307692308,67,1124.05595191783,1.14251675924856
23257,526670.731,5348829.484,171,72,99,44.913,0,2018,2,99,326,160,0.80892322878394,-134,21.621978021978,61,1124.05595191783,1.14251675924856
23257,526670.731,5348829.484,152,93,59,47.81,6,2019,1,99,321,168,0.807206311161641,-110.8,21.721978021978,69,1124.05595191783,1.14251675924856
23257,526670.731,5348829.484,0,0,0,112.632,0,2020,0,27,321,170,0.784120783765584,-108.6,20.0032967032967,143,1124.05595191783,1.14251675924856
23258,526670.731,5348597.828,0,0,0,137.328,0,2001,2,27,333,184,0.782094891090694,-10.6,19.1659340659341,157,1085.66300204254,-1.4594182131461
23258,526670.731,5348597.828,113,94,19,53.43,2,2002,2,92,348,234,0.80896447667506,6.29999999999999,19.1637362637363,142,1085.66300204254,-1.4594182131461
23258,526670.731,5348597.828,155,101,54,44.809,6,2003,1,97,341,162,0.751868975705265,-207.1,23.9516483516484,65,1085.66300204254,-1.4594182131461
23258,526670.731,5348597.828,160,93,67,40.324,0,2004,2,107,340,208,0.794541895165978,109,18.7549450549451,101,1085.66300204254,-1.4594182131461
23258,526670.731,5348597.828,152,93,59,66.165,2,2005,2,87,312,184,0.834952702028439,-46.2,18.9098901098901,97,1085.66300204254,-1.4594182131461
23258,526670.731,5348597.828,194,61,133,30.118,0,2006,3,121,347,241,0.796573263984663,29.4,19.8868131868132,120,1085.66300204254,-1.4594182131461
23258,526670.731,5348597.828,0,0,0,91.063,0,2007,0,53,308,162,0.83979124829503,236.4,18.0659340659341,109,1085.66300204254,-1.4594182131461
23258,526670.731,5348597.828,100,63,37,50.726,3,2008,2,98,302,176,0.840099309418275,13.4,18.4934065934066,78,1085.66300204254,-1.4594182131461
23258,526670.731,5348597.828,165,54,111,46.73,0,2009,3,94,318,201,0.837933203482844,14,19.4461538461538,107,1085.66300204254,-1.4594182131461
23258,526670.731,5348597.828,149,83,66,40.331,0,2010,3,103,305,257,0.796080475872241,69.3,19.1879120879121,154,1085.66300204254,-1.4594182131461
23258,526670.731,5348597.828,81,53,28,67.905,10,2011,1,57,327,258,0.797489208344182,108.7,18.4846153846154,201,1085.66300204254,-1.4594182131461
23258,526670.731,5348597.828,143,82,61,70.008,4,2012,3,76,311,210,0.820833974956763,6.9,19.8923076923077,134,1085.66300204254,-1.4594182131461
23258,526670.731,5348597.828,171,93,78,44.046,0,2013,2,109,314,185,0.830383451017475,-187.7,20.2681318681319,76,1085.66300204254,-1.4594182131461
23258,526670.731,5348597.828,133,57,76,55.647,3,2014,5,78,344,249,0.842669942672627,71,18.9736263736264,171,1085.66300204254,-1.4594182131461
23258,526670.731,5348597.828,165,93,72,51.584,2,2015,1,96,340,161,0.835438947426172,-210.3,22.0318681318681,65,1085.66300204254,-1.4594182131461
23258,526670.731,5348597.828,162,95,67,56.391,4,2016,1,98,343,176,0.854155851319428,-28.3,20.1868131868132,78,1085.66300204254,-1.4594182131461
23258,526670.731,5348597.828,0,0,0,65.77,0,2017,0,74,321,169,0.851070915315615,-67,20.9692307692308,95,1085.66300204254,-1.4594182131461
23258,526670.731,5348597.828,168,73,95,50.25,0,2018,2,94,325,169,0.819606587549053,-134,21.621978021978,75,1085.66300204254,-1.4594182131461
23258,526670.731,5348597.828,150,94,56,50.604,6,2019,1,96,330,162,0.814655919553928,-110.8,21.721978021978,66,1085.66300204254,-1.4594182131461
23258,526670.731,5348597.828,0,0,0,118.123,0,2020,0,21,322,176,0.790513254704264,-108.6,20.0032967032967,155,1085.66300204254,-1.4594182131461
23347,526670.731,5327980.412,0,0,0,50.516,0,2001,2,103,310,185,0.904198917172477,10.6,17.710989010989,82,1162.92941360156,-1.42211308872832
23347,526670.731,5327980.412,150,74,76,29.025,0,2002,3,122,289,185,0.870311791678302,25.6,17.9494505494505,63,1162.92941360156,-1.42211308872832
23347,526670.731,5327980.412,157,56,101,38.332,1,2003,2,108,317,168,0.892811189851585,-201.3,22.6626373626374,60,1162.92941360156,-1.42211308872832
23347,526670.731,5327980.412,164,94,70,30.971,0,2004,2,119,327,194,0.856666577939973,132.4,17.5076923076923,75,1162.92941360156,-1.42211308872832
23347,526670.731,5327980.412,152,98,54,48.099,0,2005,1,106,312,170,0.888949233149068,-23.3,17.6,64,1162.92941360156,-1.42211308872832
23347,526670.731,5327980.412,199,93,106,20.54,1,2006,1,133,323,177,0.873153997731279,50,18.6131868131868,44,1162.92941360156,-1.42211308872832
23347,526670.731,5327980.412,166,131,35,41.315,0,2007,1,101,295,216,0.850486234347226,269.6,16.9021978021978,115,1162.92941360156,-1.42211308872832
23347,526670.731,5327980.412,86,57,29,26.938,0,2008,1,120,310,177,0.899635854627336,38,17.3098901098901,57,1162.92941360156,-1.42211308872832
23347,526670.731,5327980.412,183,61,122,27.077,0,2009,2,120,313,161,0.888307275973597,34.6,18.2571428571429,41,1162.92941360156,-1.42211308872832
23347,526670.731,5327980.412,165,93,72,31.094,0,2010,1,118,311,178,0.878679844752036,95.1,17.9945054945055,60,1162.92941360156,-1.42211308872832
23347,526670.731,5327980.412,86,71,15,40.971,0,2011,1,93,317,161,0.862065339375377,139.3,17.1164835164835,68,1162.92941360156,-1.42211308872832
23347,526670.731,5327980.412,148,96,52,47.637,2,2012,1,106,315,185,0.879333383785733,38.5,18.2296703296703,79,1162.92941360156,-1.42211308872832
23347,526670.731,5327980.412,179,78,101,25.144,1,2013,3,129,296,233,0.841199395254953,-164.8,18.7813186813187,104,1162.92941360156,-1.42211308872832
23347,526670.731,5327980.412,144,47,97,37.93,3,2014,2,105,336,177,0.861939796884262,101.8,17.4461538461538,72,1162.92941360156,-1.42211308872832
23347,526670.731,5327980.412,162,93,69,37.452,0,2015,2,112,338,232,0.835679301443925,-192.4,20.4978021978022,120,1162.92941360156,-1.42211308872832
23347,526670.731,5327980.412,171,93,78,30.993,0,2016,1,123,333,177,0.907766662056077,-4.8,18.6318681318681,54,1162.92941360156,-1.42211308872832
23347,526670.731,5327980.412,0,0,0,32.877,0,2017,0,114,312,170,0.862049251038711,-54.4,19.6516483516484,56,1162.92941360156,-1.42211308872832
23347,526670.731,5327980.412,159,93,66,37.754,0,2018,1,109,311,160,0.902821374485625,-121.8,20.367032967033,51,1162.92941360156,-1.42211308872832
23347,526670.731,5327980.412,138,82,56,27.154,3,2019,2,123,324,169,0.866415099674551,-107,20.478021978022,46,1162.92941360156,-1.42211308872832
23347,526670.731,5327980.412,0,0,0,32.974,0,2020,0,104,307,240,0.812266444438069,-91.9,18.7142857142857,136,1162.92941360156,-1.42211308872832
23349,526670.731,5327517.099,86,86,0,38.245,0,2001,2,114,296,176,0.881018458313694,10.6,17.710989010989,62,1209.44708714589,0.724998388848865
23349,526670.731,5327517.099,112,70,42,29.976,0,2002,2,121,300,178,0.864084834132943,25.6,17.9494505494505,57,1209.44708714589,0.724998388848865
23349,526670.731,5327517.099,161,74,87,32.076,0,2003,2,115,303,161,0.884452229318154,-201.3,22.6626373626374,46,1209.44708714589,0.724998388848865
23349,526670.731,5327517.099,183,147,36,30.061,0,2004,1,120,321,186,0.867307111636941,132.4,17.5076923076923,66,1209.44708714589,0.724998388848865
23349,526670.731,5327517.099,0,0,0,39.356,0,2005,0,114,304,170,0.896528734076109,-23.3,17.6,56,1209.44708714589,0.724998388848865
23349,526670.731,5327517.099,181,63,118,36.102,2,2006,2,118,331,178,0.883397863252262,50,18.6131868131868,60,1209.44708714589,0.724998388848865
23349,526670.731,5327517.099,167,95,72,43.119,0,2007,2,99,300,185,0.850057002960237,269.6,16.9021978021978,86,1209.44708714589,0.724998388848865
23349,526670.731,5327517.099,0,0,0,23.924,0,2008,0,123,307,169,0.880348294369593,38,17.3098901098901,46,1209.44708714589,0.724998388848865
23349,526670.731,5327517.099,170,69,101,35.357,0,2009,2,111,305,162,0.898431017884787,34.6,18.2571428571429,51,1209.44708714589,0.724998388848865
23349,526670.731,5327517.099,171,127,44,28.491,0,2010,1,121,307,177,0.882743337892376,95.1,17.9945054945055,56,1209.44708714589,0.724998388848865
23349,526670.731,5327517.099,0,0,0,36.288,0,2011,0,98,321,225,0.808943863076189,139.3,17.1164835164835,127,1209.44708714589,0.724998388848865
23349,526670.731,5327517.099,143,93,50,35.503,0,2012,2,118,310,194,0.835547034135991,38.5,18.2296703296703,76,1209.44708714589,0.724998388848865
23349,526670.731,5327517.099,180,75,105,29.446,1,2013,2,125,302,177,0.89480625749598,-164.8,18.7813186813187,52,1209.44708714589,0.724998388848865
23349,526670.731,5327517.099,138,58,80,35.904,1,2014,3,108,333,185,0.881203770002297,101.8,17.4461538461538,77,1209.44708714589,0.724998388848865
23349,526670.731,5327517.099,150,93,57,40.997,0,2015,1,108,307,153,0.833054369464014,-192.4,20.4978021978022,45,1209.44708714589,0.724998388848865
23349,526670.731,5327517.099,172,131,41,35.317,1,2016,1,119,321,169,0.868405751095156,-4.8,18.6318681318681,50,1209.44708714589,0.724998388848865
23349,526670.731,5327517.099,157,103,54,40.558,7,2017,1,104,306,162,0.863107439608456,-54.4,19.6516483516484,58,1209.44708714589,0.724998388848865
23349,526670.731,5327517.099,150,93,57,52.727,0,2018,1,96,311,153,0.893053360182294,-121.8,20.367032967033,57,1209.44708714589,0.724998388848865
23349,526670.731,5327517.099,150,93,57,30.758,3,2019,1,119,329,162,0.855287866514446,-107,20.478021978022,43,1209.44708714589,0.724998388848865
23349,526670.731,5327517.099,0,0,0,30.885,0,2020,0,107,305,162,0.802400701874713,-91.9,18.7142857142857,55,1209.44708714589,0.724998388848865
23475,526902.387,5349061.14,0,0,0,85.183,0,2001,2,73,306,208,0.837353847043952,-10.6,19.1659340659341,135,1098.21356308513,-0.133982686142417
23475,526902.387,5349061.14,116,75,41,41.434,0,2002,3,106,318,186,0.849925805381577,6.29999999999999,19.1637362637363,80,1098.21356308513,-0.133982686142417
23475,526902.387,5349061.14,156,93,63,43.911,5,2003,2,98,336,192,0.787862342411052,-207.1,23.9516483516484,94,1098.21356308513,-0.133982686142417
23475,526902.387,5349061.14,154,93,61,40.324,0,2004,2,107,341,201,0.840279478707514,109,18.7549450549451,94,1098.21356308513,-0.133982686142417
23475,526902.387,5349061.14,154,93,61,57.235,2,2005,2,96,317,177,0.849921005703427,-46.2,18.9098901098901,81,1098.21356308513,-0.133982686142417
23475,526902.387,5349061.14,194,66,128,31.026,0,2006,2,120,346,170,0.833879926328452,29.4,19.8868131868132,50,1098.21356308513,-0.133982686142417
23475,526902.387,5349061.14,0,0,0,44.134,0,2007,0,96,305,153,0.843683456895177,236.4,18.0659340659341,57,1098.21356308513,-0.133982686142417
23475,526902.387,5349061.14,109,73,36,65.95,7,2008,3,84,318,225,0.83246100435852,13.4,18.4934065934066,141,1098.21356308513,-0.133982686142417
23475,526902.387,5349061.14,168,69,99,40.855,0,2009,3,100,321,241,0.837149287215358,14,19.4461538461538,141,1098.21356308513,-0.133982686142417
23475,526902.387,5349061.14,162,96,66,35.664,0,2010,1,108,308,162,0.821760811303234,69.3,19.1879120879121,54,1098.21356308513,-0.133982686142417
23475,526902.387,5349061.14,0,0,0,56.947,0,2011,0,69,325,257,0.813376129822199,108.7,18.4846153846154,188,1098.21356308513,-0.133982686142417
23475,526902.387,5349061.14,153,93,60,52.541,3,2012,2,97,314,209,0.828860181936555,6.9,19.8923076923077,112,1098.21356308513,-0.133982686142417
23475,526902.387,5349061.14,177,63,114,44.046,0,2013,3,109,308,249,0.835273765630759,-187.7,20.2681318681319,140,1098.21356308513,-0.133982686142417
23475,526902.387,5349061.14,93,63,30,54.84,3,2014,2,79,335,129,0.870430585992062,71,18.9736263736264,50,1098.21356308513,-0.133982686142417
23475,526902.387,5349061.14,155,93,62,52.737,3,2015,2,95,324,250,0.806534993803333,-210.3,22.0318681318681,155,1098.21356308513,-0.133982686142417
23475,526902.387,5349061.14,167,93,74,61.312,4,2016,2,93,350,225,0.859044973750689,-28.3,20.1868131868132,132,1098.21356308513,-0.133982686142417
23475,526902.387,5349061.14,130,95,35,57.363,6,2017,2,82,304,218,0.8195958986276,-67,20.9692307692308,136,1098.21356308513,-0.133982686142417
23475,526902.387,5349061.14,180,70,110,42.897,0,2018,2,101,323,185,0.816258182896481,-134,21.621978021978,84,1098.21356308513,-0.133982686142417
23475,526902.387,5349061.14,0,0,0,40.277,0,2019,0,107,327,170,0.822603755507489,-110.8,21.721978021978,63,1098.21356308513,-0.133982686142417
23475,526902.387,5349061.14,0,0,0,48.52,0,2020,0,82,347,162,0.788782378164479,-108.6,20.0032967032967,80,1098.21356308513,-0.133982686142417
23476,526902.387,5348829.484,0,0,0,133.82,0,2001,2,30,327,193,0.817988904169001,-10.6,19.1659340659341,163,1115.62719661717,0.686065120927397
23476,526902.387,5348829.484,120,63,57,46.383,1,2002,3,100,339,185,0.822365717433731,6.29999999999999,19.1637362637363,85,1115.62719661717,0.686065120927397
23476,526902.387,5348829.484,162,93,69,38.671,1,2003,1,104,332,162,0.805952692266205,-207.1,23.9516483516484,58,1115.62719661717,0.686065120927397
23476,526902.387,5348829.484,161,93,68,41.282,0,2004,2,106,335,226,0.803599383701817,109,18.7549450549451,120,1115.62719661717,0.686065120927397
23476,526902.387,5348829.484,158,108,50,55.241,2,2005,2,98,314,240,0.800769444888466,-46.2,18.9098901098901,142,1115.62719661717,0.686065120927397
23476,526902.387,5348829.484,185,65,120,53.428,2,2006,2,99,344,170,0.814459226637021,29.4,19.8868131868132,71,1115.62719661717,0.686065120927397
23476,526902.387,5348829.484,0,0,0,61.718,0,2007,0,79,302,170,0.82132435295567,236.4,18.0659340659341,91,1115.62719661717,0.686065120927397
23476,526902.387,5348829.484,101,59,42,61.803,4,2008,2,88,315,162,0.847047812049159,13.4,18.4934065934066,74,1115.62719661717,0.686065120927397
23476,526902.387,5348829.484,169,64,105,40.855,0,2009,3,100,317,240,0.826228809284521,14,19.4461538461538,140,1115.62719661717,0.686065120927397
23476,526902.387,5348829.484,168,93,75,34.78,0,2010,2,109,307,248,0.80145653173473,69.3,19.1879120879121,139,1115.62719661717,0.686065120927397
23476,526902.387,5348829.484,86,54,32,49.372,3,2011,1,78,325,249,0.797886973426918,108.7,18.4846153846154,171,1115.62719661717,0.686065120927397
23476,526902.387,5348829.484,148,82,66,53.294,3,2012,3,96,307,210,0.834166708291283,6.9,19.8923076923077,114,1115.62719661717,0.686065120927397
23476,526902.387,5348829.484,176,93,83,42.077,0,2013,1,111,307,178,0.818418853704686,-187.7,20.2681318681319,67,1115.62719661717,0.686065120927397
23476,526902.387,5348829.484,138,52,86,46.64,0,2014,3,89,328,201,0.918869643544184,71,18.9736263736264,112,1115.62719661717,0.686065120927397
23476,526902.387,5348829.484,163,93,70,50.462,1,2015,1,97,339,152,0.818511255552079,-210.3,22.0318681318681,55,1115.62719661717,0.686065120927397
23476,526902.387,5348829.484,169,97,72,56.391,4,2016,1,98,340,178,0.845745130547877,-28.3,20.1868131868132,80,1115.62719661717,0.686065120927397
23476,526902.387,5348829.484,133,98,35,49.487,6,2017,1,90,305,169,0.818670239327155,-67,20.9692307692308,79,1115.62719661717,0.686065120927397
23476,526902.387,5348829.484,169,61,108,44.913,0,2018,2,99,319,153,0.816516695332511,-134,21.621978021978,54,1115.62719661717,0.686065120927397
23476,526902.387,5348829.484,152,80,72,44.941,6,2019,2,102,328,168,0.810946018821794,-110.8,21.721978021978,66,1115.62719661717,0.686065120927397
23476,526902.387,5348829.484,0,0,0,56.762,0,2020,0,74,318,170,0.811488462844914,-108.6,20.0032967032967,96,1115.62719661717,0.686065120927397
23477,526902.387,5348597.828,0,0,0,139.581,0,2001,1,25,308,193,0.811571028729976,-10.6,19.1659340659341,168,1095.20527527501,1.26876237384202
23477,526902.387,5348597.828,119,54,65,48.899,2,2002,3,97,341,185,0.81870474785916,6.29999999999999,19.1637362637363,88,1095.20527527501,1.26876237384202
23477,526902.387,5348597.828,163,93,70,42.145,3,2003,1,100,336,177,0.804055841780233,-207.1,23.9516483516484,77,1095.20527527501,1.26876237384202
23477,526902.387,5348597.828,162,99,63,40.324,0,2004,2,107,340,225,0.810532083082628,109,18.7549450549451,118,1095.20527527501,1.26876237384202
23477,526902.387,5348597.828,157,106,51,59.097,2,2005,2,94,313,232,0.799262845590186,-46.2,18.9098901098901,138,1095.20527527501,1.26876237384202
23477,526902.387,5348597.828,195,63,132,29.225,0,2006,2,122,347,176,0.807292626581288,29.4,19.8868131868132,54,1095.20527527501,1.26876237384202
23477,526902.387,5348597.828,0,0,0,89.019,0,2007,0,55,301,169,0.825491799278115,236.4,18.0659340659341,114,1095.20527527501,1.26876237384202
23477,526902.387,5348597.828,96,58,38,48.669,1,2008,2,100,315,170,0.839683177929254,13.4,18.4934065934066,70,1095.20527527501,1.26876237384202
23477,526902.387,5348597.828,167,63,104,46.73,0,2009,3,94,323,232,0.813082887772714,14,19.4461538461538,138,1095.20527527501,1.26876237384202
23477,526902.387,5348597.828,168,93,75,34.78,0,2010,2,109,306,185,0.788912803858631,69.3,19.1879120879121,76,1095.20527527501,1.26876237384202
23477,526902.387,5348597.828,93,55,38,55.251,3,2011,3,71,324,192,0.774829971731386,108.7,18.4846153846154,121,1095.20527527501,1.26876237384202
23477,526902.387,5348597.828,151,82,69,54.776,3,2012,3,94,304,201,0.807784213470742,6.9,19.8923076923077,107,1095.20527527501,1.26876237384202
23477,526902.387,5348597.828,175,97,78,43.057,0,2013,1,110,305,185,0.809713321497655,-187.7,20.2681318681319,75,1095.20527527501,1.26876237384202
23477,526902.387,5348597.828,83,50,33,108.222,18,2014,1,27,320,194,0.965857345556308,71,18.9736263736264,167,1095.20527527501,1.26876237384202
23477,526902.387,5348597.828,162,94,68,56.224,4,2015,1,92,339,154,0.815975659753427,-210.3,22.0318681318681,62,1095.20527527501,1.26876237384202
23477,526902.387,5348597.828,171,93,78,55.379,4,2016,2,99,342,186,0.852049106647015,-28.3,20.1868131868132,87,1095.20527527501,1.26876237384202
23477,526902.387,5348597.828,131,97,34,53.259,6,2017,1,86,308,177,0.82131850084047,-67,20.9692307692308,91,1095.20527527501,1.26876237384202
23477,526902.387,5348597.828,157,62,95,91.899,9,2018,2,55,323,177,0.822436135535525,-134,21.621978021978,122,1095.20527527501,1.26876237384202
23477,526902.387,5348597.828,146,80,66,56.908,8,2019,2,89,330,170,0.80980708411104,-110.8,21.721978021978,81,1095.20527527501,1.26876237384202
23477,526902.387,5348597.828,0,0,0,118.123,0,2020,0,21,323,177,0.799629960276388,-108.6,20.0032967032967,156,1095.20527527501,1.26876237384202
23544,526902.387,5333076.852,86,83,3,62.07,9,2001,3,93,310,186,0.841111675886148,10.6,17.710989010989,93,1236.67931756038,1.01857136783022
23544,526902.387,5333076.852,115,75,40,34.584,0,2002,3,116,316,249,0.802081556376441,25.6,17.9494505494505,133,1236.67931756038,1.01857136783022
23544,526902.387,5333076.852,162,93,69,32.076,0,2003,1,115,328,169,0.843706708650944,-201.3,22.6626373626374,54,1236.67931756038,1.01857136783022
23544,526902.387,5333076.852,158,94,64,45.212,0,2004,2,105,340,306,0.830395746294791,132.4,17.5076923076923,201,1236.67931756038,1.01857136783022
23544,526902.387,5333076.852,153,96,57,56.203,2,2005,2,99,315,193,0.822236346412198,-23.3,17.6,94,1236.67931756038,1.01857136783022
23544,526902.387,5333076.852,183,94,89,57.606,4,2006,1,101,341,177,0.8324189544522,50,18.6131868131868,76,1236.67931756038,1.01857136783022
23544,526902.387,5333076.852,0,0,0,37.937,0,2007,0,105,322,193,0.851594646774269,269.6,16.9021978021978,88,1236.67931756038,1.01857136783022
23544,526902.387,5333076.852,0,0,0,25.916,0,2008,0,121,308,184,0.845645420756503,38,17.3098901098901,63,1236.67931756038,1.01857136783022
23544,526902.387,5333076.852,165,76,89,30.564,0,2009,2,116,305,177,0.871901964255082,34.6,18.2571428571429,61,1236.67931756038,1.01857136783022
23544,526902.387,5333076.852,177,63,114,29.343,0,2010,2,120,310,170,0.829049627043673,95.1,17.9945054945055,50,1236.67931756038,1.01857136783022
23544,526902.387,5333076.852,86,71,15,45.856,0,2011,1,88,326,170,0.791259738981541,139.3,17.1164835164835,82,1236.67931756038,1.01857136783022
23544,526902.387,5333076.852,150,82,68,44.886,0,2012,3,109,309,194,0.870525074856362,38.5,18.2296703296703,85,1236.67931756038,1.01857136783022
23544,526902.387,5333076.852,181,62,119,11.908,1,2013,3,142,296,242,0.856350361210252,-164.8,18.7813186813187,100,1236.67931756038,1.01857136783022
23544,526902.387,5333076.852,150,46,104,45.374,3,2014,2,95,351,137,0.853548563146469,101.8,17.4461538461538,42,1236.67931756038,1.01857136783022
23544,526902.387,5333076.852,157,93,64,53.284,2,2015,1,96,346,169,0.850657131919382,-192.4,20.4978021978022,73,1236.67931756038,1.01857136783022
23544,526902.387,5333076.852,163,93,70,43.922,5,2016,2,111,338,226,0.823413503657518,-4.8,18.6318681318681,115,1236.67931756038,1.01857136783022
23544,526902.387,5333076.852,143,94,49,48.06,7,2017,1,95,307,178,0.823518347368533,-54.4,19.6516483516484,83,1236.67931756038,1.01857136783022
23544,526902.387,5333076.852,167,62,105,36.723,0,2018,3,110,348,193,0.808725281055404,-121.8,20.367032967033,83,1236.67931756038,1.01857136783022
23544,526902.387,5333076.852,147,93,54,36.079,3,2019,2,113,338,185,0.845757584603668,-107,20.478021978022,72,1236.67931756038,1.01857136783022
23544,526902.387,5333076.852,0,0,0,59.738,0,2020,0,75,313,193,0.801113367267566,-91.9,18.7142857142857,118,1236.67931756038,1.01857136783022
23568,526902.387,5327517.099,0,0,0,47.118,0,2001,3,106,298,170,0.865024505616518,10.6,17.710989010989,64,1159.67765752094,-1.4302232864407
23568,526902.387,5327517.099,93,68,25,30.897,0,2002,2,120,317,178,0.857423946320504,25.6,17.9494505494505,58,1159.67765752094,-1.4302232864407
23568,526902.387,5327517.099,163,76,87,34.805,0,2003,2,112,295,161,0.862126305499391,-201.3,22.6626373626374,49,1159.67765752094,-1.4302232864407
23568,526902.387,5327517.099,174,63,111,32.816,0,2004,2,117,325,178,0.84734672626962,132.4,17.5076923076923,61,1159.67765752094,-1.4302232864407
23568,526902.387,5327517.099,154,101,53,44.83,0,2005,1,109,304,169,0.88006820674136,-23.3,17.6,60,1159.67765752094,-1.4302232864407
23568,526902.387,5327517.099,191,65,126,36.102,2,2006,2,118,326,170,0.852215026288519,50,18.6131868131868,52,1159.67765752094,-1.4302232864407
23568,526902.387,5327517.099,0,0,0,45.967,0,2007,0,96,294,178,0.874143342424642,269.6,16.9021978021978,82,1159.67765752094,-1.4302232864407
23568,526902.387,5327517.099,84,55,29,23.924,0,2008,1,123,306,177,0.855738284404901,38,17.3098901098901,54,1159.67765752094,-1.4302232864407
23568,526902.387,5327517.099,180,62,118,35.357,0,2009,2,111,304,169,0.906549822959879,34.6,18.2571428571429,58,1159.67765752094,-1.4302232864407
23568,526902.387,5327517.099,175,93,82,29.343,0,2010,2,120,305,177,0.870637538825642,95.1,17.9945054945055,57,1159.67765752094,-1.4302232864407
23568,526902.387,5327517.099,84,67,17,38.118,0,2011,1,96,317,162,0.831763280029147,139.3,17.1164835164835,66,1159.67765752094,-1.4302232864407
23568,526902.387,5327517.099,154,93,61,43.011,0,2012,1,111,299,169,0.873862055480789,38.5,18.2296703296703,58,1159.67765752094,-1.4302232864407
23568,526902.387,5327517.099,182,69,113,22.086,1,2013,2,132,298,185,0.872826001999783,-164.8,18.7813186813187,53,1159.67765752094,-1.4302232864407
23568,526902.387,5327517.099,150,47,103,39.329,3,2014,2,103,337,170,0.856167672671515,101.8,17.4461538461538,67,1159.67765752094,-1.4302232864407
23568,526902.387,5327517.099,152,93,59,44.708,0,2015,1,104,317,145,0.786036325123942,-192.4,20.4978021978022,41,1159.67765752094,-1.4302232864407
23568,526902.387,5327517.099,169,104,65,42.788,5,2016,1,112,323,170,0.835645474600172,-4.8,18.6318681318681,58,1159.67765752094,-1.4302232864407
23568,526902.387,5327517.099,142,93,49,36.707,6,2017,1,109,312,168,0.849666332902844,-54.4,19.6516483516484,59,1159.67765752094,-1.4302232864407
23568,526902.387,5327517.099,158,71,87,46.75,0,2018,2,101,311,153,0.894106979569688,-121.8,20.367032967033,52,1159.67765752094,-1.4302232864407
23568,526902.387,5327517.099,153,94,59,28.928,3,2019,1,121,328,162,0.850372409730963,-107,20.478021978022,41,1159.67765752094,-1.4302232864407
23568,526902.387,5327517.099,0,0,0,30.218,0,2020,0,108,303,169,0.815808065930798,-91.9,18.7142857142857,61,1159.67765752094,-1.4302232864407
23569,526902.387,5327285.443,0,0,0,43.733,0,2001,1,109,296,177,0.886531209321015,10.6,17.710989010989,68,1182.45070254466,-0.56836997636554
23569,526902.387,5327285.443,93,66,27,32.753,0,2002,2,118,307,177,0.859759002240917,25.6,17.9494505494505,59,1182.45070254466,-0.56836997636554
23569,526902.387,5327285.443,163,73,90,35.696,0,2003,2,111,292,161,0.860025763849005,-201.3,22.6626373626374,50,1182.45070254466,-0.56836997636554
23569,526902.387,5327285.443,166,63,103,42.01,0,2004,2,108,318,185,0.84879993153979,132.4,17.5076923076923,77,1182.45070254466,-0.56836997636554
23569,526902.387,5327285.443,151,112,39,40.416,0,2005,1,113,301,170,0.85922000432734,-23.3,17.6,57,1182.45070254466,-0.56836997636554
23569,526902.387,5327285.443,190,63,127,51.052,2,2006,2,106,329,162,0.861618148740122,50,18.6131868131868,56,1182.45070254466,-0.56836997636554
23569,526902.387,5327285.443,0,0,0,41.315,0,2007,0,101,299,178,0.867042889046846,269.6,16.9021978021978,77,1182.45070254466,-0.56836997636554
23569,526902.387,5327285.443,84,56,28,21.09,0,2008,1,126,303,177,0.842124863854846,38,17.3098901098901,51,1182.45070254466,-0.56836997636554
23569,526902.387,5327285.443,179,63,116,42.89,0,2009,2,104,306,162,0.90623265656086,34.6,18.2571428571429,58,1182.45070254466,-0.56836997636554
23569,526902.387,5327285.443,170,93,77,29.343,0,2010,1,120,304,178,0.869222339947205,95.1,17.9945054945055,58,1182.45070254466,-0.56836997636554
23569,526902.387,5327285.443,84,66,18,35.406,0,2011,1,99,317,153,0.81399845333535,139.3,17.1164835164835,54,1182.45070254466,-0.56836997636554
23569,526902.387,5327285.443,153,93,60,43.951,0,2012,1,110,304,161,0.848743974674577,38.5,18.2296703296703,51,1182.45070254466,-0.56836997636554
23569,526902.387,5327285.443,177,69,108,29.446,1,2013,2,125,296,177,0.866498453902291,-164.8,18.7813186813187,52,1182.45070254466,-0.56836997636554
23569,526902.387,5327285.443,150,44,106,40.046,3,2014,2,102,336,168,0.86260550735156,101.8,17.4461538461538,66,1182.45070254466,-0.56836997636554
23569,526902.387,5327285.443,156,93,63,40.081,0,2015,1,109,296,153,0.823795968592785,-192.4,20.4978021978022,44,1182.45070254466,-0.56836997636554
23569,526902.387,5327285.443,168,100,68,42.788,5,2016,1,112,320,169,0.80661010359382,-4.8,18.6318681318681,57,1182.45070254466,-0.56836997636554
23569,526902.387,5327285.443,142,93,49,35.924,5,2017,1,110,310,169,0.855789600146216,-54.4,19.6516483516484,59,1182.45070254466,-0.56836997636554
23569,526902.387,5327285.443,160,71,89,45.596,0,2018,2,102,312,153,0.894596482332814,-121.8,20.367032967033,51,1182.45070254466,-0.56836997636554
23569,526902.387,5327285.443,157,102,55,30.758,3,2019,1,119,331,162,0.840715260287576,-107,20.478021978022,43,1182.45070254466,-0.56836997636554
23569,526902.387,5327285.443,0,0,0,30.885,0,2020,0,107,299,168,0.826018519065646,-91.9,18.7142857142857,61,1182.45070254466,-0.56836997636554
23570,526902.387,5327053.786,0,0,0,34.934,0,2001,1,117,317,177,0.850100295593911,10.6,17.710989010989,60,1204.82242289891,-1.43804808892394
23570,526902.387,5327053.786,93,93,0,26.91,0,2002,2,124,293,193,0.851403420441025,25.6,17.9494505494505,69,1204.82242289891,-1.43804808892394
23570,526902.387,5327053.786,161,93,68,32.076,0,2003,1,115,292,161,0.862860758262687,-201.3,22.6626373626374,46,1204.82242289891,-1.43804808892394
23570,526902.387,5327053.786,170,102,68,24.673,0,2004,1,126,323,186,0.863040955338295,132.4,17.5076923076923,60,1204.82242289891,-1.43804808892394
23570,526902.387,5327053.786,0,0,0,34.985,0,2005,0,118,309,176,0.857887317454155,-23.3,17.6,58,1204.82242289891,-1.43804808892394
23570,526902.387,5327053.786,176,93,83,60.241,5,2006,1,99,328,169,0.864637475125103,50,18.6131868131868,70,1204.82242289891,-1.43804808892394
23570,526902.387,5327053.786,0,0,0,39.59,0,2007,0,103,295,202,0.824717489898502,269.6,16.9021978021978,99,1204.82242289891,-1.43804808892394
23570,526902.387,5327053.786,126,59,67,12.513,0,2008,3,137,295,193,0.801503632762545,38,17.3098901098901,56,1204.82242289891,-1.43804808892394
23570,526902.387,5327053.786,161,62,99,41.78,0,2009,2,105,299,170,0.907778118617017,34.6,18.2571428571429,65,1204.82242289891,-1.43804808892394
23570,526902.387,5327053.786,160,93,67,28.491,0,2010,2,121,301,185,0.869551842339597,95.1,17.9945054945055,64,1204.82242289891,-1.43804808892394
23570,526902.387,5327053.786,125,65,60,32.89,0,2011,2,102,313,153,0.797428801653351,139.3,17.1164835164835,51,1204.82242289891,-1.43804808892394
23570,526902.387,5327053.786,93,75,18,37.773,0,2012,3,116,309,185,0.833200756285333,38.5,18.2296703296703,69,1204.82242289891,-1.43804808892394
23570,526902.387,5327053.786,169,105,64,25.144,1,2013,1,129,300,177,0.869780671589921,-164.8,18.7813186813187,48,1204.82242289891,-1.43804808892394
23570,526902.387,5327053.786,116,83,33,38.624,3,2014,2,104,339,170,0.871592012023943,101.8,17.4461538461538,66,1204.82242289891,-1.43804808892394
23570,526902.387,5327053.786,93,93,0,38.306,0,2015,1,111,297,162,0.838025642394953,-192.4,20.4978021978022,51,1204.82242289891,-1.43804808892394
23570,526902.387,5327053.786,167,93,74,38.512,4,2016,1,116,322,178,0.899980396436377,-4.8,18.6318681318681,62,1204.82242289891,-1.43804808892394
23570,526902.387,5327053.786,140,93,47,32.144,3,2017,1,115,292,170,0.85520302288932,-54.4,19.6516483516484,55,1204.82242289891,-1.43804808892394
23570,526902.387,5327053.786,169,66,103,41.01,0,2018,2,106,308,160,0.842342706901877,-121.8,20.367032967033,54,1204.82242289891,-1.43804808892394
23570,526902.387,5327053.786,164,95,69,31.682,3,2019,1,118,333,168,0.843467138061661,-107,20.478021978022,50,1204.82242289891,-1.43804808892394
23570,526902.387,5327053.786,93,93,0,30.885,1,2020,1,107,300,169,0.821494381931016,-91.9,18.7142857142857,62,1204.82242289891,-1.43804808892394
23694,527134.043,5349061.14,0,0,0,82.54,0,2001,2,75,310,193,0.835564538029786,-10.6,19.1659340659341,118,1073.62612274589,1.38129205409175
23694,527134.043,5349061.14,108,76,32,69.431,7,2002,3,78,337,225,0.848534811315581,6.29999999999999,19.1637362637363,147,1073.62612274589,1.38129205409175
23694,527134.043,5349061.14,161,95,66,37.83,1,2003,2,105,340,193,0.817140611027771,-207.1,23.9516483516484,88,1073.62612274589,1.38129205409175
23694,527134.043,5349061.14,153,93,60,43.254,0,2004,2,104,343,192,0.846295400599184,109,18.7549450549451,88,1073.62612274589,1.38129205409175
23694,527134.043,5349061.14,152,93,59,61.036,2,2005,2,92,317,177,0.875638330337875,-46.2,18.9098901098901,85,1073.62612274589,1.38129205409175
23694,527134.043,5349061.14,185,65,120,51.034,1,2006,2,101,347,178,0.834908104520495,29.4,19.8868131868132,77,1073.62612274589,1.38129205409175
23694,527134.043,5349061.14,0,0,0,50.085,0,2007,0,90,306,160,0.85596284974666,236.4,18.0659340659341,70,1073.62612274589,1.38129205409175
23694,527134.043,5349061.14,110,74,36,71.382,12,2008,3,79,319,217,0.84123194897686,13.4,18.4934065934066,138,1073.62612274589,1.38129205409175
23694,527134.043,5349061.14,159,69,90,60.644,3,2009,3,82,326,240,0.82216494403344,14,19.4461538461538,158,1073.62612274589,1.38129205409175
23694,527134.043,5349061.14,162,93,69,41.304,0,2010,2,102,307,241,0.826000148553813,69.3,19.1879120879121,139,1073.62612274589,1.38129205409175
23694,527134.043,5349061.14,0,0,0,70.678,0,2011,0,54,325,257,0.808509215760769,108.7,18.4846153846154,203,1073.62612274589,1.38129205409175
23694,527134.043,5349061.14,151,93,58,51.054,3,2012,2,99,318,210,0.821565719010825,6.9,19.8923076923077,111,1073.62612274589,1.38129205409175
23694,527134.043,5349061.14,177,66,111,39.211,0,2013,3,114,305,249,0.828451318668548,-187.7,20.2681318681319,135,1073.62612274589,1.38129205409175
23694,527134.043,5349061.14,85,61,24,42.08,0,2014,1,95,331,296,0.791452697188063,71,18.9736263736264,201,1073.62612274589,1.38129205409175
23694,527134.043,5349061.14,159,93,66,42.491,0,2015,1,105,329,162,0.790825440527499,-210.3,22.0318681318681,57,1073.62612274589,1.38129205409175
23694,527134.043,5349061.14,167,93,74,58.412,4,2016,2,96,346,217,0.817507424112212,-28.3,20.1868131868132,121,1073.62612274589,1.38129205409175
23694,527134.043,5349061.14,133,93,40,49.487,6,2017,1,90,301,176,0.813270062292107,-67,20.9692307692308,86,1073.62612274589,1.38129205409175
23694,527134.043,5349061.14,180,70,110,40.939,0,2018,2,103,324,186,0.802693736074277,-134,21.621978021978,83,1073.62612274589,1.38129205409175
23694,527134.043,5349061.14,0,0,0,36.651,0,2019,0,111,328,177,0.810843244325651,-110.8,21.721978021978,66,1073.62612274589,1.38129205409175
23694,527134.043,5349061.14,0,0,0,35.421,0,2020,0,97,351,177,0.784292809897562,-108.6,20.0032967032967,80,1073.62612274589,1.38129205409175
23695,527134.043,5348829.484,0,0,0,144.702,0,2001,3,20,331,193,0.817168090155053,-10.6,19.1659340659341,173,1101.85555737209,0.30743337872808
23695,527134.043,5348829.484,119,65,54,48.899,2,2002,3,97,341,192,0.821797631924383,6.29999999999999,19.1637362637363,95,1101.85555737209,0.30743337872808
23695,527134.043,5348829.484,161,93,68,41.272,2,2003,1,101,337,169,0.818285817223942,-207.1,23.9516483516484,68,1101.85555737209,0.30743337872808
23695,527134.043,5348829.484,165,93,72,37.523,0,2004,2,110,339,224,0.844306016905772,109,18.7549450549451,114,1101.85555737209,0.30743337872808
23695,527134.043,5348829.484,157,103,54,56.3,2,2005,1,97,317,177,0.862364282983425,-46.2,18.9098901098901,80,1101.85555737209,0.30743337872808
23695,527134.043,5348829.484,184,66,118,55.857,3,2006,2,97,347,170,0.818260541685673,29.4,19.8868131868132,73,1101.85555737209,0.30743337872808
23695,527134.043,5348829.484,93,93,0,59.624,5,2007,1,81,301,177,0.820188596980383,236.4,18.0659340659341,96,1101.85555737209,0.30743337872808
23695,527134.043,5348829.484,101,58,43,60.682,3,2008,2,89,316,169,0.846324170299598,13.4,18.4934065934066,80,1101.85555737209,0.30743337872808
23695,527134.043,5348829.484,169,64,105,39.949,0,2009,2,101,323,153,0.818587661138467,14,19.4461538461538,52,1101.85555737209,0.30743337872808
23695,527134.043,5348829.484,167,93,74,38.427,0,2010,2,105,306,242,0.805487799906737,69.3,19.1879120879121,137,1101.85555737209,0.30743337872808
23695,527134.043,5348829.484,86,54,32,54.415,3,2011,1,72,324,225,0.802258881594103,108.7,18.4846153846154,153,1101.85555737209,0.30743337872808
23695,527134.043,5348829.484,148,82,66,50.316,2,2012,3,100,307,193,0.838853157867792,6.9,19.8923076923077,93,1101.85555737209,0.30743337872808
23695,527134.043,5348829.484,176,93,83,42.077,0,2013,1,111,306,178,0.818666408331544,-187.7,20.2681318681319,67,1101.85555737209,0.30743337872808
23695,527134.043,5348829.484,135,52,83,51.613,3,2014,5,83,326,201,0.805601113080295,71,18.9736263736264,118,1101.85555737209,0.30743337872808
23695,527134.043,5348829.484,168,106,62,43.404,0,2015,1,104,340,153,0.818418726008828,-210.3,22.0318681318681,49,1101.85555737209,0.30743337872808
23695,527134.043,5348829.484,169,100,69,56.391,4,2016,1,98,345,185,0.842378319460726,-28.3,20.1868131868132,87,1101.85555737209,0.30743337872808
23695,527134.043,5348829.484,132,94,38,47.717,6,2017,1,92,304,170,0.82401900156171,-67,20.9692307692308,78,1101.85555737209,0.30743337872808
23695,527134.043,5348829.484,169,61,108,43.902,0,2018,2,100,320,169,0.801564708142572,-134,21.621978021978,69,1101.85555737209,0.30743337872808
23695,527134.043,5348829.484,153,80,73,43.991,5,2019,2,103,325,177,0.820766006734256,-110.8,21.721978021978,74,1101.85555737209,0.30743337872808
23695,527134.043,5348829.484,0,0,0,117.188,0,2020,0,22,324,170,0.803397950439658,-108.6,20.0032967032967,148,1101.85555737209,0.30743337872808
23696,527134.043,5348597.828,0,0,0,139.581,0,2001,2,25,303,186,0.804453828217738,-10.6,19.1659340659341,161,1083.25799715344,-0.834405822879266
23696,527134.043,5348597.828,120,52,68,44.766,0,2002,3,102,343,241,0.80982256894568,6.29999999999999,19.1637362637363,139,1083.25799715344,-0.834405822879266
23696,527134.043,5348597.828,164,110,54,40.399,1,2003,1,102,333,169,0.806246568483603,-207.1,23.9516483516484,67,1083.25799715344,-0.834405822879266
23696,527134.043,5348597.828,165,101,64,34.749,0,2004,2,113,338,224,0.818828177613647,109,18.7549450549451,111,1083.25799715344,-0.834405822879266
23696,527134.043,5348597.828,153,94,59,62.037,2,2005,1,91,314,178,0.827580017919314,-46.2,18.9098901098901,87,1083.25799715344,-0.834405822879266
23696,527134.043,5348597.828,185,65,120,52.249,2,2006,2,100,346,170,0.804135387134113,29.4,19.8868131868132,70,1083.25799715344,-0.834405822879266
23696,527134.043,5348597.828,0,0,0,75.434,0,2007,0,66,299,170,0.821909073319952,236.4,18.0659340659341,104,1083.25799715344,-0.834405822879266
23696,527134.043,5348597.828,96,57,39,46.427,1,2008,3,102,314,185,0.82258634182719,13.4,18.4934065934066,83,1083.25799715344,-0.834405822879266
23696,527134.043,5348597.828,168,62,106,42.733,0,2009,2,98,325,154,0.80211037561676,14,19.4461538461538,56,1083.25799715344,-0.834405822879266
23696,527134.043,5348597.828,168,93,75,33.916,0,2010,2,110,308,234,0.786489568222394,69.3,19.1879120879121,124,1083.25799715344,-0.834405822879266
23696,527134.043,5348597.828,86,55,31,61.36,6,2011,1,64,325,209,0.787087268918592,108.7,18.4846153846154,145,1083.25799715344,-0.834405822879266
23696,527134.043,5348597.828,147,82,65,55.511,3,2012,3,93,304,185,0.829068271487928,6.9,19.8923076923077,92,1083.25799715344,-0.834405822879266
23696,527134.043,5348597.828,177,93,84,41.105,0,2013,2,112,306,185,0.817453114036509,-187.7,20.2681318681319,73,1083.25799715344,-0.834405822879266
23696,527134.043,5348597.828,86,52,34,110.303,20,2014,1,25,328,202,0.808102678608381,71,18.9736263736264,177,1083.25799715344,-0.834405822879266
23696,527134.043,5348597.828,162,94,68,55.068,4,2015,1,93,338,161,0.808428790047048,-210.3,22.0318681318681,68,1083.25799715344,-0.834405822879266
23696,527134.043,5348597.828,170,101,69,52.435,4,2016,2,102,342,193,0.855702447200215,-28.3,20.1868131868132,91,1083.25799715344,-0.834405822879266
23696,527134.043,5348597.828,131,99,32,56.308,6,2017,1,83,305,184,0.824670499582881,-67,20.9692307692308,101,1083.25799715344,-0.834405822879266
23696,527134.043,5348597.828,162,61,101,60.814,1,2018,2,84,321,177,0.81395941262958,-134,21.621978021978,93,1083.25799715344,-0.834405822879266
23696,527134.043,5348597.828,150,80,70,52.483,8,2019,2,94,325,177,0.812045779467003,-110.8,21.721978021978,83,1083.25799715344,-0.834405822879266
23696,527134.043,5348597.828,0,0,0,116.262,0,2020,0,23,322,184,0.794549769867352,-108.6,20.0032967032967,161,1083.25799715344,-0.834405822879266
23697,527134.043,5348366.171,0,0,0,136.143,0,2001,2,28,319,185,0.820564368436756,-10.6,19.1659340659341,157,1053.73460738546,-1.00594727803062
23697,527134.043,5348366.171,86,59,27,32.299,0,2002,1,117,341,240,0.806875428056852,6.29999999999999,19.1637362637363,123,1053.73460738546,-1.00594727803062
23697,527134.043,5348366.171,156,95,61,39.529,1,2003,1,103,321,177,0.791684440321983,-207.1,23.9516483516484,74,1053.73460738546,-1.00594727803062
23697,527134.043,5348366.171,157,94,63,43.254,0,2004,2,104,338,201,0.798284712663587,109,18.7549450549451,97,1053.73460738546,-1.00594727803062
23697,527134.043,5348366.171,175,93,82,56.3,2,2005,4,97,310,202,0.794982673847171,-46.2,18.9098901098901,105,1053.73460738546,-1.00594727803062
23697,527134.043,5348366.171,188,57,131,27.494,0,2006,2,124,345,178,0.807366883645707,29.4,19.8868131868132,54,1053.73460738546,-1.00594727803062
23697,527134.043,5348366.171,0,0,0,80.527,0,2007,0,62,304,169,0.83444898153868,236.4,18.0659340659341,107,1053.73460738546,-1.00594727803062
23697,527134.043,5348366.171,0,0,0,87.232,0,2008,0,65,310,193,0.791087597550696,13.4,18.4934065934066,128,1053.73460738546,-1.00594727803062
23697,527134.043,5348366.171,169,63,106,45.698,0,2009,2,95,325,185,0.835823260320479,14,19.4461538461538,90,1053.73460738546,-1.00594727803062
23697,527134.043,5348366.171,154,98,56,33.069,0,2010,2,111,305,201,0.812524588005295,69.3,19.1879120879121,90,1053.73460738546,-1.00594727803062
23697,527134.043,5348366.171,0,0,0,64.119,0,2011,0,61,324,186,0.806694188654441,108.7,18.4846153846154,125,1053.73460738546,-1.00594727803062
23697,527134.043,5348366.171,147,93,54,45.786,1,2012,1,106,302,178,0.845284542474436,6.9,19.8923076923077,72,1053.73460738546,-1.00594727803062
23697,527134.043,5348366.171,176,61,115,33.435,0,2013,3,120,305,194,0.826896838051783,-187.7,20.2681318681319,74,1053.73460738546,-1.00594727803062
23697,527134.043,5348366.171,86,55,31,91.607,10,2014,1,43,321,200,0.809384144573768,71,18.9736263736264,157,1053.73460738546,-1.00594727803062
23697,527134.043,5348366.171,154,80,74,47.279,0,2015,2,100,336,177,0.829176528306385,-210.3,22.0318681318681,77,1053.73460738546,-1.00594727803062
23697,527134.043,5348366.171,160,93,67,51.483,4,2016,2,103,337,186,0.861647369315609,-28.3,20.1868131868132,83,1053.73460738546,-1.00594727803062
23697,527134.043,5348366.171,0,0,0,60.553,0,2017,0,79,318,202,0.86677776609608,-67,20.9692307692308,123,1053.73460738546,-1.00594727803062
23697,527134.043,5348366.171,153,68,85,56.687,1,2018,3,88,318,185,0.818014616934826,-134,21.621978021978,97,1053.73460738546,-1.00594727803062
23697,527134.043,5348366.171,144,83,61,54.223,8,2019,2,92,341,185,0.811074990368301,-110.8,21.721978021978,93,1053.73460738546,-1.00594727803062
23697,527134.043,5348366.171,0,0,0,115.345,0,2020,0,24,342,192,0.78992540132859,-108.6,20.0032967032967,168,1053.73460738546,-1.00594727803062
23761,527134.043,5333540.164,81,81,0,60.967,9,2001,1,94,332,178,0.873497771552837,10.6,17.710989010989,84,1192.33435027184,-0.242644798745389
23761,527134.043,5333540.164,86,80,6,39.149,0,2002,1,111,319,241,0.822426596924851,25.6,17.9494505494505,130,1192.33435027184,-0.242644798745389
23761,527134.043,5333540.164,163,94,69,39.247,1,2003,1,107,289,169,0.858753879348613,-201.3,22.6626373626374,62,1192.33435027184,-0.242644798745389
23761,527134.043,5333540.164,163,34,129,40.964,0,2004,3,109,340,217,0.821375854542093,132.4,17.5076923076923,108,1192.33435027184,-0.242644798745389
23761,527134.043,5333540.164,146,109,37,60.785,2,2005,1,95,312,170,0.861217858450025,-23.3,17.6,75,1192.33435027184,-0.242644798745389
23761,527134.043,5333540.164,195,93,102,31.643,1,2006,1,122,341,178,0.85386621899724,50,18.6131868131868,56,1192.33435027184,-0.242644798745389
23761,527134.043,5333540.164,0,0,0,73.09,0,2007,0,70,313,193,0.851802523420389,269.6,16.9021978021978,123,1192.33435027184,-0.242644798745389
23761,527134.043,5333540.164,0,0,0,25.916,0,2008,0,121,304,170,0.874660601085158,38,17.3098901098901,49,1192.33435027184,-0.242644798745389
23761,527134.043,5333540.164,162,69,93,49.897,0,2009,3,98,304,192,0.860255361386099,34.6,18.2571428571429,94,1192.33435027184,-0.242644798745389
23761,527134.043,5333540.164,161,101,60,37.95,0,2010,2,111,311,216,0.869681868812561,95.1,17.9945054945055,105,1192.33435027184,-0.242644798745389
23761,527134.043,5333540.164,86,66,20,55.595,3,2011,1,78,331,177,0.800675985673814,139.3,17.1164835164835,99,1192.33435027184,-0.242644798745389
23761,527134.043,5333540.164,150,93,57,55.239,4,2012,2,97,318,201,0.841597753370245,38.5,18.2296703296703,104,1192.33435027184,-0.242644798745389
23761,527134.043,5333540.164,180,93,87,33.97,1,2013,2,121,307,209,0.839708178484007,-164.8,18.7813186813187,88,1192.33435027184,-0.242644798745389
23761,527134.043,5333540.164,154,85,69,44.582,3,2014,2,96,329,177,0.844332181290892,101.8,17.4461538461538,81,1192.33435027184,-0.242644798745389
23761,527134.043,5333540.164,160,98,62,46.702,0,2015,1,102,327,154,0.818277115275156,-192.4,20.4978021978022,52,1192.33435027184,-0.242644798745389
23761,527134.043,5333540.164,169,93,76,53.061,5,2016,1,103,338,177,0.84806114516202,-4.8,18.6318681318681,74,1192.33435027184,-0.242644798745389
23761,527134.043,5333540.164,123,94,29,52.814,7,2017,2,90,304,224,0.84162727270153,-54.4,19.6516483516484,134,1192.33435027184,-0.242644798745389
23761,527134.043,5333540.164,170,59,111,36.723,0,2018,3,110,346,200,0.816599968405664,-121.8,20.367032967033,90,1192.33435027184,-0.242644798745389
23761,527134.043,5333540.164,148,93,55,40.608,3,2019,1,108,340,170,0.853477772351021,-107,20.478021978022,62,1192.33435027184,-0.242644798745389
23761,527134.043,5333540.164,93,93,0,55.362,16,2020,1,79,317,178,0.829634352371912,-91.9,18.7142857142857,99,1192.33435027184,-0.242644798745389
23762,527134.043,5333308.508,0,0,0,59.854,0,2001,2,95,319,184,0.866277506661143,10.6,17.710989010989,89,1199.41937989664,-1.49504589714912
23762,527134.043,5333308.508,93,77,16,31.831,0,2002,3,119,314,250,0.816365751753408,25.6,17.9494505494505,131,1199.41937989664,-1.49504589714912
23762,527134.043,5333308.508,168,107,61,32.971,0,2003,1,114,323,168,0.852337352512266,-201.3,22.6626373626374,54,1199.41937989664,-1.49504589714912
23762,527134.043,5333308.508,164,46,118,37.808,0,2004,3,112,340,225,0.813737840058598,132.4,17.5076923076923,113,1199.41937989664,-1.49504589714912
23762,527134.043,5333308.508,150,97,53,56.203,2,2005,1,99,317,176,0.837262436116327,-23.3,17.6,77,1199.41937989664,-1.49504589714912
23762,527134.043,5333308.508,188,93,95,48.352,2,2006,1,108,340,178,0.845651904401707,50,18.6131868131868,70,1199.41937989664,-1.49504589714912
23762,527134.043,5333308.508,0,0,0,44.049,0,2007,0,98,311,200,0.846809312404592,269.6,16.9021978021978,102,1199.41937989664,-1.49504589714912
23762,527134.043,5333308.508,0,0,0,21.09,0,2008,0,126,310,217,0.840961864537166,38,17.3098901098901,91,1199.41937989664,-1.49504589714912
23762,527134.043,5333308.508,176,73,103,34.334,0,2009,2,112,302,170,0.872682527618399,34.6,18.2571428571429,58,1199.41937989664,-1.49504589714912
23762,527134.043,5333308.508,162,107,55,35.884,0,2010,1,113,314,184,0.846822270164892,95.1,17.9945054945055,71,1199.41937989664,-1.49504589714912
23762,527134.043,5333308.508,86,66,20,48.726,0,2011,1,85,328,146,0.788795983074301,139.3,17.1164835164835,61,1199.41937989664,-1.49504589714912
23762,527134.043,5333308.508,154,98,56,42.059,0,2012,2,112,319,209,0.829972095924095,38.5,18.2296703296703,97,1199.41937989664,-1.49504589714912
23762,527134.043,5333308.508,182,93,89,22.086,1,2013,2,132,306,193,0.840849217634685,-164.8,18.7813186813187,61,1199.41937989664,-1.49504589714912
23762,527134.043,5333308.508,157,82,75,40.775,3,2014,2,101,327,176,0.823913986326418,101.8,17.4461538461538,75,1199.41937989664,-1.49504589714912
23762,527134.043,5333308.508,160,103,57,47.732,0,2015,2,101,327,193,0.788166064301823,-192.4,20.4978021978022,92,1199.41937989664,-1.49504589714912
23762,527134.043,5333308.508,169,93,76,53.061,5,2016,2,103,340,194,0.859325546105684,-4.8,18.6318681318681,91,1199.41937989664,-1.49504589714912
23762,527134.043,5333308.508,128,94,34,40.558,7,2017,2,104,305,186,0.823764014526297,-54.4,19.6516483516484,82,1199.41937989664,-1.49504589714912
23762,527134.043,5333308.508,170,59,111,39.897,0,2018,3,107,348,194,0.801253585127312,-121.8,20.367032967033,87,1199.41937989664,-1.49504589714912
23762,527134.043,5333308.508,148,93,55,31.682,3,2019,1,118,335,176,0.832883855691732,-107,20.478021978022,58,1199.41937989664,-1.49504589714912
23762,527134.043,5333308.508,93,93,0,36.758,3,2020,2,99,315,184,0.810772632129657,-91.9,18.7142857142857,85,1199.41937989664,-1.49504589714912
23763,527134.043,5333076.852,86,83,3,44.853,6,2001,3,108,301,185,0.833637209324366,10.6,17.710989010989,77,1232.22066426678,0.957928730207267
23763,527134.043,5333076.852,119,73,46,17.449,0,2002,3,133,314,257,0.768381408133065,25.6,17.9494505494505,124,1232.22066426678,0.957928730207267
23763,527134.043,5333076.852,159,93,66,36.57,0,2003,1,110,325,170,0.814356439599993,-201.3,22.6626373626374,60,1232.22066426678,0.957928730207267
23763,527134.043,5333076.852,161,93,68,32.816,0,2004,2,117,324,233,0.809087617884908,132.4,17.5076923076923,116,1232.22066426678,0.957928730207267
23763,527134.043,5333076.852,154,93,61,54.962,1,2005,1,100,313,177,0.82293775476551,-23.3,17.6,77,1232.22066426678,0.957928730207267
23763,527134.043,5333076.852,185,100,85,45.743,2,2006,1,110,340,176,0.81399591168261,50,18.6131868131868,66,1232.22066426678,0.957928730207267
23763,527134.043,5333076.852,93,93,0,40.442,0,2007,2,102,303,194,0.84184148954176,269.6,16.9021978021978,92,1232.22066426678,0.957928730207267
23763,527134.043,5333076.852,0,0,0,22.957,0,2008,0,124,302,193,0.830005077566082,38,17.3098901098901,69,1232.22066426678,0.957928730207267
23763,527134.043,5333076.852,147,75,72,63.178,1,2009,2,87,304,177,0.863331731146093,34.6,18.2571428571429,90,1232.22066426678,0.957928730207267
23763,527134.043,5333076.852,177,63,114,29.343,0,2010,3,120,311,184,0.830317189037434,95.1,17.9945054945055,64,1232.22066426678,0.957928730207267
23763,527134.043,5333076.852,86,71,15,43.895,0,2011,1,90,324,161,0.787019530313274,139.3,17.1164835164835,71,1232.22066426678,0.957928730207267
23763,527134.043,5333076.852,152,81,71,23.907,0,2012,3,129,297,200,0.830335170007456,38.5,18.2296703296703,71,1232.22066426678,0.957928730207267
23763,527134.043,5333076.852,185,59,126,26.186,1,2013,3,128,303,248,0.84366863625675,-164.8,18.7813186813187,120,1232.22066426678,0.957928730207267
23763,527134.043,5333076.852,148,51,97,40.775,3,2014,3,101,346,186,0.816503749264399,101.8,17.4461538461538,85,1232.22066426678,0.957928730207267
23763,527134.043,5333076.852,159,93,66,44.708,0,2015,1,104,345,177,0.807660917842412,-192.4,20.4978021978022,73,1232.22066426678,0.957928730207267
23763,527134.043,5333076.852,168,93,75,40.629,5,2016,2,114,338,226,0.819161956781413,-4.8,18.6318681318681,112,1232.22066426678,0.957928730207267
23763,527134.043,5333076.852,145,97,48,39.048,7,2017,1,106,304,184,0.79480720689512,-54.4,19.6516483516484,78,1232.22066426678,0.957928730207267
23763,527134.043,5333076.852,169,60,109,33.866,0,2018,3,113,347,186,0.797882583734507,-121.8,20.367032967033,73,1232.22066426678,0.957928730207267
23763,527134.043,5333076.852,144,93,51,38.724,3,2019,1,110,334,177,0.807996937977682,-107,20.478021978022,67,1232.22066426678,0.957928730207267
23763,527134.043,5333076.852,0,0,0,37.571,0,2020,0,98,304,185,0.803803186655636,-91.9,18.7142857142857,87,1232.22066426678,0.957928730207267
23764,527134.043,5332845.195,86,83,3,60.967,9,2001,2,94,308,193,0.832886525143138,10.6,17.710989010989,99,1256.65123846041,-0.118348028166021
23764,527134.043,5332845.195,117,74,43,29.976,0,2002,3,121,313,256,0.789851332934249,25.6,17.9494505494505,135,1256.65123846041,-0.118348028166021
23764,527134.043,5332845.195,162,93,69,29.44,0,2003,1,118,337,178,0.815695040260357,-201.3,22.6626373626374,60,1256.65123846041,-0.118348028166021
23764,527134.043,5332845.195,164,97,67,31.885,0,2004,2,118,323,225,0.804943625402711,132.4,17.5076923076923,107,1256.65123846041,-0.118348028166021
23764,527134.043,5332845.195,153,93,60,54.962,1,2005,2,100,314,193,0.835497754111545,-23.3,17.6,93,1256.65123846041,-0.118348028166021
23764,527134.043,5332845.195,185,94,91,44.475,2,2006,2,111,343,192,0.799895149872248,50,18.6131868131868,81,1256.65123846041,-0.118348028166021
23764,527134.043,5332845.195,93,93,0,47.966,2,2007,2,94,313,194,0.8581329761791,269.6,16.9021978021978,100,1256.65123846041,-0.118348028166021
23764,527134.043,5332845.195,0,0,0,21.09,0,2008,0,126,308,193,0.832225563750234,38,17.3098901098901,67,1256.65123846041,-0.118348028166021
23764,527134.043,5332845.195,167,76,91,27.938,0,2009,3,119,304,232,0.833681530202907,34.6,18.2571428571429,113,1256.65123846041,-0.118348028166021
23764,527134.043,5332845.195,175,63,112,32.946,0,2010,3,116,312,201,0.831096809551587,95.1,17.9945054945055,85,1256.65123846041,-0.118348028166021
23764,527134.043,5332845.195,86,72,14,52.571,1,2011,1,81,325,176,0.780889373391272,139.3,17.1164835164835,95,1256.65123846041,-0.118348028166021
23764,527134.043,5332845.195,151,81,70,22.881,0,2012,3,130,323,200,0.838878268406052,38.5,18.2296703296703,70,1256.65123846041,-0.118348028166021
23764,527134.043,5332845.195,184,67,117,31.708,1,2013,3,123,300,194,0.847631532824533,-164.8,18.7813186813187,71,1256.65123846041,-0.118348028166021
23764,527134.043,5332845.195,153,49,104,33.282,0,2014,2,112,347,170,0.804747801616363,101.8,17.4461538461538,58,1256.65123846041,-0.118348028166021
23764,527134.043,5332845.195,163,93,70,41.916,0,2015,2,107,345,193,0.819404290419418,-192.4,20.4978021978022,86,1256.65123846041,-0.118348028166021
23764,527134.043,5332845.195,169,93,76,43.922,5,2016,2,111,344,218,0.842223387858972,-4.8,18.6318681318681,107,1256.65123846041,-0.118348028166021
23764,527134.043,5332845.195,144,93,51,42.902,7,2017,2,101,303,185,0.820908622571465,-54.4,19.6516483516484,84,1256.65123846041,-0.118348028166021
23764,527134.043,5332845.195,169,59,110,32.949,0,2018,3,114,350,200,0.828631683408439,-121.8,20.367032967033,86,1256.65123846041,-0.118348028166021
23764,527134.043,5332845.195,141,93,48,42.533,3,2019,2,106,339,193,0.818944809400845,-107,20.478021978022,87,1256.65123846041,-0.118348028166021
23764,527134.043,5332845.195,0,0,0,44.629,0,2020,0,90,315,217,0.836456926415365,-91.9,18.7142857142857,127,1256.65123846041,-0.118348028166021
23765,527134.043,5332613.539,0,0,0,71.852,0,2001,2,85,328,202,0.822067993398839,10.6,17.710989010989,117,1263.54529742017,1.43350726974209
23765,527134.043,5332613.539,104,85,19,53.303,4,2002,2,96,306,169,0.780799598767012,25.6,17.9494505494505,73,1263.54529742017,1.43350726974209
23765,527134.043,5332613.539,152,100,52,38.332,1,2003,1,108,291,178,0.835203747830813,-201.3,22.6626373626374,70,1263.54529742017,1.43350726974209
23765,527134.043,5332613.539,149,35,114,35.76,0,2004,3,114,333,233,0.822237057790109,132.4,17.5076923076923,119,1263.54529742017,1.43350726974209
23765,527134.043,5332613.539,148,99,49,51.396,0,2005,1,103,310,186,0.844545465974483,-23.3,17.6,83,1263.54529742017,1.43350726974209
23765,527134.043,5332613.539,182,84,98,26.621,1,2006,3,127,339,185,0.828718735322845,50,18.6131868131868,58,1263.54529742017,1.43350726974209
23765,527134.043,5332613.539,0,0,0,60.667,0,2007,0,82,316,202,0.877939136962892,269.6,16.9021978021978,120,1263.54529742017,1.43350726974209
23765,527134.043,5332613.539,0,0,0,19.328,0,2008,0,128,309,185,0.837794840364644,38,17.3098901098901,57,1263.54529742017,1.43350726974209
23765,527134.043,5332613.539,151,93,58,57.193,0,2009,2,92,321,185,0.876143245972277,34.6,18.2571428571429,93,1263.54529742017,1.43350726974209
23765,527134.043,5332613.539,155,93,62,31.094,0,2010,2,118,311,210,0.876965208468293,95.1,17.9945054945055,92,1263.54529742017,1.43350726974209
23765,527134.043,5332613.539,86,77,9,50.618,0,2011,1,83,328,232,0.809448601031536,139.3,17.1164835164835,149,1263.54529742017,1.43350726974209
23765,527134.043,5332613.539,120,93,27,38.913,0,2012,2,115,307,193,0.857133510826892,38.5,18.2296703296703,78,1263.54529742017,1.43350726974209
23765,527134.043,5332613.539,184,72,112,26.186,1,2013,3,128,308,200,0.87329257508834,-164.8,18.7813186813187,72,1263.54529742017,1.43350726974209
23765,527134.043,5332613.539,86,61,25,37.245,2,2014,1,106,337,208,0.881774606239645,101.8,17.4461538461538,102,1263.54529742017,1.43350726974209
23765,527134.043,5332613.539,0,0,0,39.184,0,2015,0,110,347,193,0.83900443062226,-192.4,20.4978021978022,83,1263.54529742017,1.43350726974209
23765,527134.043,5332613.539,160,93,67,50.938,5,2016,2,105,345,217,0.881282586769023,-4.8,18.6318681318681,112,1263.54529742017,1.43350726974209
23765,527134.043,5332613.539,0,0,0,63.593,0,2017,0,80,316,186,0.856528188415572,-54.4,19.6516483516484,106,1263.54529742017,1.43350726974209
23765,527134.043,5332613.539,86,73,13,38.811,0,2018,1,108,312,193,0.869680633712771,-121.8,20.367032967033,85,1263.54529742017,1.43350726974209
23765,527134.043,5332613.539,129,73,56,33.486,3,2019,3,116,341,186,0.846065317092577,-107,20.478021978022,70,1263.54529742017,1.43350726974209
23765,527134.043,5332613.539,93,93,0,63.33,17,2020,2,72,329,225,0.835723067070579,-91.9,18.7142857142857,153,1263.54529742017,1.43350726974209
23788,527134.043,5327285.443,0,0,0,44.853,0,2001,1,108,294,176,0.876834522816929,10.6,17.710989010989,68,1172.80455358123,0.69035589283201
23788,527134.043,5327285.443,93,66,27,31.831,0,2002,3,119,294,241,0.855711823751428,25.6,17.9494505494505,122,1172.80455358123,0.69035589283201
23788,527134.043,5327285.443,163,70,93,32.076,0,2003,2,115,291,161,0.853425322830099,-201.3,22.6626373626374,46,1172.80455358123,0.69035589283201
23788,527134.043,5327285.443,164,63,101,43.062,0,2004,3,107,322,193,0.849895637433424,132.4,17.5076923076923,86,1172.80455358123,0.69035589283201
23788,527134.043,5327285.443,149,115,34,42.603,0,2005,1,111,306,169,0.870660522617554,-23.3,17.6,58,1172.80455358123,0.69035589283201
23788,527134.043,5327285.443,188,67,121,57.606,4,2006,3,101,321,265,0.871314309793976,50,18.6131868131868,164,1172.80455358123,0.69035589283201
23788,527134.043,5327285.443,0,0,0,42.208,0,2007,0,100,293,177,0.877684807982452,269.6,16.9021978021978,77,1172.80455358123,0.69035589283201
23788,527134.043,5327285.443,84,55,29,21.09,0,2008,1,126,303,234,0.845753171811894,38,17.3098901098901,108,1172.80455358123,0.69035589283201
23788,527134.043,5327285.443,169,64,105,65.52,2,2009,2,85,307,169,0.901834827404154,34.6,18.2571428571429,84,1172.80455358123,0.69035589283201
23788,527134.043,5327285.443,175,94,81,26.783,0,2010,2,123,302,186,0.853364086073437,95.1,17.9945054945055,63,1172.80455358123,0.69035589283201
23788,527134.043,5327285.443,86,67,19,36.288,0,2011,1,98,315,169,0.855221663313242,139.3,17.1164835164835,71,1172.80455358123,0.69035589283201
23788,527134.043,5327285.443,155,103,52,41.059,0,2012,1,113,300,168,0.848443546155853,38.5,18.2296703296703,55,1172.80455358123,0.69035589283201
23788,527134.043,5327285.443,182,67,115,17.095,1,2013,3,137,294,186,0.861796492859839,-164.8,18.7813186813187,49,1172.80455358123,0.69035589283201
23788,527134.043,5327285.443,146,44,102,38.624,3,2014,2,104,336,168,0.847755824115526,101.8,17.4461538461538,64,1172.80455358123,0.69035589283201
23788,527134.043,5327285.443,151,93,58,45.692,0,2015,1,103,322,161,0.863908287133883,-192.4,20.4978021978022,58,1172.80455358123,0.69035589283201
23788,527134.043,5327285.443,168,94,74,38.512,4,2016,1,116,328,177,0.847768309087227,-4.8,18.6318681318681,61,1172.80455358123,0.69035589283201
23788,527134.043,5327285.443,144,106,38,36.707,6,2017,1,109,318,169,0.851065136212892,-54.4,19.6516483516484,60,1172.80455358123,0.69035589283201
23788,527134.043,5327285.443,151,72,79,52.727,0,2018,2,96,318,178,0.804100440453215,-121.8,20.367032967033,82,1172.80455358123,0.69035589283201
23788,527134.043,5327285.443,152,98,54,31.682,3,2019,1,118,330,169,0.849884441967165,-107,20.478021978022,51,1172.80455358123,0.69035589283201
23788,527134.043,5327285.443,0,0,0,31.568,0,2020,0,106,303,176,0.797309108933136,-91.9,18.7142857142857,70,1172.80455358123,0.69035589283201
23789,527134.043,5327053.786,0,0,0,43.733,0,2001,1,109,276,185,0.864854867545257,10.6,17.710989010989,76,1206.64171537789,-0.743477578681823
23789,527134.043,5327053.786,93,52,41,24.68,0,2002,3,126,293,186,0.846050375198927,25.6,17.9494505494505,60,1206.64171537789,-0.743477578681823
23789,527134.043,5327053.786,164,131,33,32.076,0,2003,1,115,307,168,0.866534380147358,-201.3,22.6626373626374,53,1206.64171537789,-0.743477578681823
23789,527134.043,5327053.786,168,93,75,26.464,0,2004,2,124,322,192,0.857890978631746,132.4,17.5076923076923,68,1206.64171537789,-0.743477578681823
23789,527134.043,5327053.786,0,0,0,37.186,0,2005,0,116,311,170,0.854564761380626,-23.3,17.6,54,1206.64171537789,-0.743477578681823
23789,527134.043,5327053.786,180,93,87,31.643,1,2006,1,122,326,177,0.863630133848652,50,18.6131868131868,55,1206.64171537789,-0.743477578681823
23789,527134.043,5327053.786,0,0,0,38.754,0,2007,0,104,296,209,0.814429607428547,269.6,16.9021978021978,105,1206.64171537789,-0.743477578681823
23789,527134.043,5327053.786,131,58,73,22.957,0,2008,2,124,301,184,0.852095249717201,38,17.3098901098901,60,1206.64171537789,-0.743477578681823
23789,527134.043,5327053.786,162,67,95,47.509,0,2009,2,100,295,169,0.892242505122025,34.6,18.2571428571429,69,1206.64171537789,-0.743477578681823
23789,527134.043,5327053.786,160,93,67,25.098,0,2010,2,125,299,185,0.874460319198405,95.1,17.9945054945055,60,1206.64171537789,-0.743477578681823
23789,527134.043,5327053.786,124,65,59,32.89,0,2011,3,102,314,224,0.81494007326704,139.3,17.1164835164835,122,1206.64171537789,-0.743477578681823
23789,527134.043,5327053.786,93,75,18,38.913,0,2012,3,115,310,193,0.834349033501451,38.5,18.2296703296703,78,1206.64171537789,-0.743477578681823
23789,527134.043,5327053.786,170,97,73,23.092,1,2013,1,131,293,185,0.882855312208411,-164.8,18.7813186813187,54,1206.64171537789,-0.743477578681823
23789,527134.043,5327053.786,105,93,12,37.93,3,2014,1,105,339,169,0.853602770199319,101.8,17.4461538461538,64,1206.64171537789,-0.743477578681823
23789,527134.043,5327053.786,0,0,0,43.75,0,2015,0,105,308,154,0.84829261547993,-192.4,20.4978021978022,49,1206.64171537789,-0.743477578681823
23789,527134.043,5327053.786,167,93,74,38.512,4,2016,1,116,332,177,0.897502084086822,-4.8,18.6318681318681,61,1206.64171537789,-0.743477578681823
23789,527134.043,5327053.786,136,94,42,33.624,3,2017,1,113,299,170,0.846562787646434,-54.4,19.6516483516484,57,1206.64171537789,-0.743477578681823
23789,527134.043,5327053.786,171,68,103,35.732,0,2018,2,111,311,177,0.838991255973086,-121.8,20.367032967033,66,1206.64171537789,-0.743477578681823
23789,527134.043,5327053.786,166,106,60,28.036,3,2019,1,122,332,170,0.853852799063883,-107,20.478021978022,48,1206.64171537789,-0.743477578681823
23789,527134.043,5327053.786,93,93,0,29.565,1,2020,2,109,298,225,0.786813995513325,-91.9,18.7142857142857,116,1206.64171537789,-0.743477578681823
23914,527365.7,5348829.484,0,0,0,69.771,0,2001,1,85,319,186,0.848349387528983,-10.6,19.1659340659341,101,1043.18712908032,0.828056573853356
23914,527365.7,5348829.484,138,55,83,45.571,0,2002,2,101,344,178,0.833035141222606,6.29999999999999,19.1637362637363,77,1043.18712908032,0.828056573853356
23914,527365.7,5348829.484,157,93,64,40.399,1,2003,2,102,336,185,0.808994561049513,-207.1,23.9516483516484,83,1043.18712908032,0.828056573853356
23914,527365.7,5348829.484,152,100,52,37.523,0,2004,1,110,330,178,0.821739023415474,109,18.7549450549451,68,1043.18712908032,0.828056573853356
23914,527365.7,5348829.484,154,94,60,59.097,2,2005,2,94,314,201,0.820904432664065,-46.2,18.9098901098901,107,1043.18712908032,0.828056573853356
23914,527365.7,5348829.484,194,70,124,31.95,0,2006,2,119,346,161,0.826058045036468,29.4,19.8868131868132,42,1043.18712908032,0.828056573853356
23914,527365.7,5348829.484,0,0,0,81.942,0,2007,0,61,301,152,0.835934209289294,236.4,18.0659340659341,91,1043.18712908032,0.828056573853356
23914,527365.7,5348829.484,86,56,30,65.95,7,2008,1,84,314,176,0.844321489594442,13.4,18.4934065934066,92,1043.18712908032,0.828056573853356
23914,527365.7,5348829.484,174,63,111,34.012,0,2009,3,108,327,225,0.806754518969703,14,19.4461538461538,117,1043.18712908032,0.828056573853356
23914,527365.7,5348829.484,166,93,73,36.567,0,2010,1,107,305,170,0.825375282717854,69.3,19.1879120879121,63,1043.18712908032,0.828056573853356
23914,527365.7,5348829.484,84,52,32,68.831,10,2011,1,56,328,169,0.816617051068341,108.7,18.4846153846154,113,1043.18712908032,0.828056573853356
23914,527365.7,5348829.484,151,82,69,57.016,4,2012,2,91,324,169,0.849951480547645,6.9,19.8923076923077,78,1043.18712908032,0.828056573853356
23914,527365.7,5348829.484,180,93,87,41.105,0,2013,2,112,302,186,0.837892959021637,-187.7,20.2681318681319,74,1043.18712908032,0.828056573853356
23914,527365.7,5348829.484,84,46,38,46.64,0,2014,1,89,318,184,0.813369594877522,71,18.9736263736264,95,1043.18712908032,0.828056573853356
23914,527365.7,5348829.484,158,94,64,57.325,4,2015,1,91,313,162,0.81757925250439,-210.3,22.0318681318681,71,1043.18712908032,0.828056573853356
23914,527365.7,5348829.484,170,93,77,51.483,4,2016,2,103,345,217,0.812104706011665,-28.3,20.1868131868132,114,1043.18712908032,0.828056573853356
23914,527365.7,5348829.484,128,94,34,57.363,6,2017,1,82,299,177,0.828912282568812,-67,20.9692307692308,95,1043.18712908032,0.828056573853356
23914,527365.7,5348829.484,157,60,97,48.096,0,2018,2,96,318,178,0.811997499844613,-134,21.621978021978,82,1043.18712908032,0.828056573853356
23914,527365.7,5348829.484,150,99,51,52.483,8,2019,1,94,302,177,0.826911209347136,-110.8,21.721978021978,83,1043.18712908032,0.828056573853356
23914,527365.7,5348829.484,149,64,85,37.027,0,2020,3,95,326,266,0.864073093156457,-108.6,20.0032967032967,171,1043.18712908032,0.828056573853356
23915,527365.7,5348597.828,0,0,0,67.307,0,2001,1,87,316,184,0.818941864270408,-10.6,19.1659340659341,97,1039.81753400452,1.18409425341606
23915,527365.7,5348597.828,138,53,85,43.136,0,2002,3,104,344,241,0.809994964964046,6.29999999999999,19.1637362637363,137,1039.81753400452,1.18409425341606
23915,527365.7,5348597.828,156,94,62,45.717,6,2003,1,96,331,161,0.795419781893346,-207.1,23.9516483516484,65,1039.81753400452,1.18409425341606
23915,527365.7,5348597.828,150,101,49,40.324,0,2004,1,107,331,178,0.801382478908996,109,18.7549450549451,71,1039.81753400452,1.18409425341606
23915,527365.7,5348597.828,154,94,60,65.126,2,2005,2,88,313,217,0.777956360263924,-46.2,18.9098901098901,129,1039.81753400452,1.18409425341606
23915,527365.7,5348597.828,185,67,118,54.622,2,2006,2,98,347,161,0.796223424265138,29.4,19.8868131868132,63,1039.81753400452,1.18409425341606
23915,527365.7,5348597.828,0,0,0,79.151,0,2007,0,63,302,153,0.824509239269322,236.4,18.0659340659341,90,1039.81753400452,1.18409425341606
23915,527365.7,5348597.828,82,55,27,64.909,6,2008,1,85,312,176,0.8327420688341,13.4,18.4934065934066,91,1039.81753400452,1.18409425341606
23915,527365.7,5348597.828,166,61,105,52.313,0,2009,2,89,326,154,0.790667937338664,14,19.4461538461538,65,1039.81753400452,1.18409425341606
23915,527365.7,5348597.828,165,94,71,37.489,0,2010,1,106,307,170,0.798243421696281,69.3,19.1879120879121,64,1039.81753400452,1.18409425341606
23915,527365.7,5348597.828,83,52,31,65.061,9,2011,1,60,327,169,0.799060807480475,108.7,18.4846153846154,109,1039.81753400452,1.18409425341606
23915,527365.7,5348597.828,153,81,72,53.294,3,2012,2,96,323,168,0.837585419293331,6.9,19.8923076923077,72,1039.81753400452,1.18409425341606
23915,527365.7,5348597.828,175,94,81,48.286,0,2013,1,105,306,178,0.820793255898335,-187.7,20.2681318681319,73,1039.81753400452,1.18409425341606
23915,527365.7,5348597.828,93,48,45,59.851,3,2014,3,73,325,185,0.790902971579736,71,18.9736263736264,112,1039.81753400452,1.18409425341606
23915,527365.7,5348597.828,159,93,66,56.224,4,2015,1,92,313,154,0.805142375462459,-210.3,22.0318681318681,62,1039.81753400452,1.18409425341606
23915,527365.7,5348597.828,170,94,76,54.382,4,2016,2,100,342,225,0.798431752383163,-28.3,20.1868131868132,125,1039.81753400452,1.18409425341606
23915,527365.7,5348597.828,127,95,32,58.437,6,2017,2,81,305,185,0.813954928007042,-67,20.9692307692308,104,1039.81753400452,1.18409425341606
23915,527365.7,5348597.828,153,61,92,53.425,0,2018,2,91,319,176,0.804900846688379,-134,21.621978021978,85,1039.81753400452,1.18409425341606
23915,527365.7,5348597.828,148,97,51,55.099,8,2019,1,91,301,169,0.805183946412026,-110.8,21.721978021978,78,1039.81753400452,1.18409425341606
23915,527365.7,5348597.828,86,63,23,116.262,25,2020,1,23,321,272,0.835122390965515,-108.6,20.0032967032967,249,1039.81753400452,1.18409425341606
23916,527365.7,5348366.171,0,0,0,67.307,0,2001,2,87,319,177,0.793986029184838,-10.6,19.1659340659341,90,1012.10684059474,0.470904409288028
23916,527365.7,5348366.171,110,61,49,38.893,0,2002,2,109,341,177,0.81325884405201,6.29999999999999,19.1637362637363,68,1012.10684059474,0.470904409288028
23916,527365.7,5348366.171,151,93,58,41.272,2,2003,1,101,315,170,0.825875967025243,-207.1,23.9516483516484,69,1012.10684059474,0.470904409288028
23916,527365.7,5348366.171,147,94,53,36.591,0,2004,2,111,329,241,0.824144109564281,109,18.7549450549451,130,1012.10684059474,0.470904409288028
23916,527365.7,5348366.171,151,94,57,60.056,2,2005,1,93,309,176,0.837494311978184,-46.2,18.9098901098901,83,1012.10684059474,0.470904409288028
23916,527365.7,5348366.171,191,55,136,31.95,0,2006,2,119,345,176,0.805375510385721,29.4,19.8868131868132,57,1012.10684059474,0.470904409288028
23916,527365.7,5348366.171,0,0,0,71.985,0,2007,0,69,298,169,0.813709448976194,236.4,18.0659340659341,100,1012.10684059474,0.470904409288028
23916,527365.7,5348366.171,94,56,38,40.507,1,2008,3,107,309,185,0.807343459708109,13.4,18.4934065934066,78,1012.10684059474,0.470904409288028
23916,527365.7,5348366.171,168,62,106,39.949,0,2009,3,101,322,184,0.861228682980882,14,19.4461538461538,83,1012.10684059474,0.470904409288028
23916,527365.7,5348366.171,159,99,60,32.237,0,2010,1,112,304,185,0.795590964285176,69.3,19.1879120879121,73,1012.10684059474,0.470904409288028
23916,527365.7,5348366.171,0,0,0,56.947,0,2011,0,69,323,185,0.80528624740745,108.7,18.4846153846154,116,1012.10684059474,0.470904409288028
23916,527365.7,5348366.171,151,81,70,48.84,1,2012,2,102,318,176,0.832799560093253,6.9,19.8923076923077,74,1012.10684059474,0.470904409288028
23916,527365.7,5348366.171,178,99,79,39.211,0,2013,1,114,302,185,0.823428098511615,-187.7,20.2681318681319,71,1012.10684059474,0.470904409288028
23916,527365.7,5348366.171,127,60,67,54.047,3,2014,3,80,316,248,0.994772084171689,71,18.9736263736264,168,1012.10684059474,0.470904409288028
23916,527365.7,5348366.171,158,93,65,47.279,0,2015,1,100,311,169,0.799327811172478,-210.3,22.0318681318681,69,1012.10684059474,0.470904409288028
23916,527365.7,5348366.171,166,63,103,48.517,4,2016,3,106,331,192,0.819511978170654,-28.3,20.1868131868132,86,1012.10684059474,0.470904409288028
23916,527365.7,5348366.171,132,99,33,44.324,6,2017,1,96,320,185,0.806177250626399,-67,20.9692307692308,89,1012.10684059474,0.470904409288028
23916,527365.7,5348366.171,157,82,75,45.945,0,2018,2,98,315,178,0.812893724942445,-134,21.621978021978,80,1012.10684059474,0.470904409288028
23916,527365.7,5348366.171,0,0,0,45.906,0,2019,0,101,297,185,0.788855881593405,-110.8,21.721978021978,84,1012.10684059474,0.470904409288028
23916,527365.7,5348366.171,86,73,13,105.055,23,2020,1,34,338,185,0.785487930283682,-108.6,20.0032967032967,151,1012.10684059474,0.470904409288028
23965,527365.7,5337015.01,0,0,0,135.67,0,2001,0,33,337,169,0.854351960369878,-14.2,19.5065934065934,136,822.567819577579,1.36167418857594
23965,527365.7,5337015.01,0,0,0,71.922,0,2002,0,78,341,177,0.822799614888318,3,19.4725274725275,99,822.567819577579,1.36167418857594
23965,527365.7,5337015.01,93,93,0,71.505,14,2003,1,70,323,153,0.788117632131665,-209,24.2648351648352,83,822.567819577579,1.36167418857594
23965,527365.7,5337015.01,0,0,0,69.992,0,2004,0,80,332,170,0.849364442117512,104,19.0769230769231,90,822.567819577579,1.36167418857594
23965,527365.7,5337015.01,144,93,51,68.604,2,2005,2,87,312,161,0.850743058900371,-49.6,19.2098901098901,74,822.567819577579,1.36167418857594
23965,527365.7,5337015.01,85,63,22,49.984,0,2006,1,103,344,161,0.824168863128812,25.1,20.1736263736264,58,822.567819577579,1.36167418857594
23965,527365.7,5337015.01,0,0,0,127.897,0,2007,0,24,326,162,0.936217338660659,229.8,18.3494505494505,138,822.567819577579,1.36167418857594
23965,527365.7,5337015.01,0,0,0,53.555,0,2008,0,97,316,161,0.869597612486762,8.90000000000001,18.8,64,822.567819577579,1.36167418857594
23965,527365.7,5337015.01,86,74,12,49.992,0,2009,1,92,319,160,0.843215956405608,9.4,19.7494505494506,68,822.567819577579,1.36167418857594
23965,527365.7,5337015.01,131,83,48,47.876,0,2010,2,97,313,169,0.834572229397191,64.4,19.4725274725275,72,822.567819577579,1.36167418857594
23965,527365.7,5337015.01,108,78,30,58.557,3,2011,3,69,332,218,0.821234554963562,103.5,18.7505494505494,149,822.567819577579,1.36167418857594
23965,527365.7,5337015.01,0,0,0,69.488,0,2012,0,79,337,160,0.855160023363589,3.2,20.1307692307692,81,822.567819577579,1.36167418857594
23965,527365.7,5337015.01,155,93,62,59.216,2,2013,1,97,327,169,0.845812832541911,-190.8,20.5692307692308,72,822.567819577579,1.36167418857594
23965,527365.7,5337015.01,86,85,1,106.398,9,2014,1,32,327,152,0.821298952255335,65.4,19.2153846153846,120,822.567819577579,1.36167418857594
23965,527365.7,5337015.01,93,93,0,73.24,4,2015,1,76,345,160,0.860955146618152,-212.4,22.3164835164835,84,822.567819577579,1.36167418857594
23965,527365.7,5337015.01,145,94,51,73.405,5,2016,1,83,334,176,0.866357715670126,-31.9,20.4131868131868,93,822.567819577579,1.36167418857594
23965,527365.7,5337015.01,0,0,0,61.347,0,2017,0,80,340,169,0.832347445425467,-70.8,21.2648351648352,89,822.567819577579,1.36167418857594
23965,527365.7,5337015.01,0,0,0,136.091,0,2018,0,20,337,160,0.845689922797653,-135.7,21.9263736263736,140,822.567819577579,1.36167418857594
23965,527365.7,5337015.01,132,93,39,56.906,6,2019,1,91,339,161,0.839842666349932,-112.7,22.0065934065934,70,822.567819577579,1.36167418857594
23965,527365.7,5337015.01,0,0,0,94.307,0,2020,0,45,326,177,0.848434398710743,-111.3,20.3164835164835,132,822.567819577579,1.36167418857594
23980,527365.7,5333540.164,86,86,0,43.733,5,2001,3,109,302,184,0.856222364980972,10.6,17.710989010989,75,1253.10142650429,1.42460055751319
23980,527365.7,5333540.164,86,70,16,29.025,0,2002,1,122,312,234,0.863306897912742,25.6,17.9494505494505,112,1253.10142650429,1.42460055751319
23980,527365.7,5333540.164,158,99,59,32.076,0,2003,1,115,331,169,0.811343889349219,-201.3,22.6626373626374,54,1253.10142650429,1.42460055751319
23980,527365.7,5333540.164,149,94,55,30.971,0,2004,2,119,322,218,0.815912487270311,132.4,17.5076923076923,99,1253.10142650429,1.42460055751319
23980,527365.7,5333540.164,147,106,41,60.785,2,2005,1,95,304,178,0.84936837411406,-23.3,17.6,83,1253.10142650429,1.42460055751319
23980,527365.7,5333540.164,185,57,128,51.052,2,2006,2,106,342,177,0.822591138640201,50,18.6131868131868,71,1253.10142650429,1.42460055751319
23980,527365.7,5333540.164,0,0,0,38.754,0,2007,0,104,297,201,0.834758965576185,269.6,16.9021978021978,97,1253.10142650429,1.42460055751319
23980,527365.7,5333540.164,0,0,0,22.957,0,2008,0,124,305,185,0.862067581062088,38,17.3098901098901,61,1253.10142650429,1.42460055751319
23980,527365.7,5333540.164,176,60,116,36.405,0,2009,2,110,299,169,0.874686429614077,34.6,18.2571428571429,59,1253.10142650429,1.42460055751319
23980,527365.7,5333540.164,175,93,82,32.009,0,2010,2,117,306,186,0.85814087093432,95.1,17.9945054945055,69,1253.10142650429,1.42460055751319
23980,527365.7,5333540.164,82,66,16,42.914,0,2011,1,91,338,169,0.801779923897177,139.3,17.1164835164835,78,1253.10142650429,1.42460055751319
23980,527365.7,5333540.164,155,96,59,42.059,0,2012,2,112,322,193,0.849318302681176,38.5,18.2296703296703,81,1253.10142650429,1.42460055751319
23980,527365.7,5333540.164,187,93,94,30.583,1,2013,2,124,297,208,0.833246285610297,-164.8,18.7813186813187,84,1253.10142650429,1.42460055751319
23980,527365.7,5333540.164,151,46,105,45.374,3,2014,2,95,348,177,0.844146112133616,101.8,17.4461538461538,82,1253.10142650429,1.42460055751319
23980,527365.7,5333540.164,166,93,73,47.732,0,2015,1,101,344,177,0.806477065640857,-192.4,20.4978021978022,76,1253.10142650429,1.42460055751319
23980,527365.7,5333540.164,169,93,76,40.629,5,2016,2,114,342,201,0.906872066025668,-4.8,18.6318681318681,87,1253.10142650429,1.42460055751319
23980,527365.7,5333540.164,142,96,46,59.067,7,2017,1,84,301,178,0.846579589558999,-54.4,19.6516483516484,94,1253.10142650429,1.42460055751319
23980,527365.7,5333540.164,161,58,103,42.134,0,2018,3,105,348,202,0.791340711712249,-121.8,20.367032967033,97,1253.10142650429,1.42460055751319
23980,527365.7,5333540.164,171,93,78,31.682,3,2019,1,118,336,177,0.853911717833279,-107,20.478021978022,59,1253.10142650429,1.42460055751319
23980,527365.7,5333540.164,0,0,0,53.301,0,2020,0,81,318,185,0.836072106832805,-91.9,18.7142857142857,104,1253.10142650429,1.42460055751319
23981,527365.7,5333308.508,0,0,0,45.985,0,2001,3,107,309,185,0.848087633860842,10.6,17.710989010989,78,1245.04406067344,0.48278775611592
23981,527365.7,5333308.508,86,70,16,34.584,0,2002,1,116,315,185,0.808205051678738,25.6,17.9494505494505,69,1245.04406067344,0.48278775611592
23981,527365.7,5333308.508,157,100,57,37.444,1,2003,1,109,330,168,0.805275511079442,-201.3,22.6626373626374,59,1245.04406067344,0.48278775611592
23981,527365.7,5333308.508,152,98,54,33.772,0,2004,2,116,338,210,0.7970840993143,132.4,17.5076923076923,94,1245.04406067344,0.48278775611592
23981,527365.7,5333308.508,154,94,60,51.396,0,2005,1,103,304,178,0.828752910934372,-23.3,17.6,75,1245.04406067344,0.48278775611592
23981,527365.7,5333308.508,191,56,135,37.273,2,2006,2,117,342,176,0.818593313760873,50,18.6131868131868,59,1245.04406067344,0.48278775611592
23981,527365.7,5333308.508,93,93,0,48.989,2,2007,2,93,302,224,0.825986535233256,269.6,16.9021978021978,131,1245.04406067344,0.48278775611592
23981,527365.7,5333308.508,0,0,0,25.916,0,2008,0,121,306,185,0.867880557548166,38,17.3098901098901,64,1245.04406067344,0.48278775611592
23981,527365.7,5333308.508,173,60,113,39.639,0,2009,2,107,300,177,0.871869615802578,34.6,18.2571428571429,70,1245.04406067344,0.48278775611592
23981,527365.7,5333308.508,176,93,83,31.094,0,2010,2,118,307,193,0.846469110515967,95.1,17.9945054945055,75,1245.04406067344,0.48278775611592
23981,527365.7,5333308.508,82,66,16,45.856,0,2011,1,88,331,146,0.773253371541561,139.3,17.1164835164835,58,1245.04406067344,0.48278775611592
23981,527365.7,5333308.508,155,97,58,43.951,0,2012,1,110,324,185,0.844544743299181,38.5,18.2296703296703,75,1245.04406067344,0.48278775611592
23981,527365.7,5333308.508,186,93,93,21.065,1,2013,2,133,305,193,0.835150716912461,-164.8,18.7813186813187,60,1245.04406067344,0.48278775611592
23981,527365.7,5333308.508,152,50,102,42.268,3,2014,2,99,348,177,0.835625762565144,101.8,17.4461538461538,78,1245.04406067344,0.48278775611592
23981,527365.7,5333308.508,174,93,81,39.184,0,2015,1,110,346,169,0.792725268668193,-192.4,20.4978021978022,59,1245.04406067344,0.48278775611592
23981,527365.7,5333308.508,172,93,79,46.319,5,2016,2,109,342,193,0.877294637383696,-4.8,18.6318681318681,84,1245.04406067344,0.48278775611592
23981,527365.7,5333308.508,145,96,49,52.814,7,2017,1,90,303,178,0.826103254160112,-54.4,19.6516483516484,88,1245.04406067344,0.48278775611592
23981,527365.7,5333308.508,154,58,96,67.638,3,2018,3,83,348,193,0.803614932315929,-121.8,20.367032967033,110,1245.04406067344,0.48278775611592
23981,527365.7,5333308.508,167,93,74,37.816,3,2019,1,111,335,176,0.834693528013744,-107,20.478021978022,65,1245.04406067344,0.48278775611592
23981,527365.7,5333308.508,0,0,0,34.434,0,2020,0,102,321,184,0.809908805099693,-91.9,18.7142857142857,82,1245.04406067344,0.48278775611592
23982,527365.7,5333076.852,0,0,0,23.064,0,2001,3,128,302,192,0.847692230919304,10.6,17.710989010989,64,1244.92506891862,-1.3165126138838
23982,527365.7,5333076.852,143,71,72,36.376,0,2002,3,114,336,185,0.796291949097883,25.6,17.9494505494505,71,1244.92506891862,-1.3165126138838
23982,527365.7,5333076.852,162,93,69,33.887,0,2003,1,113,327,176,0.815798926880584,-201.3,22.6626373626374,63,1244.92506891862,-1.3165126138838
23982,527365.7,5333076.852,159,93,66,31.885,0,2004,2,118,338,225,0.78607343368133,132.4,17.5076923076923,107,1244.92506891862,-1.3165126138838
23982,527365.7,5333076.852,155,94,61,60.785,2,2005,2,95,315,185,0.828002214127398,-23.3,17.6,90,1244.92506891862,-1.3165126138838
23982,527365.7,5333076.852,190,76,114,39.623,2,2006,3,115,339,201,0.822324478635759,50,18.6131868131868,86,1244.92506891862,-1.3165126138838
23982,527365.7,5333076.852,93,93,0,41.315,0,2007,2,101,305,185,0.878280101084483,269.6,16.9021978021978,84,1244.92506891862,-1.3165126138838
23982,527365.7,5333076.852,0,0,0,24.913,0,2008,0,122,311,208,0.835153144774346,38,17.3098901098901,86,1244.92506891862,-1.3165126138838
23982,527365.7,5333076.852,164,66,98,60.741,1,2009,2,89,302,162,0.838164329705919,34.6,18.2571428571429,73,1244.92506891862,-1.3165126138838
23982,527365.7,5333076.852,174,93,81,36.908,0,2010,1,112,317,177,0.817383392938147,95.1,17.9945054945055,65,1244.92506891862,-1.3165126138838
23982,527365.7,5333076.852,0,0,0,41.932,0,2011,0,92,325,169,0.807099975058884,139.3,17.1164835164835,77,1244.92506891862,-1.3165126138838
23982,527365.7,5333076.852,93,80,13,35.503,0,2012,3,118,316,192,0.843818991193692,38.5,18.2296703296703,74,1244.92506891862,-1.3165126138838
23982,527365.7,5333076.852,188,72,116,22.086,1,2013,3,132,298,192,0.849911254679046,-164.8,18.7813186813187,60,1244.92506891862,-1.3165126138838
23982,527365.7,5333076.852,154,48,106,40.046,3,2014,3,102,327,193,0.830478199523727,101.8,17.4461538461538,91,1244.92506891862,-1.3165126138838
23982,527365.7,5333076.852,167,93,74,36.622,0,2015,2,113,343,217,0.744047426516022,-192.4,20.4978021978022,104,1244.92506891862,-1.3165126138838
23982,527365.7,5333076.852,172,93,79,40.629,5,2016,2,114,341,194,0.860167082131773,-4.8,18.6318681318681,80,1244.92506891862,-1.3165126138838
23982,527365.7,5333076.852,139,93,46,47.157,7,2017,1,96,313,178,0.824991105781906,-54.4,19.6516483516484,82,1244.92506891862,-1.3165126138838
23982,527365.7,5333076.852,157,78,79,38.811,0,2018,2,108,351,169,0.846815606909466,-121.8,20.367032967033,61,1244.92506891862,-1.3165126138838
23982,527365.7,5333076.852,166,93,73,28.928,3,2019,1,121,338,177,0.818575479235129,-107,20.478021978022,56,1244.92506891862,-1.3165126138838
23982,527365.7,5333076.852,0,0,0,38.404,0,2020,0,97,329,185,0.804619029483333,-91.9,18.7142857142857,88,1244.92506891862,-1.3165126138838
23983,527365.7,5332845.195,0,0,0,20.083,0,2001,2,131,327,193,0.850820137798778,10.6,17.710989010989,62,1257.09364717112,1.32237386681649
23983,527365.7,5332845.195,139,75,64,37.289,0,2002,3,113,337,192,0.809338050985174,25.6,17.9494505494505,79,1257.09364717112,1.32237386681649
23983,527365.7,5332845.195,163,93,70,28.574,0,2003,2,119,336,186,0.815029935155229,-201.3,22.6626373626374,67,1257.09364717112,1.32237386681649
23983,527365.7,5332845.195,161,93,68,27.357,0,2004,2,123,344,216,0.81448470147925,132.4,17.5076923076923,93,1257.09364717112,1.32237386681649
23983,527365.7,5332845.195,153,94,59,71.125,2,2005,2,86,315,193,0.840410610520786,-23.3,17.6,107,1257.09364717112,1.32237386681649
23983,527365.7,5332845.195,197,76,121,25.693,1,2006,3,128,346,201,0.83561564204352,50,18.6131868131868,73,1257.09364717112,1.32237386681649
23983,527365.7,5332845.195,0,0,0,53.237,0,2007,0,89,314,186,0.884997610243793,269.6,16.9021978021978,97,1257.09364717112,1.32237386681649
23983,527365.7,5332845.195,0,0,0,30.139,0,2008,0,117,313,208,0.845425647967398,38,17.3098901098901,91,1257.09364717112,1.32237386681649
23983,527365.7,5332845.195,171,66,105,42.89,0,2009,3,104,302,240,0.844661572140503,34.6,18.2571428571429,136,1257.09364717112,1.32237386681649
23983,527365.7,5332845.195,172,93,79,36.908,0,2010,1,112,321,177,0.820071859040871,95.1,17.9945054945055,65,1257.09364717112,1.32237386681649
23983,527365.7,5332845.195,0,0,0,108.689,0,2011,0,27,330,184,0.812645687219491,139.3,17.1164835164835,157,1257.09364717112,1.32237386681649
23983,527365.7,5332845.195,95,81,14,32.34,0,2012,2,121,324,178,0.868132685940299,38.5,18.2296703296703,57,1257.09364717112,1.32237386681649
23983,527365.7,5332845.195,189,73,116,17.095,1,2013,3,137,308,194,0.864369921883359,-164.8,18.7813186813187,57,1257.09364717112,1.32237386681649
23983,527365.7,5332845.195,146,53,93,53.918,5,2014,3,85,336,185,0.835337722017259,101.8,17.4461538461538,100,1257.09364717112,1.32237386681649
23983,527365.7,5332845.195,166,93,73,38.306,0,2015,2,111,352,242,0.804398738576845,-192.4,20.4978021978022,131,1257.09364717112,1.32237386681649
23983,527365.7,5332845.195,175,93,82,36.388,2,2016,2,118,351,209,0.879906851723396,-4.8,18.6318681318681,91,1257.09364717112,1.32237386681649
23983,527365.7,5332845.195,135,93,42,54.829,7,2017,2,88,321,209,0.841913640819986,-54.4,19.6516483516484,121,1257.09364717112,1.32237386681649
23983,527365.7,5332845.195,156,79,77,35.732,0,2018,2,111,352,178,0.851805839014086,-121.8,20.367032967033,67,1257.09364717112,1.32237386681649
23983,527365.7,5332845.195,166,93,73,27.154,3,2019,2,123,338,194,0.851679342128571,-107,20.478021978022,71,1257.09364717112,1.32237386681649
23983,527365.7,5332845.195,0,0,0,40.121,0,2020,0,95,328,185,0.825851759201967,-91.9,18.7142857142857,90,1257.09364717112,1.32237386681649
23984,527365.7,5332613.539,0,0,0,50.516,0,2001,2,103,321,194,0.849163229223599,10.6,17.710989010989,91,1271.93830671022,-0.922864326962451
23984,527365.7,5332613.539,0,0,0,44.84,0,2002,0,105,334,201,0.803715958093478,25.6,17.9494505494505,96,1271.93830671022,-0.922864326962451
23984,527365.7,5332613.539,0,0,0,37.444,0,2003,0,109,331,185,0.815589695246671,-201.3,22.6626373626374,76,1271.93830671022,-0.922864326962451
23984,527365.7,5332613.539,154,93,61,27.357,0,2004,2,123,331,225,0.838372840096378,132.4,17.5076923076923,102,1271.93830671022,-0.922864326962451
23984,527365.7,5332613.539,143,110,33,58.644,2,2005,1,97,316,186,0.83776531188564,-23.3,17.6,89,1271.93830671022,-0.922864326962451
23984,527365.7,5332613.539,193,71,122,24.696,1,2006,3,129,336,201,0.851712914229083,50,18.6131868131868,72,1271.93830671022,-0.922864326962451
23984,527365.7,5332613.539,0,0,0,136.126,0,2007,0,16,301,184,0.936635841987057,269.6,16.9021978021978,168,1271.93830671022,-0.922864326962451
23984,527365.7,5332613.539,0,0,0,17.673,0,2008,0,130,317,209,0.843915728462486,38,17.3098901098901,79,1271.93830671022,-0.922864326962451
23984,527365.7,5332613.539,161,71,90,29.679,0,2009,3,117,289,185,0.871998259594594,34.6,18.2571428571429,68,1271.93830671022,-0.922864326962451
23984,527365.7,5332613.539,167,93,74,37.95,0,2010,2,111,322,202,0.892909121277693,95.1,17.9945054945055,91,1271.93830671022,-0.922864326962451
23984,527365.7,5332613.539,118,93,25,68.442,6,2011,1,65,326,177,0.805363953824175,139.3,17.1164835164835,112,1271.93830671022,-0.922864326962451
23984,527365.7,5332613.539,157,81,76,30.246,0,2012,3,123,320,185,0.866143191232863,38.5,18.2296703296703,62,1271.93830671022,-0.922864326962451
23984,527365.7,5332613.539,173,74,99,20.056,1,2013,3,134,301,193,0.864877028749682,-164.8,18.7813186813187,59,1271.93830671022,-0.922864326962451
23984,527365.7,5332613.539,96,59,37,51.207,3,2014,3,88,335,218,0.854292081551617,101.8,17.4461538461538,130,1271.93830671022,-0.922864326962451
23984,527365.7,5332613.539,151,93,58,35.812,0,2015,2,114,349,193,0.838913640551302,-192.4,20.4978021978022,79,1271.93830671022,-0.922864326962451
23984,527365.7,5332613.539,161,99,62,39.568,5,2016,2,115,347,217,0.875438745688166,-4.8,18.6318681318681,102,1271.93830671022,-0.922864326962451
23984,527365.7,5332613.539,96,93,3,72.7,8,2017,2,72,312,202,0.863436619945368,-54.4,19.6516483516484,130,1271.93830671022,-0.922864326962451
23984,527365.7,5332613.539,142,68,74,36.723,0,2018,3,110,353,186,0.847422851943561,-121.8,20.367032967033,76,1271.93830671022,-0.922864326962451
23984,527365.7,5332613.539,150,94,56,36.935,3,2019,2,112,339,201,0.8381186762736,-107,20.478021978022,89,1271.93830671022,-0.922864326962451
23984,527365.7,5332613.539,0,0,0,52.289,0,2020,0,82,326,225,0.820324604039507,-91.9,18.7142857142857,143,1271.93830671022,-0.922864326962451
24109,527597.356,5354389.237,0,0,0,151.375,0,2001,1,15,345,224,0.821101392908793,4.09999999999999,18.2296703296703,209,1159.49399708557,-0.338753860411452
24109,527597.356,5354389.237,93,93,0,82.051,11,2002,2,69,323,248,0.827591718064712,18.8,18.3868131868132,179,1159.49399708557,-0.338753860411452
24109,527597.356,5354389.237,155,93,62,43.182,2,2003,1,101,281,169,0.840992631397194,-204,23.121978021978,68,1159.49399708557,-0.338753860411452
24109,527597.356,5354389.237,123,42,81,30.038,0,2004,3,119,342,202,0.84482283804009,123.8,17.9692307692308,83,1159.49399708557,-0.338753860411452
24109,527597.356,5354389.237,150,93,57,82.153,2,2005,4,75,312,258,0.818210548307407,-31.4,18.0615384615385,183,1159.49399708557,-0.338753860411452
24109,527597.356,5354389.237,173,73,100,34.723,0,2006,3,118,348,313,0.836140137467869,43,19.0516483516484,195,1159.49399708557,-0.338753860411452
24109,527597.356,5354389.237,0,0,0,97.845,0,2007,0,48,321,232,0.837585698122112,258.5,17.3142857142857,184,1159.49399708557,-0.338753860411452
24109,527597.356,5354389.237,86,85,1,131.523,36,2008,1,24,326,225,0.860899513586475,29.3,17.7417582417582,201,1159.49399708557,-0.338753860411452
24109,527597.356,5354389.237,167,69,98,39.188,0,2009,2,106,307,209,0.841696799988302,27.1,18.689010989011,103,1159.49399708557,-0.338753860411452
24109,527597.356,5354389.237,148,93,55,65.969,4,2010,2,86,316,216,0.846969128485757,87.4,18.4241758241758,130,1159.49399708557,-0.338753860411452
24109,527597.356,5354389.237,86,71,15,123.752,38,2011,1,12,347,320,0.854349671658742,129,17.5824175824176,308,1159.49399708557,-0.338753860411452
24109,527597.356,5354389.237,0,0,0,91.076,0,2012,0,58,318,184,0.850202821319278,29,18.7703296703297,126,1159.49399708557,-0.338753860411452
24109,527597.356,5354389.237,161,63,98,47.288,0,2013,3,108,324,217,0.858237474393258,-172.4,19.2857142857143,109,1159.49399708557,-0.338753860411452
24109,527597.356,5354389.237,0,0,0,115.265,0,2014,0,23,314,193,0.856849366435583,91.5,17.9450549450549,170,1159.49399708557,-0.338753860411452
24109,527597.356,5354389.237,86,67,19,68.157,5,2015,1,81,348,305,0.898011363115474,-197.8,21,224,1159.49399708557,-0.338753860411452
24109,527597.356,5354389.237,0,0,0,146.136,0,2016,0,19,351,313,0.89565490398864,-13,19.132967032967,294,1159.49399708557,-0.338753860411452
24109,527597.356,5354389.237,0,0,0,116.561,0,2017,0,32,321,274,0.869254543100643,-57.8,20.1032967032967,242,1159.49399708557,-0.338753860411452
24109,527597.356,5354389.237,86,77,9,141.208,47,2018,1,15,337,297,0.863916704342085,-125.4,20.7956043956044,282,1159.49399708557,-0.338753860411452
24109,527597.356,5354389.237,0,0,0,109.396,0,2019,0,43,335,265,0.828437635525853,-108.1,20.8824175824176,222,1159.49399708557,-0.338753860411452
24109,527597.356,5354389.237,0,0,0,92.347,0,2020,0,46,331,225,0.807741848398372,-97.4,19.156043956044,179,1159.49399708557,-0.338753860411452
24134,527597.356,5348597.828,0,0,0,69.771,0,2001,1,85,314,153,0.812166072288892,-10.6,19.1659340659341,68,997.658454228936,0.0350067152565358
24134,527597.356,5348597.828,140,52,88,48.046,1,2002,3,98,337,241,0.813762779156834,6.29999999999999,19.1637362637363,143,997.658454228936,0.0350067152565358
24134,527597.356,5348597.828,156,95,61,45.717,6,2003,1,96,329,153,0.849929832174147,-207.1,23.9516483516484,57,997.658454228936,0.0350067152565358
24134,527597.356,5348597.828,149,93,56,49.639,1,2004,2,98,325,240,0.80791039477185,109,18.7549450549451,142,997.658454228936,0.0350067152565358
24134,527597.356,5348597.828,153,94,59,69.29,2,2005,2,84,318,241,0.790611634053326,-46.2,18.9098901098901,157,997.658454228936,0.0350067152565358
24134,527597.356,5348597.828,186,71,115,49.796,0,2006,3,102,346,258,0.799434710809423,29.4,19.8868131868132,156,997.658454228936,0.0350067152565358
24134,527597.356,5348597.828,0,0,0,86.917,0,2007,0,57,310,153,0.868076689652892,236.4,18.0659340659341,96,997.658454228936,0.0350067152565358
24134,527597.356,5348597.828,86,60,26,83.979,13,2008,1,68,311,154,0.827784078335516,13.4,18.4934065934066,86,997.658454228936,0.0350067152565358
24134,527597.356,5348597.828,166,60,106,57.288,0,2009,2,85,328,152,0.803484726868055,14,19.4461538461538,67,997.658454228936,0.0350067152565358
24134,527597.356,5348597.828,165,115,50,41.304,0,2010,1,102,307,161,0.800120132062538,69.3,19.1879120879121,59,997.658454228936,0.0350067152565358
24134,527597.356,5348597.828,83,52,31,58.684,3,2011,1,67,327,146,0.796832297174466,108.7,18.4846153846154,79,997.658454228936,0.0350067152565358
24134,527597.356,5348597.828,151,81,70,54.047,3,2012,2,95,322,161,0.838405115112874,6.9,19.8923076923077,66,997.658454228936,0.0350067152565358
24134,527597.356,5348597.828,176,93,83,44.046,0,2013,1,109,305,176,0.799812817163798,-187.7,20.2681318681319,67,997.658454228936,0.0350067152565358
24134,527597.356,5348597.828,93,47,46,60.727,3,2014,3,72,322,201,0.787748879972091,71,18.9736263736264,129,997.658454228936,0.0350067152565358
24134,527597.356,5348597.828,158,94,64,62.946,4,2015,1,85,312,153,0.827050279417196,-210.3,22.0318681318681,68,997.658454228936,0.0350067152565358
24134,527597.356,5348597.828,170,121,49,58.412,4,2016,2,96,337,233,0.769703733988247,-28.3,20.1868131868132,137,997.658454228936,0.0350067152565358
24134,527597.356,5348597.828,129,98,31,53.259,6,2017,2,86,302,217,0.801521133846985,-67,20.9692307692308,131,997.658454228936,0.0350067152565358
24134,527597.356,5348597.828,154,60,94,54.503,0,2018,2,90,319,160,0.788962049348278,-134,21.621978021978,70,997.658454228936,0.0350067152565358
24134,527597.356,5348597.828,149,97,52,54.223,8,2019,1,92,303,168,0.807279014682275,-110.8,21.721978021978,76,997.658454228936,0.0350067152565358
24134,527597.356,5348597.828,86,63,23,46.623,10,2020,1,84,321,162,0.778756182205917,-108.6,20.0032967032967,78,997.658454228936,0.0350067152565358
24135,527597.356,5348366.171,0,0,0,125.863,0,2001,2,37,322,153,0.786735614239295,-10.6,19.1659340659341,116,985.086590804404,1.19636003302995
24135,527597.356,5348366.171,111,61,50,46.383,1,2002,2,100,340,162,0.782824421920305,6.29999999999999,19.1637362637363,62,985.086590804404,1.19636003302995
24135,527597.356,5348366.171,151,94,57,48.507,9,2003,1,93,326,153,0.797263363584128,-207.1,23.9516483516484,60,985.086590804404,1.19636003302995
24135,527597.356,5348366.171,144,94,50,59.309,2,2004,1,88,328,153,0.792825608621543,109,18.7549450549451,65,985.086590804404,1.19636003302995
24135,527597.356,5348366.171,150,93,57,68.247,2,2005,1,85,317,154,0.823796318935062,-46.2,18.9098901098901,69,985.086590804404,1.19636003302995
24135,527597.356,5348366.171,192,58,134,36.635,0,2006,3,114,346,161,0.822170526437679,29.4,19.8868131868132,47,985.086590804404,1.19636003302995
24135,527597.356,5348366.171,0,0,0,81.942,0,2007,0,61,303,169,0.823038808656072,236.4,18.0659340659341,108,985.086590804404,1.19636003302995
24135,527597.356,5348366.171,93,56,37,103.607,20,2008,2,48,315,177,0.797461100423322,13.4,18.4934065934066,129,985.086590804404,1.19636003302995
24135,527597.356,5348366.171,167,63,104,47.787,0,2009,2,93,327,161,0.810867252129726,14,19.4461538461538,68,985.086590804404,1.19636003302995
24135,527597.356,5348366.171,160,100,60,41.304,0,2010,1,102,306,161,0.78766821234524,69.3,19.1879120879121,59,985.086590804404,1.19636003302995
24135,527597.356,5348366.171,0,0,0,58.684,0,2011,0,67,324,154,0.796416763335278,108.7,18.4846153846154,87,985.086590804404,1.19636003302995
24135,527597.356,5348366.171,151,81,70,52.541,3,2012,2,97,321,168,0.833124457097661,6.9,19.8923076923077,71,985.086590804404,1.19636003302995
24135,527597.356,5348366.171,175,99,76,57.094,2,2013,1,97,305,169,0.799019906253594,-187.7,20.2681318681319,72,985.086590804404,1.19636003302995
24135,527597.356,5348366.171,126,63,63,64.389,3,2014,3,68,322,217,0.815618751009841,71,18.9736263736264,149,985.086590804404,1.19636003302995
24135,527597.356,5348366.171,158,93,65,55.068,4,2015,1,93,316,145,0.818515588964322,-210.3,22.0318681318681,52,985.086590804404,1.19636003302995
24135,527597.356,5348366.171,165,64,101,59.372,4,2016,3,95,332,208,0.802482489046315,-28.3,20.1868131868132,113,985.086590804404,1.19636003302995
24135,527597.356,5348366.171,130,93,37,57.363,6,2017,2,82,326,217,0.787937612579234,-67,20.9692307692308,135,985.086590804404,1.19636003302995
24135,527597.356,5348366.171,157,83,74,54.503,0,2018,2,90,317,153,0.802494265581175,-134,21.621978021978,63,985.086590804404,1.19636003302995
24135,527597.356,5348366.171,0,0,0,55.099,0,2019,0,91,308,161,0.7808827182094,-110.8,21.721978021978,70,985.086590804404,1.19636003302995
24135,527597.356,5348366.171,86,74,12,106.263,23,2020,1,33,341,169,0.788316175651103,-108.6,20.0032967032967,136,985.086590804404,1.19636003302995
24200,527597.356,5333308.508,0,0,0,65.552,0,2001,3,90,309,186,0.844332289839465,10.6,17.710989010989,96,1260.76792123758,1.40831151771194
24200,527597.356,5333308.508,86,71,15,35.472,0,2002,1,115,309,184,0.815655923625811,25.6,17.9494505494505,69,1260.76792123758,1.40831151771194
24200,527597.356,5333308.508,154,99,55,38.332,1,2003,1,108,332,169,0.797693668533387,-201.3,22.6626373626374,61,1260.76792123758,1.40831151771194
24200,527597.356,5333308.508,144,94,50,33.772,0,2004,2,116,336,209,0.798341427303911,132.4,17.5076923076923,93,1260.76792123758,1.40831151771194
24200,527597.356,5333308.508,152,94,58,51.396,0,2005,2,103,309,185,0.821371671298468,-23.3,17.6,82,1260.76792123758,1.40831151771194
24200,527597.356,5333308.508,187,59,128,44.475,2,2006,3,111,343,224,0.824673241709116,50,18.6131868131868,113,1260.76792123758,1.40831151771194
24200,527597.356,5333308.508,0,0,0,45.967,0,2007,0,96,303,224,0.822773454209237,269.6,16.9021978021978,128,1260.76792123758,1.40831151771194
24200,527597.356,5333308.508,0,0,0,22.012,0,2008,0,125,305,216,0.840866859060038,38,17.3098901098901,91,1260.76792123758,1.40831151771194
24200,527597.356,5333308.508,173,59,114,38.559,0,2009,2,108,297,178,0.864249980651824,34.6,18.2571428571429,70,1260.76792123758,1.40831151771194
24200,527597.356,5333308.508,176,93,83,32.946,0,2010,2,116,309,200,0.836541955684395,95.1,17.9945054945055,84,1260.76792123758,1.40831151771194
24200,527597.356,5333308.508,82,66,16,49.664,0,2011,1,84,325,257,0.772623815938036,139.3,17.1164835164835,173,1260.76792123758,1.40831151771194
24200,527597.356,5333308.508,158,98,60,43.011,0,2012,2,111,319,200,0.834724589622189,38.5,18.2296703296703,89,1260.76792123758,1.40831151771194
24200,527597.356,5333308.508,187,93,94,18.097,1,2013,2,136,300,193,0.852763971890319,-164.8,18.7813186813187,57,1260.76792123758,1.40831151771194
24200,527597.356,5333308.508,152,47,105,43.8,3,2014,2,97,347,177,0.841938546295896,101.8,17.4461538461538,80,1260.76792123758,1.40831151771194
24200,527597.356,5333308.508,165,93,72,49.863,0,2015,1,99,346,177,0.788686472837041,-192.4,20.4978021978022,78,1260.76792123758,1.40831151771194
24200,527597.356,5333308.508,169,93,76,39.568,5,2016,2,115,343,194,0.876375586843606,-4.8,18.6318681318681,79,1260.76792123758,1.40831151771194
24200,527597.356,5333308.508,144,100,44,56.909,7,2017,1,86,303,185,0.828839025065612,-54.4,19.6516483516484,99,1260.76792123758,1.40831151771194
24200,527597.356,5333308.508,163,58,105,45.596,0,2018,3,102,348,202,0.805399589797262,-121.8,20.367032967033,100,1260.76792123758,1.40831151771194
24200,527597.356,5333308.508,169,93,76,35.239,3,2019,1,114,337,178,0.835288972522473,-107,20.478021978022,64,1260.76792123758,1.40831151771194
24200,527597.356,5333308.508,0,0,0,125.837,0,2020,0,18,326,192,0.826016101652423,-91.9,18.7142857142857,174,1260.76792123758,1.40831151771194
24331,527829.012,5353694.268,0,0,0,136.542,0,2001,1,29,330,200,0.845237306547149,4.09999999999999,18.2296703296703,171,1040.34936340889,1.42563474350875
24331,527829.012,5353694.268,106,64,42,60.755,5,2002,3,87,300,186,0.836003553574768,18.8,18.3868131868132,99,1040.34936340889,1.42563474350875
24331,527829.012,5353694.268,145,93,52,42.23,1,2003,1,102,314,177,0.868422170420229,-204,23.121978021978,75,1040.34936340889,1.42563474350875
24331,527829.012,5353694.268,141,44,97,46.42,0,2004,3,102,338,193,0.830603703003929,123.8,17.9692307692308,91,1040.34936340889,1.42563474350875
24331,527829.012,5353694.268,157,75,82,58.515,2,2005,2,96,313,177,0.855237999023549,-31.4,18.0615384615385,81,1040.34936340889,1.42563474350875
24331,527829.012,5353694.268,186,66,120,30.549,0,2006,3,122,346,185,0.840186173922839,43,19.0516483516484,63,1040.34936340889,1.42563474350875
24331,527829.012,5353694.268,0,0,0,69.826,0,2007,0,72,305,201,0.873495737677701,258.5,17.3142857142857,129,1040.34936340889,1.42563474350875
24331,527829.012,5353694.268,86,81,5,107.647,25,2008,1,46,315,176,0.802083041992592,29.3,17.7417582417582,130,1040.34936340889,1.42563474350875
24331,527829.012,5353694.268,169,69,100,36.142,0,2009,2,109,305,178,0.882055745861005,27.1,18.689010989011,69,1040.34936340889,1.42563474350875
24331,527829.012,5353694.268,162,93,69,43.367,0,2010,1,104,310,177,0.825886909695836,87.4,18.4241758241758,73,1040.34936340889,1.42563474350875
24331,527829.012,5353694.268,85,63,22,60.074,3,2011,1,71,324,186,0.80461162065124,129,17.5824175824176,115,1040.34936340889,1.42563474350875
24331,527829.012,5353694.268,145,95,50,52.388,3,2012,1,99,300,177,0.8300494801096,29,18.7703296703297,78,1040.34936340889,1.42563474350875
24331,527829.012,5353694.268,151,61,90,47.288,0,2013,3,108,306,209,0.853287988070739,-172.4,19.2857142857143,101,1040.34936340889,1.42563474350875
24331,527829.012,5353694.268,86,50,36,98.067,19,2014,1,40,343,217,0.835903048951984,91.5,17.9450549450549,177,1040.34936340889,1.42563474350875
24331,527829.012,5353694.268,147,94,53,44.917,0,2015,2,103,331,201,0.860684777543438,-197.8,21,98,1040.34936340889,1.42563474350875
24331,527829.012,5353694.268,159,93,66,48.062,5,2016,1,107,343,177,0.881510360663682,-13,19.132967032967,70,1040.34936340889,1.42563474350875
24331,527829.012,5353694.268,105,94,11,47.442,6,2017,2,94,323,233,0.82414518000865,-57.8,20.1032967032967,139,1040.34936340889,1.42563474350875
24331,527829.012,5353694.268,152,120,32,48.587,0,2018,1,98,326,169,0.852564958323907,-125.4,20.7956043956044,71,1040.34936340889,1.42563474350875
24331,527829.012,5353694.268,136,84,52,51.435,7,2019,3,96,331,201,0.856480395912327,-108.1,20.8824175824176,105,1040.34936340889,1.42563474350875
24331,527829.012,5353694.268,0,0,0,49.43,0,2020,0,83,319,217,0.805635670689514,-97.4,19.156043956044,134,1040.34936340889,1.42563474350875
24335,527829.012,5352767.642,0,0,0,97.034,0,2001,2,65,341,193,0.789634148881426,4.09999999999999,18.2296703296703,128,1051.90633238944,0.0849627665536419
24335,527829.012,5352767.642,86,61,25,83.2,11,2002,1,68,332,241,0.795127503211364,18.8,18.3868131868132,173,1051.90633238944,0.0849627665536419
24335,527829.012,5352767.642,152,93,59,56.116,10,2003,1,88,339,161,0.804136239505064,-204,23.121978021978,73,1051.90633238944,0.0849627665536419
24335,527829.012,5352767.642,147,93,54,60.42,4,2004,2,89,344,209,0.792500801621443,123.8,17.9692307692308,120,1051.90633238944,0.0849627665536419
24335,527829.012,5352767.642,93,93,0,74.252,2,2005,2,82,318,266,0.791858903304393,-31.4,18.0615384615385,184,1051.90633238944,0.0849627665536419
24335,527829.012,5352767.642,184,66,118,39.166,0,2006,3,114,348,258,0.808455781684882,43,19.0516483516484,144,1051.90633238944,0.0849627665536419
24335,527829.012,5352767.642,0,0,0,123.542,0,2007,0,25,333,208,0.818786524001198,258.5,17.3142857142857,183,1051.90633238944,0.0849627665536419
24335,527829.012,5352767.642,93,93,0,122.795,33,2008,1,32,313,176,0.814278214498393,29.3,17.7417582417582,144,1051.90633238944,0.0849627665536419
24335,527829.012,5352767.642,171,66,105,46.893,0,2009,2,99,313,177,0.850434899010382,27.1,18.689010989011,78,1051.90633238944,0.0849627665536419
24335,527829.012,5352767.642,162,93,69,56.987,2,2010,2,93,309,184,0.807684683764112,87.4,18.4241758241758,91,1051.90633238944,0.0849627665536419
24335,527829.012,5352767.642,93,93,0,81.257,19,2011,2,50,330,281,0.802168924274282,129,17.5824175824176,231,1051.90633238944,0.0849627665536419
24335,527829.012,5352767.642,144,93,51,69.942,5,2012,1,79,318,178,0.829421597807778,29,18.7703296703297,99,1051.90633238944,0.0849627665536419
24335,527829.012,5352767.642,171,93,78,48.502,0,2013,2,107,312,193,0.82234518812048,-172.4,19.2857142857143,86,1051.90633238944,0.0849627665536419
24335,527829.012,5352767.642,0,0,0,111.231,0,2014,0,27,349,289,0.8260111843582,91.5,17.9450549450549,262,1051.90633238944,0.0849627665536419
24335,527829.012,5352767.642,150,94,56,70.137,5,2015,1,79,347,178,0.831880542359209,-197.8,21,99,1051.90633238944,0.0849627665536419
24335,527829.012,5352767.642,162,93,69,62.625,5,2016,2,93,347,225,0.832323069932563,-13,19.132967032967,132,1051.90633238944,0.0849627665536419
24335,527829.012,5352767.642,0,0,0,84.433,0,2017,0,61,332,161,0.852721501093054,-57.8,20.1032967032967,100,1051.90633238944,0.0849627665536419
24335,527829.012,5352767.642,156,123,33,55.675,1,2018,1,92,330,184,0.82496015793859,-125.4,20.7956043956044,92,1051.90633238944,0.0849627665536419
24335,527829.012,5352767.642,129,85,44,78.446,15,2019,3,71,345,225,0.853378261624533,-108.1,20.8824175824176,154,1051.90633238944,0.0849627665536419
24335,527829.012,5352767.642,0,0,0,89.921,0,2020,0,48,342,218,0.793940564035411,-97.4,19.156043956044,170,1051.90633238944,0.0849627665536419
24336,527829.012,5352535.986,0,0,0,69.773,0,2001,1,86,338,186,0.813707651349357,4.09999999999999,18.2296703296703,100,1019.18129820601,1.25072438268758
24336,527829.012,5352535.986,86,75,11,69.61,10,2002,1,80,334,241,0.802836939261206,18.8,18.3868131868132,161,1019.18129820601,1.25072438268758
24336,527829.012,5352535.986,149,93,56,67.472,12,2003,1,77,338,153,0.789366072173868,-204,23.121978021978,76,1019.18129820601,1.25072438268758
24336,527829.012,5352535.986,122,94,28,58.364,3,2004,2,91,339,185,0.7983547938244,123.8,17.9692307692308,94,1019.18129820601,1.25072438268758
24336,527829.012,5352535.986,0,0,0,140.737,0,2005,0,21,323,170,0.808344469910656,-31.4,18.0615384615385,149,1019.18129820601,1.25072438268758
24336,527829.012,5352535.986,165,94,71,52.88,0,2006,2,103,350,264,0.789957826701531,43,19.0516483516484,161,1019.18129820601,1.25072438268758
24336,527829.012,5352535.986,0,0,0,122.415,0,2007,0,26,320,176,0.808610208377347,258.5,17.3142857142857,150,1019.18129820601,1.25072438268758
24336,527829.012,5352535.986,0,0,0,128.106,0,2008,0,27,311,176,0.832808218201753,29.3,17.7417582417582,149,1019.18129820601,1.25072438268758
24336,527829.012,5352535.986,163,67,96,45.721,0,2009,2,100,322,176,0.857936360298316,27.1,18.689010989011,76,1019.18129820601,1.25072438268758
24336,527829.012,5352535.986,167,93,74,47.973,2,2010,1,100,307,177,0.81097307131177,87.4,18.4241758241758,77,1019.18129820601,1.25072438268758
24336,527829.012,5352535.986,86,63,23,71.019,11,2011,1,60,329,185,0.788606963728038,129,17.5824175824176,125,1019.18129820601,1.25072438268758
24336,527829.012,5352535.986,140,94,46,64.999,4,2012,1,84,307,178,0.815373677732023,29,18.7703296703297,94,1019.18129820601,1.25072438268758
24336,527829.012,5352535.986,172,62,110,37.588,0,2013,3,117,302,186,0.805226435322175,-172.4,19.2857142857143,69,1019.18129820601,1.25072438268758
24336,527829.012,5352535.986,85,85,0,106.184,21,2014,1,32,346,249,0.817314740284913,91.5,17.9450549450549,217,1019.18129820601,1.25072438268758
24336,527829.012,5352535.986,156,97,59,51.143,1,2015,1,97,346,177,0.821841144048301,-197.8,21,80,1019.18129820601,1.25072438268758
24336,527829.012,5352535.986,158,93,65,56.27,5,2016,2,99,342,201,0.866674999265317,-13,19.132967032967,102,1019.18129820601,1.25072438268758
24336,527829.012,5352535.986,113,93,20,79.342,7,2017,1,65,305,169,0.813820187319389,-57.8,20.1032967032967,104,1019.18129820601,1.25072438268758
24336,527829.012,5352535.986,86,53,33,132.523,41,2018,1,22,345,176,0.826772555557558,-125.4,20.7956043956044,154,1019.18129820601,1.25072438268758
24336,527829.012,5352535.986,133,93,40,63.922,10,2019,2,83,333,224,0.823067246620533,-108.1,20.8824175824176,141,1019.18129820601,1.25072438268758
24336,527829.012,5352535.986,0,0,0,89.921,0,2020,0,48,338,217,0.781782700543168,-97.4,19.156043956044,169,1019.18129820601,1.25072438268758
24419,527829.012,5333308.508,86,85,1,136.593,36,2001,2,30,305,185,0.840587243198389,10.6,17.710989010989,155,1208.80175718663,1.34654077027031
24419,527829.012,5333308.508,86,69,17,41.98,0,2002,1,108,320,178,0.820900879292738,25.6,17.9494505494505,70,1208.80175718663,1.34654077027031
24419,527829.012,5333308.508,156,93,63,41.134,1,2003,1,105,330,170,0.812932780781498,-201.3,22.6626373626374,65,1208.80175718663,1.34654077027031
24419,527829.012,5333308.508,157,93,64,32.816,0,2004,2,117,336,186,0.81865798714914,132.4,17.5076923076923,69,1208.80175718663,1.34654077027031
24419,527829.012,5333308.508,153,94,59,54.962,1,2005,1,100,315,177,0.822851414066353,-23.3,17.6,77,1208.80175718663,1.34654077027031
24419,527829.012,5333308.508,192,63,129,28.544,1,2006,2,125,345,178,0.810568703020753,50,18.6131868131868,53,1208.80175718663,1.34654077027031
24419,527829.012,5333308.508,0,0,0,51.097,0,2007,0,91,303,200,0.828443500707925,269.6,16.9021978021978,109,1208.80175718663,1.34654077027031
24419,527829.012,5333308.508,106,93,13,45.444,2,2008,2,104,312,216,0.822065014176358,38,17.3098901098901,112,1208.80175718663,1.34654077027031
24419,527829.012,5333308.508,176,65,111,36.405,0,2009,2,110,302,176,0.866216633633257,34.6,18.2571428571429,66,1208.80175718663,1.34654077027031
24419,527829.012,5333308.508,158,93,65,35.884,0,2010,2,113,313,193,0.821589098733581,95.1,17.9945054945055,80,1208.80175718663,1.34654077027031
24419,527829.012,5333308.508,86,72,14,53.569,2,2011,1,80,325,256,0.777321097122759,139.3,17.1164835164835,176,1208.80175718663,1.34654077027031
24419,527829.012,5333308.508,152,94,58,42.059,0,2012,2,112,307,185,0.823843261071216,38.5,18.2296703296703,73,1208.80175718663,1.34654077027031
24419,527829.012,5333308.508,177,59,118,56.805,1,2013,2,102,315,185,0.8412238626236,-164.8,18.7813186813187,83,1208.80175718663,1.34654077027031
24419,527829.012,5333308.508,154,65,89,43.8,3,2014,3,97,323,176,0.828481790030416,101.8,17.4461538461538,79,1208.80175718663,1.34654077027031
24419,527829.012,5333308.508,157,93,64,48.782,0,2015,1,100,345,169,0.825836999316592,-192.4,20.4978021978022,69,1208.80175718663,1.34654077027031
24419,527829.012,5333308.508,169,93,76,45.1,5,2016,2,110,344,208,0.878973873907943,-4.8,18.6318681318681,98,1208.80175718663,1.34654077027031
24419,527829.012,5333308.508,141,95,46,55.859,7,2017,2,87,313,185,0.830647094377527,-54.4,19.6516483516484,98,1208.80175718663,1.34654077027031
24419,527829.012,5333308.508,169,71,98,43.278,0,2018,2,104,323,170,0.837272359604555,-121.8,20.367032967033,66,1208.80175718663,1.34654077027031
24419,527829.012,5333308.508,163,93,70,41.579,3,2019,1,107,338,177,0.834896524613358,-107,20.478021978022,70,1208.80175718663,1.34654077027031
24419,527829.012,5333308.508,0,0,0,121.047,0,2020,0,23,328,192,0.831667783834642,-91.9,18.7142857142857,169,1208.80175718663,1.34654077027031
24551,528060.669,5353462.611,0,0,0,139.961,0,2001,1,26,304,193,0.85531447750864,4.09999999999999,18.2296703296703,167,993.821009642633,1.49896678100362
24551,528060.669,5353462.611,86,61,25,59.622,4,2002,1,88,314,202,0.858435848076925,18.8,18.3868131868132,114,993.821009642633,1.49896678100362
24551,528060.669,5353462.611,157,95,62,38.548,1,2003,1,106,329,176,0.861151338753595,-204,23.121978021978,70,993.821009642633,1.49896678100362
24551,528060.669,5353462.611,153,93,60,44.264,0,2004,2,104,337,249,0.803628870520004,123.8,17.9692307692308,145,993.821009642633,1.49896678100362
24551,528060.669,5353462.611,152,93,59,59.552,2,2005,2,95,311,178,0.838999309219172,-31.4,18.0615384615385,83,993.821009642633,1.49896678100362
24551,528060.669,5353462.611,176,69,107,33.629,0,2006,2,119,344,177,0.836758860039466,43,19.0516483516484,58,993.821009642633,1.49896678100362
24551,528060.669,5353462.611,0,0,0,81.65,0,2007,0,62,308,224,0.845331213687114,258.5,17.3142857142857,162,993.821009642633,1.49896678100362
24551,528060.669,5353462.611,95,93,2,52.66,5,2008,2,97,319,234,0.835474046625639,29.3,17.7417582417582,137,993.821009642633,1.49896678100362
24551,528060.669,5353462.611,165,67,98,40.211,0,2009,3,105,306,185,0.873415110466494,27.1,18.689010989011,80,993.821009642633,1.49896678100362
24551,528060.669,5353462.611,162,93,69,44.49,0,2010,1,103,307,177,0.847022798463518,87.4,18.4241758241758,74,993.821009642633,1.49896678100362
24551,528060.669,5353462.611,86,65,21,59.124,3,2011,1,72,319,168,0.84266999514024,129,17.5824175824176,96,993.821009642633,1.49896678100362
24551,528060.669,5353462.611,144,93,51,57.984,4,2012,2,92,311,216,0.832773128857284,29,18.7703296703297,124,993.821009642633,1.49896678100362
24551,528060.669,5353462.611,159,64,95,40.607,0,2013,3,114,306,208,0.862948019803701,-172.4,19.2857142857143,94,993.821009642633,1.49896678100362
24551,528060.669,5353462.611,93,60,33,58.044,7,2014,3,78,341,216,0.846057687557115,91.5,17.9450549450549,138,993.821009642633,1.49896678100362
24551,528060.669,5353462.611,0,0,0,51.143,0,2015,0,97,333,217,0.847522126368964,-197.8,21,120,993.821009642633,1.49896678100362
24551,528060.669,5353462.611,165,93,72,49.129,5,2016,2,106,345,184,0.87402776154198,-13,19.132967032967,78,993.821009642633,1.49896678100362
24551,528060.669,5353462.611,116,94,22,47.442,6,2017,1,94,306,161,0.852922965100647,-57.8,20.1032967032967,67,993.821009642633,1.49896678100362
24551,528060.669,5353462.611,158,122,36,46.272,0,2018,1,100,321,193,0.842563895653382,-125.4,20.7956043956044,93,993.821009642633,1.49896678100362
24551,528060.669,5353462.611,144,93,51,54.222,9,2019,2,93,327,218,0.877650439111672,-108.1,20.8824175824176,125,993.821009642633,1.49896678100362
24551,528060.669,5353462.611,0,0,0,46.591,0,2020,0,86,329,177,0.819841668090368,-97.4,19.156043956044,91,993.821009642633,1.49896678100362
24552,528060.669,5353230.955,0,0,0,144.208,0,2001,1,22,338,248,0.833593255251835,4.09999999999999,18.2296703296703,226,1030.32866356823,1.07360945426211
24552,528060.669,5353230.955,86,68,18,65.588,9,2002,1,83,321,186,0.847954878640275,18.8,18.3868131868132,103,1030.32866356823,1.07360945426211
24552,528060.669,5353230.955,155,93,62,41.284,1,2003,1,103,322,160,0.838638017650988,-204,23.121978021978,57,1030.32866356823,1.07360945426211
24552,528060.669,5353230.955,154,57,97,36.37,0,2004,2,112,341,169,0.817266857073048,123.8,17.9692307692308,57,1030.32866356823,1.07360945426211
24552,528060.669,5353230.955,151,128,23,60.605,2,2005,1,94,316,162,0.830947561445069,-31.4,18.0615384615385,68,1030.32866356823,1.07360945426211
24552,528060.669,5353230.955,175,69,106,34.723,0,2006,3,118,346,234,0.812967519662211,43,19.0516483516484,116,1030.32866356823,1.07360945426211
24552,528060.669,5353230.955,0,0,0,99.076,0,2007,0,47,331,210,0.822158236130547,258.5,17.3142857142857,163,1030.32866356823,1.07360945426211
24552,528060.669,5353230.955,96,93,3,43.362,2,2008,2,105,322,256,0.829834992114092,29.3,17.7417582417582,151,1030.32866356823,1.07360945426211
24552,528060.669,5353230.955,175,67,108,34.171,0,2009,2,111,307,177,0.878729643705023,27.1,18.689010989011,66,1030.32866356823,1.07360945426211
24552,528060.669,5353230.955,162,93,69,45.632,1,2010,1,102,314,178,0.830614389966228,87.4,18.4241758241758,76,1030.32866356823,1.07360945426211
24552,528060.669,5353230.955,93,68,25,60.074,3,2011,2,71,323,169,0.818291043721452,129,17.5824175824176,98,1030.32866356823,1.07360945426211
24552,528060.669,5353230.955,147,94,53,53.983,3,2012,2,97,308,257,0.802635551339638,29,18.7703296703297,160,1030.32866356823,1.07360945426211
24552,528060.669,5353230.955,161,63,98,47.288,0,2013,3,108,307,194,0.828110647579967,-172.4,19.2857142857143,86,1030.32866356823,1.07360945426211
24552,528060.669,5353230.955,93,60,33,58.904,7,2014,3,77,346,226,0.851273873263916,91.5,17.9450549450549,149,1030.32866356823,1.07360945426211
24552,528060.669,5353230.955,0,0,0,51.143,0,2015,0,97,346,184,0.824491634424986,-197.8,21,87,1030.32866356823,1.07360945426211
24552,528060.669,5353230.955,154,93,61,74.884,8,2016,1,81,345,178,0.869682638334474,-13,19.132967032967,97,1030.32866356823,1.07360945426211
24552,528060.669,5353230.955,111,93,18,58.18,6,2017,1,83,308,162,0.85624642478577,-57.8,20.1032967032967,79,1030.32866356823,1.07360945426211
24552,528060.669,5353230.955,158,121,37,51.007,0,2018,1,96,328,178,0.826005459600254,-125.4,20.7956043956044,82,1030.32866356823,1.07360945426211
24552,528060.669,5353230.955,150,93,57,51.435,7,2019,1,96,326,176,0.836500145403373,-108.1,20.8824175824176,80,1030.32866356823,1.07360945426211
24552,528060.669,5353230.955,0,0,0,56.59,0,2020,0,76,333,176,0.807278393019819,-97.4,19.156043956044,100,1030.32866356823,1.07360945426211
24554,528060.669,5352767.642,0,0,0,84.279,0,2001,2,75,307,194,0.778077922941645,4.09999999999999,18.2296703296703,119,1012.35690967045,-0.234134176995035
24554,528060.669,5352767.642,86,50,36,74.427,10,2002,1,76,331,240,0.811112251828608,18.8,18.3868131868132,164,1012.35690967045,-0.234134176995035
24554,528060.669,5352767.642,148,93,55,59.093,10,2003,1,85,340,161,0.796357285635304,-204,23.121978021978,76,1012.35690967045,-0.234134176995035
24554,528060.669,5352767.642,147,93,54,58.364,3,2004,2,91,342,226,0.79803320320271,123.8,17.9692307692308,135,1012.35690967045,-0.234134176995035
24554,528060.669,5352767.642,93,93,0,75.377,2,2005,2,81,317,265,0.78442514451736,-31.4,18.0615384615385,184,1012.35690967045,-0.234134176995035
24554,528060.669,5352767.642,183,65,118,43.947,0,2006,3,110,346,257,0.805365616770481,43,19.0516483516484,147,1012.35690967045,-0.234134176995035
24554,528060.669,5352767.642,0,0,0,116.985,0,2007,0,31,336,202,0.835000456123611,258.5,17.3142857142857,171,1012.35690967045,-0.234134176995035
24554,528060.669,5352767.642,93,93,0,122.795,33,2008,1,32,320,168,0.816179555184261,29.3,17.7417582417582,136,1012.35690967045,-0.234134176995035
24554,528060.669,5352767.642,169,67,102,60.578,1,2009,2,88,325,177,0.843689295883875,27.1,18.689010989011,89,1012.35690967045,-0.234134176995035
24554,528060.669,5352767.642,166,93,73,43.367,0,2010,1,104,305,177,0.807548049712943,87.4,18.4241758241758,73,1012.35690967045,-0.234134176995035
24554,528060.669,5352767.642,93,93,0,79.223,17,2011,2,52,329,280,0.803767170792448,129,17.5824175824176,228,1012.35690967045,-0.234134176995035
24554,528060.669,5352767.642,147,93,54,72.876,5,2012,1,76,316,178,0.845015261401668,29,18.7703296703297,102,1012.35690967045,-0.234134176995035
24554,528060.669,5352767.642,174,93,81,44.976,0,2013,2,110,313,185,0.81115365856307,-172.4,19.2857142857143,75,1012.35690967045,-0.234134176995035
24554,528060.669,5352767.642,85,84,1,105.188,21,2014,1,33,348,281,0.826527953608193,91.5,17.9450549450549,248,1012.35690967045,-0.234134176995035
24554,528060.669,5352767.642,154,94,60,60.49,4,2015,1,89,348,178,0.825883930902452,-197.8,21,89,1012.35690967045,-0.234134176995035
24554,528060.669,5352767.642,161,93,68,62.625,5,2016,2,93,347,217,0.827105551666251,-13,19.132967032967,124,1012.35690967045,-0.234134176995035
24554,528060.669,5352767.642,0,0,0,85.682,0,2017,0,60,332,162,0.836534793480946,-57.8,20.1032967032967,102,1012.35690967045,-0.234134176995035
24554,528060.669,5352767.642,158,122,36,55.675,1,2018,1,92,330,185,0.823739119821323,-125.4,20.7956043956044,93,1012.35690967045,-0.234134176995035
24554,528060.669,5352767.642,127,85,42,78.446,15,2019,2,71,347,170,0.816734522874792,-108.1,20.8824175824176,99,1012.35690967045,-0.234134176995035
24554,528060.669,5352767.642,0,0,0,91.113,0,2020,0,47,343,178,0.794133594946,-97.4,19.156043956044,131,1012.35690967045,-0.234134176995035
24637,528060.669,5333540.164,86,86,0,145.423,40,2001,2,22,331,185,0.846166316696154,10.6,17.710989010989,163,1176.60300131528,-0.856560808251313
24637,528060.669,5333540.164,86,73,13,50.401,2,2002,1,99,345,177,0.828332519726294,25.6,17.9494505494505,78,1176.60300131528,-0.856560808251313
24637,528060.669,5333540.164,157,96,61,51.198,8,2003,1,95,336,170,0.805836341341368,-201.3,22.6626373626374,75,1176.60300131528,-0.856560808251313
24637,528060.669,5333540.164,154,93,61,44.129,0,2004,2,106,323,185,0.816840368474463,132.4,17.5076923076923,79,1176.60300131528,-0.856560808251313
24637,528060.669,5333540.164,151,94,57,67.617,2,2005,1,89,314,169,0.819836895136502,-23.3,17.6,80,1176.60300131528,-0.856560808251313
24637,528060.669,5333540.164,187,63,124,39.623,2,2006,3,115,346,186,0.795855057504125,50,18.6131868131868,71,1176.60300131528,-0.856560808251313
24637,528060.669,5333540.164,0,0,0,56.452,0,2007,0,86,303,224,0.842935166018212,269.6,16.9021978021978,138,1176.60300131528,-0.856560808251313
24637,528060.669,5333540.164,99,93,6,99.06,23,2008,2,57,316,209,0.82934459433939,38,17.3098901098901,152,1176.60300131528,-0.856560808251313
24637,528060.669,5333540.164,175,66,109,44.024,0,2009,2,103,315,170,0.85514388558224,34.6,18.2571428571429,67,1176.60300131528,-0.856560808251313
24637,528060.669,5333540.164,155,94,61,50.656,3,2010,2,100,316,193,0.821834153116944,95.1,17.9945054945055,93,1176.60300131528,-0.856560808251313
24637,528060.669,5333540.164,86,72,14,68.442,6,2011,1,65,329,169,0.810506489934593,139.3,17.1164835164835,104,1176.60300131528,-0.856560808251313
24637,528060.669,5333540.164,149,94,55,59.526,5,2012,2,92,311,224,0.816689376874033,38.5,18.2296703296703,132,1176.60300131528,-0.856560808251313
24637,528060.669,5333540.164,177,60,117,58.116,1,2013,3,101,319,193,0.834595840546862,-164.8,18.7813186813187,92,1176.60300131528,-0.856560808251313
24637,528060.669,5333540.164,151,67,84,48.627,3,2014,2,91,327,170,0.809046814530587,101.8,17.4461538461538,79,1176.60300131528,-0.856560808251313
24637,528060.669,5333540.164,159,94,65,56.912,5,2015,1,93,347,161,0.828074467142632,-192.4,20.4978021978022,68,1176.60300131528,-0.856560808251313
24637,528060.669,5333540.164,167,93,74,54.092,5,2016,2,102,348,208,0.866651287638465,-4.8,18.6318681318681,106,1176.60300131528,-0.856560808251313
24637,528060.669,5333540.164,141,95,46,61.308,7,2017,2,82,314,185,0.835890739556164,-54.4,19.6516483516484,103,1176.60300131528,-0.856560808251313
24637,528060.669,5333540.164,160,71,89,64.354,2,2018,3,86,327,288,0.827568702658065,-121.8,20.367032967033,202,1176.60300131528,-0.856560808251313
24637,528060.669,5333540.164,160,94,66,56.232,9,2019,1,92,340,177,0.837699858190454,-107,20.478021978022,85,1176.60300131528,-0.856560808251313
24637,528060.669,5333540.164,0,0,0,126.806,0,2020,0,17,330,192,0.828415111161172,-91.9,18.7142857142857,175,1176.60300131528,-0.856560808251313
24638,528060.669,5333308.508,86,85,1,140.01,39,2001,3,27,310,185,0.839920190891861,10.6,17.710989010989,158,1118.84749076616,1.51986539614062
24638,528060.669,5333308.508,86,72,14,50.401,2,2002,1,99,339,177,0.823043909378856,25.6,17.9494505494505,78,1118.84749076616,1.51986539614062
24638,528060.669,5333308.508,158,95,63,40.185,1,2003,1,106,330,162,0.802562456435726,-201.3,22.6626373626374,56,1118.84749076616,1.51986539614062
24638,528060.669,5333308.508,158,99,59,35.76,0,2004,2,114,338,200,0.812882120491922,132.4,17.5076923076923,86,1118.84749076616,1.51986539614062
24638,528060.669,5333308.508,157,98,59,56.203,2,2005,1,99,314,168,0.817404784769514,-23.3,17.6,69,1118.84749076616,1.51986539614062
24638,528060.669,5333308.508,186,63,123,40.802,2,2006,3,114,345,192,0.793811865060628,50,18.6131868131868,78,1118.84749076616,1.51986539614062
24638,528060.669,5333308.508,0,0,0,54.308,0,2007,0,88,304,209,0.824102929458424,269.6,16.9021978021978,121,1118.84749076616,1.51986539614062
24638,528060.669,5333308.508,99,93,6,67.297,9,2008,2,85,310,186,0.829993894302942,38,17.3098901098901,101,1118.84749076616,1.51986539614062
24638,528060.669,5333308.508,177,64,113,35.357,0,2009,2,111,312,170,0.861519294861933,34.6,18.2571428571429,59,1118.84749076616,1.51986539614062
24638,528060.669,5333308.508,157,94,63,41.192,0,2010,2,108,314,193,0.820376846158925,95.1,17.9945054945055,85,1118.84749076616,1.51986539614062
24638,528060.669,5333308.508,86,72,14,54.578,3,2011,1,79,324,154,0.78531803628349,139.3,17.1164835164835,75,1118.84749076616,1.51986539614062
24638,528060.669,5333308.508,149,94,55,59.526,5,2012,1,92,308,178,0.819025520916147,38.5,18.2296703296703,86,1118.84749076616,1.51986539614062
24638,528060.669,5333308.508,179,60,119,50.186,1,2013,2,107,315,178,0.832359249209488,-164.8,18.7813186813187,71,1118.84749076616,1.51986539614062
24638,528060.669,5333308.508,85,65,20,63.922,7,2014,1,74,325,169,0.808898453975898,101.8,17.4461538461538,95,1118.84749076616,1.51986539614062
24638,528060.669,5333308.508,159,93,66,48.782,0,2015,1,100,341,162,0.816171104563511,-192.4,20.4978021978022,62,1118.84749076616,1.51986539614062
24638,528060.669,5333308.508,169,102,67,48.748,5,2016,2,107,344,209,0.869412217036291,-4.8,18.6318681318681,102,1118.84749076616,1.51986539614062
24638,528060.669,5333308.508,139,96,43,52.814,7,2017,1,90,312,178,0.824125277626337,-54.4,19.6516483516484,88,1118.84749076616,1.51986539614062
24638,528060.669,5333308.508,165,71,94,52.727,0,2018,2,96,321,178,0.831699854570985,-121.8,20.367032967033,82,1118.84749076616,1.51986539614062
24638,528060.669,5333308.508,161,95,66,50.435,7,2019,1,98,342,170,0.834016191151724,-107,20.478021978022,72,1118.84749076616,1.51986539614062
24638,528060.669,5333308.508,0,0,0,113.229,0,2020,0,31,325,185,0.834002834034548,-91.9,18.7142857142857,154,1118.84749076616,1.51986539614062
24639,528060.669,5333076.852,0,0,0,146.433,0,2001,2,21,313,186,0.859656571125957,10.6,17.710989010989,165,1086.25960581832,-1.04504162552496
24639,528060.669,5333076.852,113,71,42,56.372,4,2002,3,93,348,184,0.812107162133346,25.6,17.9494505494505,91,1086.25960581832,-1.04504162552496
24639,528060.669,5333076.852,160,93,67,44.047,1,2003,1,102,332,161,0.825342265618939,-201.3,22.6626373626374,59,1086.25960581832,-1.04504162552496
24639,528060.669,5333076.852,149,103,46,44.129,0,2004,2,106,340,193,0.824786888529728,132.4,17.5076923076923,87,1086.25960581832,-1.04504162552496
24639,528060.669,5333076.852,154,108,46,58.644,2,2005,1,97,315,168,0.846191126881489,-23.3,17.6,71,1086.25960581832,-1.04504162552496
24639,528060.669,5333076.852,190,66,124,37.273,2,2006,2,117,347,161,0.819978331975264,50,18.6131868131868,44,1086.25960581832,-1.04504162552496
24639,528060.669,5333076.852,163,99,64,61.706,7,2007,2,81,313,233,0.82000521424811,269.6,16.9021978021978,152,1086.25960581832,-1.04504162552496
24639,528060.669,5333076.852,0,0,0,42.987,0,2008,0,106,315,185,0.826429811574275,38,17.3098901098901,79,1086.25960581832,-1.04504162552496
24639,528060.669,5333076.852,169,70,99,44.024,0,2009,2,103,324,170,0.87459811169331,34.6,18.2571428571429,67,1086.25960581832,-1.04504162552496
24639,528060.669,5333076.852,153,100,53,59.909,4,2010,1,93,320,169,0.832520685924968,95.1,17.9945054945055,76,1086.25960581832,-1.04504162552496
24639,528060.669,5333076.852,86,82,4,68.442,6,2011,1,65,327,160,0.835060383015391,139.3,17.1164835164835,95,1086.25960581832,-1.04504162552496
24639,528060.669,5333076.852,147,95,52,62.228,5,2012,1,89,321,162,0.836073428530115,38.5,18.2296703296703,73,1086.25960581832,-1.04504162552496
24639,528060.669,5333076.852,179,68,111,38.668,1,2013,2,117,311,177,0.84976452340784,-164.8,18.7813186813187,60,1086.25960581832,-1.04504162552496
24639,528060.669,5333076.852,144,131,13,51.207,3,2014,2,88,349,233,0.837151367204593,101.8,17.4461538461538,145,1086.25960581832,-1.04504162552496
24639,528060.669,5333076.852,156,93,63,52.113,1,2015,1,97,348,161,0.849209319842592,-192.4,20.4978021978022,64,1086.25960581832,-1.04504162552496
24639,528060.669,5333076.852,164,93,71,49.86,5,2016,2,106,343,241,0.820404965754779,-4.8,18.6318681318681,135,1086.25960581832,-1.04504162552496
24639,528060.669,5333076.852,118,93,25,89.037,12,2017,1,59,322,169,0.835768113350051,-54.4,19.6516483516484,110,1086.25960581832,-1.04504162552496
24639,528060.669,5333076.852,151,78,73,60.936,1,2018,2,89,348,153,0.866030833388971,-121.8,20.367032967033,64,1086.25960581832,-1.04504162552496
24639,528060.669,5333076.852,157,94,63,53.381,8,2019,1,95,342,170,0.849358083737487,-107,20.478021978022,75,1086.25960581832,-1.04504162552496
24639,528060.669,5333076.852,0,0,0,62.1,0,2020,0,73,322,177,0.835204812227503,-91.9,18.7142857142857,104,1086.25960581832,-1.04504162552496
24640,528060.669,5332845.195,0,0,0,145.423,0,2001,2,22,344,184,0.868310572667231,10.6,17.710989010989,162,1087.40280777354,1.48385923995613
24640,528060.669,5332845.195,113,77,36,59.628,4,2002,3,90,348,192,0.829174748298026,25.6,17.9494505494505,102,1087.40280777354,1.48385923995613
24640,528060.669,5332845.195,159,93,66,47.034,4,2003,1,99,335,161,0.835059851254318,-201.3,22.6626373626374,62,1087.40280777354,1.48385923995613
24640,528060.669,5332845.195,148,93,55,45.212,0,2004,1,105,342,178,0.856579680727243,132.4,17.5076923076923,73,1087.40280777354,1.48385923995613
24640,528060.669,5332845.195,0,0,0,81.315,0,2005,0,77,318,176,0.864587904566056,-23.3,17.6,99,1087.40280777354,1.48385923995613
24640,528060.669,5332845.195,182,67,115,51.052,2,2006,3,106,350,185,0.864277554512568,50,18.6131868131868,79,1087.40280777354,1.48385923995613
24640,528060.669,5332845.195,146,96,50,85.764,11,2007,2,60,319,224,0.842777462296577,269.6,16.9021978021978,164,1087.40280777354,1.48385923995613
24640,528060.669,5332845.195,0,0,0,35.971,0,2008,0,112,313,225,0.860872358171279,38,17.3098901098901,113,1087.40280777354,1.48385923995613
24640,528060.669,5332845.195,173,72,101,39.639,0,2009,2,107,324,169,0.893110237884364,34.6,18.2571428571429,62,1087.40280777354,1.48385923995613
24640,528060.669,5332845.195,158,93,65,46.988,1,2010,1,103,319,169,0.860244014828911,95.1,17.9945054945055,66,1087.40280777354,1.48385923995613
24640,528060.669,5332845.195,86,82,4,61.491,3,2011,1,72,324,161,0.85176336392258,139.3,17.1164835164835,89,1087.40280777354,1.48385923995613
24640,528060.669,5332845.195,146,93,53,63.151,5,2012,1,88,322,178,0.866297917138421,38.5,18.2296703296703,90,1087.40280777354,1.48385923995613
24640,528060.669,5332845.195,178,68,110,37.506,1,2013,3,118,313,184,0.873227769536006,-164.8,18.7813186813187,66,1087.40280777354,1.48385923995613
24640,528060.669,5332845.195,142,137,5,47.796,3,2014,2,92,340,240,0.833591571795122,101.8,17.4461538461538,148,1087.40280777354,1.48385923995613
24640,528060.669,5332845.195,154,93,61,54.486,3,2015,1,95,353,154,0.860726452948622,-192.4,20.4978021978022,59,1087.40280777354,1.48385923995613
24640,528060.669,5332845.195,161,93,68,55.133,5,2016,2,101,347,312,0.848107755806438,-4.8,18.6318681318681,211,1087.40280777354,1.48385923995613
24640,528060.669,5332845.195,119,93,26,70.375,8,2017,1,74,324,178,0.862232955629643,-54.4,19.6516483516484,104,1087.40280777354,1.48385923995613
24640,528060.669,5332845.195,154,78,76,60.936,1,2018,2,89,347,153,0.884515885375198,-121.8,20.367032967033,64,1087.40280777354,1.48385923995613
24640,528060.669,5332845.195,159,93,66,37.816,3,2019,1,111,341,169,0.863470108115735,-107,20.478021978022,58,1087.40280777354,1.48385923995613
24640,528060.669,5332845.195,0,0,0,65.841,0,2020,0,70,324,184,0.838150087473422,-91.9,18.7142857142857,114,1087.40280777354,1.48385923995613
24769,528292.325,5353694.268,0,0,0,86.993,0,2001,1,73,334,178,0.810144544876817,4.09999999999999,18.2296703296703,105,1026.75115736778,-1.48520641750996
24769,528292.325,5353694.268,106,94,12,73.381,10,2002,2,77,335,233,0.796358176233304,18.8,18.3868131868132,156,1026.75115736778,-1.48520641750996
24769,528292.325,5353694.268,152,93,59,56.116,10,2003,1,88,311,153,0.799578612928092,-204,23.121978021978,65,1026.75115736778,-1.48520641750996
24769,528292.325,5353694.268,191,94,97,24.049,0,2004,2,126,342,242,0.808544523552401,123.8,17.9692307692308,116,1026.75115736778,-1.48520641750996
24769,528292.325,5353694.268,154,93,61,66.216,2,2005,4,89,317,200,0.791456715802861,-31.4,18.0615384615385,111,1026.75115736778,-1.48520641750996
24769,528292.325,5353694.268,173,93,80,41.514,0,2006,2,112,345,264,0.80495878826387,43,19.0516483516484,152,1026.75115736778,-1.48520641750996
24769,528292.325,5353694.268,0,0,0,105.302,0,2007,0,42,303,226,0.812914093262272,258.5,17.3142857142857,184,1026.75115736778,-1.48520641750996
24769,528292.325,5353694.268,0,0,0,86.526,0,2008,0,67,312,169,0.820838108946661,29.3,17.7417582417582,102,1026.75115736778,-1.48520641750996
24769,528292.325,5353694.268,172,61,111,42.337,0,2009,2,103,330,177,0.85334869428918,27.1,18.689010989011,74,1026.75115736778,-1.48520641750996
24769,528292.325,5353694.268,149,83,66,51.691,2,2010,3,97,315,264,0.789335640720456,87.4,18.4241758241758,167,1026.75115736778,-1.48520641750996
24769,528292.325,5353694.268,86,61,25,66.928,7,2011,1,64,325,168,0.814668256018707,129,17.5824175824176,104,1026.75115736778,-1.48520641750996
24769,528292.325,5353694.268,141,93,48,64.05,4,2012,2,85,312,193,0.851982022168374,29,18.7703296703297,108,1026.75115736778,-1.48520641750996
24769,528292.325,5353694.268,160,63,97,48.502,0,2013,3,107,306,194,0.828120556114169,-172.4,19.2857142857143,87,1026.75115736778,-1.48520641750996
24769,528292.325,5353694.268,93,50,43,64.348,7,2014,3,71,350,185,0.809681405719419,91.5,17.9450549450549,114,1026.75115736778,-1.48520641750996
24769,528292.325,5353694.268,147,93,54,57.036,4,2015,2,92,346,217,0.826973670678163,-197.8,21,125,1026.75115736778,-1.48520641750996
24769,528292.325,5353694.268,158,93,65,62.625,5,2016,1,93,344,162,0.85060631998883,-13,19.132967032967,69,1026.75115736778,-1.48520641750996
24769,528292.325,5353694.268,117,94,23,70.566,6,2017,1,72,303,162,0.806912604350572,-57.8,20.1032967032967,90,1026.75115736778,-1.48520641750996
24769,528292.325,5353694.268,162,64,98,49.79,0,2018,2,97,348,138,0.808315360837084,-125.4,20.7956043956044,41,1026.75115736778,-1.48520641750996
24769,528292.325,5353694.268,132,93,39,66.108,10,2019,1,81,333,170,0.829834369320802,-108.1,20.8824175824176,89,1026.75115736778,-1.48520641750996
24769,528292.325,5353694.268,0,0,0,79.35,0,2020,0,57,324,185,0.795587494570509,-97.4,19.156043956044,128,1026.75115736778,-1.48520641750996
24772,528292.325,5352999.299,0,0,0,64.816,0,2001,1,90,321,193,0.83457621967923,4.09999999999999,18.2296703296703,103,1000.29097408431,-0.709145944502125
24772,528292.325,5352999.299,93,93,0,60.755,5,2002,2,87,317,232,0.822993232913286,18.8,18.3868131868132,145,1000.29097408431,-0.709145944502125
24772,528292.325,5352999.299,147,93,54,45.104,4,2003,1,99,304,178,0.842331304509838,-204,23.121978021978,79,1000.29097408431,-0.709145944502125
24772,528292.325,5352999.299,143,96,47,46.42,0,2004,2,102,337,201,0.822095587308186,123.8,17.9692307692308,99,1000.29097408431,-0.709145944502125
24772,528292.325,5352999.299,0,0,0,136.029,0,2005,0,25,307,161,0.827842748210624,-31.4,18.0615384615385,136,1000.29097408431,-0.709145944502125
24772,528292.325,5352999.299,166,67,99,40.331,0,2006,2,113,345,168,0.840134332564888,43,19.0516483516484,55,1000.29097408431,-0.709145944502125
24772,528292.325,5352999.299,0,0,0,65.782,0,2007,0,76,314,193,0.821656509233471,258.5,17.3142857142857,117,1000.29097408431,-0.709145944502125
24772,528292.325,5352999.299,86,80,6,52.66,5,2008,1,97,309,170,0.833408548853445,29.3,17.7417582417582,73,1000.29097408431,-0.709145944502125
24772,528292.325,5352999.299,164,93,71,46.893,0,2009,1,99,327,168,0.854675787235971,27.1,18.689010989011,69,1000.29097408431,-0.709145944502125
24772,528292.325,5352999.299,151,102,49,43.367,0,2010,2,104,300,218,0.837207184390344,87.4,18.4241758241758,114,1000.29097408431,-0.709145944502125
24772,528292.325,5352999.299,0,0,0,60.074,0,2011,0,71,325,273,0.805601057318188,129,17.5824175824176,202,1000.29097408431,-0.709145944502125
24772,528292.325,5352999.299,142,93,49,55.6,3,2012,1,95,311,161,0.83927485463678,29,18.7703296703297,66,1000.29097408431,-0.709145944502125
24772,528292.325,5352999.299,161,63,98,29.913,0,2013,3,124,315,186,0.850110455657499,-172.4,19.2857142857143,62,1000.29097408431,-0.709145944502125
24772,528292.325,5352999.299,86,67,19,61.576,7,2014,1,74,328,233,0.860951309905627,91.5,17.9450549450549,159,1000.29097408431,-0.709145944502125
24772,528292.325,5352999.299,146,93,53,53.464,3,2015,1,95,343,169,0.838433889138361,-197.8,21,74,1000.29097408431,-0.709145944502125
24772,528292.325,5352999.299,160,95,65,55.218,5,2016,1,100,342,161,0.834552381497391,-13,19.132967032967,61,1000.29097408431,-0.709145944502125
24772,528292.325,5352999.299,127,94,33,54.984,6,2017,1,86,307,162,0.836303583643503,-57.8,20.1032967032967,76,1000.29097408431,-0.709145944502125
24772,528292.325,5352999.299,159,129,30,47.414,0,2018,1,99,347,177,0.826593381318025,-125.4,20.7956043956044,78,1000.29097408431,-0.709145944502125
24772,528292.325,5352999.299,126,93,33,53.326,9,2019,1,94,327,177,0.85555967559197,-108.1,20.8824175824176,83,1000.29097408431,-0.709145944502125
24772,528292.325,5352999.299,0,0,0,56.59,0,2020,0,76,335,176,0.831054389933558,-97.4,19.156043956044,100,1000.29097408431,-0.709145944502125
24773,528292.325,5352767.642,0,0,0,77.834,0,2001,1,80,335,186,0.81198963415081,4.09999999999999,18.2296703296703,106,994.35711978985,0.58638344609954
24773,528292.325,5352767.642,93,93,0,77.627,10,2002,2,73,335,233,0.817908500258306,18.8,18.3868131868132,160,994.35711978985,0.58638344609954
24773,528292.325,5352767.642,148,93,55,49.124,7,2003,1,95,313,178,0.779563448966313,-204,23.121978021978,83,994.35711978985,0.58638344609954
24773,528292.325,5352767.642,143,100,43,54.283,3,2004,2,95,342,282,0.821616875784266,123.8,17.9692307692308,187,994.35711978985,0.58638344609954
24773,528292.325,5352767.642,0,0,0,139.527,0,2005,0,22,312,160,0.816096948843505,-31.4,18.0615384615385,138,994.35711978985,0.58638344609954
24773,528292.325,5352767.642,162,69,93,50.33,0,2006,2,105,345,161,0.81748381854821,43,19.0516483516484,56,994.35711978985,0.58638344609954
24773,528292.325,5352767.642,0,0,0,109.602,0,2007,0,38,309,185,0.834797038784262,258.5,17.3142857142857,147,994.35711978985,0.58638344609954
24773,528292.325,5352767.642,86,79,7,116.203,29,2008,1,38,312,169,0.811268283172553,29.3,17.7417582417582,131,994.35711978985,0.58638344609954
24773,528292.325,5352767.642,166,95,71,45.721,0,2009,1,100,333,176,0.844017474795447,27.1,18.689010989011,76,994.35711978985,0.58638344609954
24773,528292.325,5352767.642,151,93,58,41.17,0,2010,2,106,304,209,0.81282150794298,87.4,18.4241758241758,103,994.35711978985,0.58638344609954
24773,528292.325,5352767.642,93,93,0,75.156,13,2011,2,56,328,281,0.809499839545992,129,17.5824175824176,225,994.35711978985,0.58638344609954
24773,528292.325,5352767.642,144,93,51,59.632,4,2012,1,90,310,169,0.839389523605137,29,18.7703296703297,79,994.35711978985,0.58638344609954
24773,528292.325,5352767.642,161,62,99,35.36,0,2013,3,119,314,186,0.830958976499203,-172.4,19.2857142857143,67,994.35711978985,0.58638344609954
24773,528292.325,5352767.642,86,64,22,114.256,29,2014,1,24,333,233,0.85445930413904,91.5,17.9450549450549,209,994.35711978985,0.58638344609954
24773,528292.325,5352767.642,151,98,53,50.031,0,2015,1,98,343,177,0.826530268124671,-197.8,21,79,994.35711978985,0.58638344609954
24773,528292.325,5352767.642,157,93,64,64.779,5,2016,1,91,343,170,0.840346936845338,-13,19.132967032967,79,994.35711978985,0.58638344609954
24773,528292.325,5352767.642,120,93,27,84.433,7,2017,1,61,320,169,0.816783348252236,-57.8,20.1032967032967,108,994.35711978985,0.58638344609954
24773,528292.325,5352767.642,157,133,24,53.387,0,2018,1,94,349,176,0.79772285489389,-125.4,20.7956043956044,82,994.35711978985,0.58638344609954
24773,528292.325,5352767.642,126,93,33,63.922,10,2019,1,83,331,178,0.823529137794249,-108.1,20.8824175824176,95,994.35711978985,0.58638344609954
24773,528292.325,5352767.642,0,0,0,72.421,0,2020,0,63,339,177,0.792989613284329,-97.4,19.156043956044,114,994.35711978985,0.58638344609954
24840,528292.325,5337246.666,0,0,0,135.67,0,2001,1,33,306,161,0.85241378930735,-14.2,19.5065934065934,128,912.200557655704,1.24460811352113
24840,528292.325,5337246.666,114,82,32,44.567,0,2002,3,104,344,240,0.854146820262597,3,19.4725274725275,136,912.200557655704,1.24460811352113
24840,528292.325,5337246.666,149,93,56,44.903,5,2003,1,98,337,146,0.830497235880626,-209,24.2648351648352,48,912.200557655704,1.24460811352113
24840,528292.325,5337246.666,0,0,0,56.34,0,2004,0,93,333,265,0.896751735292011,104,19.0769230769231,172,912.200557655704,1.24460811352113
24840,528292.325,5337246.666,0,0,0,71.834,0,2005,0,84,316,153,0.864751813379015,-49.6,19.2098901098901,69,912.200557655704,1.24460811352113
24840,528292.325,5337246.666,175,61,114,61.319,5,2006,3,94,337,224,0.853294861706115,25.1,20.1736263736264,130,912.200557655704,1.24460811352113
24840,528292.325,5337246.666,0,0,0,86.296,0,2007,0,60,307,234,0.819951903961883,229.8,18.3494505494505,174,912.200557655704,1.24460811352113
24840,528292.325,5337246.666,0,0,0,41.871,0,2008,0,107,308,170,0.859664619491669,8.90000000000001,18.8,63,912.200557655704,1.24460811352113
24840,528292.325,5337246.666,156,93,63,40.816,0,2009,1,101,311,160,0.863962361542874,9.4,19.7494505494506,59,912.200557655704,1.24460811352113
24840,528292.325,5337246.666,162,131,31,36.691,0,2010,1,108,306,170,0.854163140325557,64.4,19.4725274725275,62,912.200557655704,1.24460811352113
24840,528292.325,5337246.666,114,67,47,55.069,3,2011,2,73,319,137,0.802696064936081,103.5,18.7505494505494,64,912.200557655704,1.24460811352113
24840,528292.325,5337246.666,0,0,0,59.714,0,2012,0,90,308,161,0.87209814315252,3.2,20.1307692307692,71,912.200557655704,1.24460811352113
24840,528292.325,5337246.666,0,0,0,42.653,0,2013,0,112,319,169,0.871128349708559,-190.8,20.5692307692308,57,912.200557655704,1.24460811352113
24840,528292.325,5337246.666,94,59,35,61.527,3,2014,2,73,313,152,0.856015214063143,65.4,19.2153846153846,79,912.200557655704,1.24460811352113
24840,528292.325,5337246.666,86,80,6,54.636,3,2015,1,95,329,169,0.857445424958007,-212.4,22.3164835164835,74,912.200557655704,1.24460811352113
24840,528292.325,5337246.666,159,93,66,62.629,4,2016,1,94,340,169,0.869278558456827,-31.9,20.4131868131868,75,912.200557655704,1.24460811352113
24840,528292.325,5337246.666,133,96,37,50.938,5,2017,1,90,322,162,0.861426663193899,-70.8,21.2648351648352,72,912.200557655704,1.24460811352113
24840,528292.325,5337246.666,159,119,40,56.362,0,2018,1,90,345,152,0.869832995633913,-135.7,21.9263736263736,62,912.200557655704,1.24460811352113
24840,528292.325,5337246.666,93,93,0,59.753,6,2019,1,88,329,153,0.848451764158396,-112.7,22.0065934065934,65,912.200557655704,1.24460811352113
24840,528292.325,5337246.666,94,93,1,40.37,3,2020,1,92,314,168,0.857516854293115,-111.3,20.3164835164835,76,912.200557655704,1.24460811352113
24841,528292.325,5337015.01,0,0,0,122.273,0,2001,2,44,330,153,0.84927626995081,-14.2,19.5065934065934,109,987.737090230707,0.87755165026345
24841,528292.325,5337015.01,86,84,2,51.436,1,2002,1,96,333,249,0.856819252177233,3,19.4725274725275,153,987.737090230707,0.87755165026345
24841,528292.325,5337015.01,149,93,56,46.751,6,2003,1,96,332,145,0.814596970885116,-209,24.2648351648352,49,987.737090230707,0.87755165026345
24841,528292.325,5337015.01,93,93,0,60.289,0,2004,1,89,332,146,0.852789288116596,104,19.0769230769231,57,987.737090230707,0.87755165026345
24841,528292.325,5337015.01,0,0,0,73.991,0,2005,0,82,316,152,0.861394075260137,-49.6,19.2098901098901,70,987.737090230707,0.87755165026345
24841,528292.325,5337015.01,182,60,122,46.425,0,2006,2,106,341,153,0.86501938051908,25.1,20.1736263736264,47,987.737090230707,0.87755165026345
24841,528292.325,5337015.01,0,0,0,78.031,0,2007,0,66,313,138,0.849899847213,229.8,18.3494505494505,72,987.737090230707,0.87755165026345
24841,528292.325,5337015.01,0,0,0,51.422,0,2008,0,99,314,162,0.842996704260119,8.90000000000001,18.8,63,987.737090230707,0.87755165026345
24841,528292.325,5337015.01,160,96,64,41.748,0,2009,1,100,321,153,0.872676225698718,9.4,19.7494505494506,53,987.737090230707,0.87755165026345
24841,528292.325,5337015.01,159,104,55,40.532,0,2010,1,104,310,161,0.837798363513702,64.4,19.4725274725275,57,987.737090230707,0.87755165026345
24841,528292.325,5337015.01,116,63,53,48.924,2,2011,2,80,326,153,0.902787504096175,103.5,18.7505494505494,73,987.737090230707,0.87755165026345
24841,528292.325,5337015.01,0,0,0,61.335,0,2012,0,88,312,160,0.869118237632459,3.2,20.1307692307692,72,987.737090230707,0.87755165026345
24841,528292.325,5337015.01,0,0,0,50.11,0,2013,0,105,319,153,0.845909224058528,-190.8,20.5692307692308,48,987.737090230707,0.87755165026345
24841,528292.325,5337015.01,83,58,25,71.412,5,2014,1,63,322,138,0.847734369916719,65.4,19.2153846153846,75,987.737090230707,0.87755165026345
24841,528292.325,5337015.01,93,81,12,60.546,4,2015,2,90,323,145,0.855485190241711,-212.4,22.3164835164835,55,987.737090230707,0.87755165026345
24841,528292.325,5337015.01,153,103,50,78.27,6,2016,1,78,332,169,0.851699856536968,-31.9,20.4131868131868,91,987.737090230707,0.87755165026345
24841,528292.325,5337015.01,133,94,39,56.951,5,2017,1,84,328,160,0.843772044686734,-70.8,21.2648351648352,76,987.737090230707,0.87755165026345
24841,528292.325,5337015.01,0,0,0,130.491,0,2018,0,24,346,146,0.8509773470826,-135.7,21.9263736263736,122,987.737090230707,0.87755165026345
24841,528292.325,5337015.01,93,93,0,54.192,6,2019,1,94,337,160,0.834892801471653,-112.7,22.0065934065934,66,987.737090230707,0.87755165026345
24841,528292.325,5337015.01,0,0,0,44.874,0,2020,0,87,315,161,0.84527376024799,-111.3,20.3164835164835,74,987.737090230707,0.87755165026345
24842,528292.325,5336783.354,0,0,0,107.079,0,2001,1,58,317,160,0.859365010935038,-14.2,19.5065934065934,102,994.000636786646,-1.48512989479562
24842,528292.325,5336783.354,86,83,3,53.295,1,2002,1,94,334,169,0.859052523627113,3,19.4725274725275,75,994.000636786646,-1.48512989479562
24842,528292.325,5336783.354,0,0,0,46.751,0,2003,0,96,320,153,0.846102984328284,-209,24.2648351648352,57,994.000636786646,-1.48512989479562
24842,528292.325,5336783.354,154,111,43,55.393,0,2004,1,94,325,161,0.907761901579742,104,19.0769230769231,67,994.000636786646,-1.48512989479562
24842,528292.325,5336783.354,142,86,56,62.295,2,2005,2,93,321,153,0.867760588793716,-49.6,19.2098901098901,60,994.000636786646,-1.48512989479562
24842,528292.325,5336783.354,174,93,81,67.08,5,2006,1,90,344,154,0.848144454763261,25.1,20.1736263736264,64,994.000636786646,-1.48512989479562
24842,528292.325,5336783.354,0,0,0,71.033,0,2007,0,72,319,145,0.89770743978667,229.8,18.3494505494505,73,994.000636786646,-1.48512989479562
24842,528292.325,5336783.354,0,0,0,44.279,0,2008,0,105,316,169,0.83333539940395,8.90000000000001,18.8,64,994.000636786646,-1.48512989479562
24842,528292.325,5336783.354,153,93,60,42.704,0,2009,1,99,323,154,0.881248545933108,9.4,19.7494505494506,55,994.000636786646,-1.48512989479562
24842,528292.325,5336783.354,146,93,53,36.691,0,2010,1,108,312,161,0.860842104983884,64.4,19.4725274725275,53,994.000636786646,-1.48512989479562
24842,528292.325,5336783.354,117,69,48,51.591,3,2011,2,77,336,154,0.910766560220451,103.5,18.7505494505494,77,994.000636786646,-1.48512989479562
24842,528292.325,5336783.354,0,0,0,54.33,0,2012,0,97,319,161,0.890884281816208,3.2,20.1307692307692,64,994.000636786646,-1.48512989479562
24842,528292.325,5336783.354,170,94,76,53.875,0,2013,1,102,320,161,0.869973791162054,-190.8,20.5692307692308,59,994.000636786646,-1.48512989479562
24842,528292.325,5336783.354,0,0,0,70.341,0,2014,0,64,346,161,0.858611668351036,65.4,19.2153846153846,97,994.000636786646,-1.48512989479562
24842,528292.325,5336783.354,93,93,0,57.061,4,2015,1,93,342,160,0.88178359552308,-212.4,22.3164835164835,67,994.000636786646,-1.48512989479562
24842,528292.325,5336783.354,126,94,32,79.294,7,2016,1,77,324,177,0.867534677288907,-31.9,20.4131868131868,100,994.000636786646,-1.48512989479562
24842,528292.325,5336783.354,126,93,33,47.311,5,2017,1,94,333,169,0.86245815026485,-70.8,21.2648351648352,75,994.000636786646,-1.48512989479562
24842,528292.325,5336783.354,0,0,0,125.424,0,2018,0,28,322,153,0.884842156375833,-135.7,21.9263736263736,125,994.000636786646,-1.48512989479562
24842,528292.325,5336783.354,129,93,36,53.217,5,2019,1,95,339,154,0.858842282506675,-112.7,22.0065934065934,59,994.000636786646,-1.48512989479562
24842,528292.325,5336783.354,0,0,0,52.721,0,2020,0,79,312,162,0.859524826630253,-111.3,20.3164835164835,83,994.000636786646,-1.48512989479562
24856,528292.325,5333540.164,0,0,0,141.141,0,2001,1,26,334,184,0.836502177144028,10.6,17.710989010989,158,1108.45063747308,-0.850443116741162
24856,528292.325,5333540.164,132,74,58,49.466,2,2002,3,100,347,313,0.911328506968901,25.6,17.9494505494505,213,1108.45063747308,-0.850443116741162
24856,528292.325,5333540.164,140,95,45,61.57,11,2003,1,85,335,161,0.772803080128312,-201.3,22.6626373626374,76,1108.45063747308,-0.850443116741162
24856,528292.325,5333540.164,142,94,48,54.457,4,2004,2,97,326,185,0.820225549530614,132.4,17.5076923076923,88,1108.45063747308,-0.850443116741162
24856,528292.325,5333540.164,0,0,0,125.532,0,2005,0,36,314,169,0.815665489967238,-23.3,17.6,133,1108.45063747308,-0.850443116741162
24856,528292.325,5333540.164,188,63,125,57.606,4,2006,3,101,345,224,0.855182303221619,50,18.6131868131868,123,1108.45063747308,-0.850443116741162
24856,528292.325,5333540.164,0,0,0,98.112,0,2007,0,49,301,208,0.838244086562097,269.6,16.9021978021978,159,1108.45063747308,-0.850443116741162
24856,528292.325,5333540.164,86,79,7,107.75,26,2008,1,48,315,185,0.827626133402189,38,17.3098901098901,137,1108.45063747308,-0.850443116741162
24856,528292.325,5333540.164,169,66,103,47.509,0,2009,2,100,318,176,0.849026002722722,34.6,18.2571428571429,76,1108.45063747308,-0.850443116741162
24856,528292.325,5333540.164,159,81,78,45.799,0,2010,3,104,313,184,0.813858345648271,95.1,17.9945054945055,80,1108.45063747308,-0.850443116741162
24856,528292.325,5333540.164,85,71,14,70.492,8,2011,1,63,327,161,0.867328803249944,139.3,17.1164835164835,98,1108.45063747308,-0.850443116741162
24856,528292.325,5333540.164,142,94,48,61.319,5,2012,2,90,304,185,0.844765534304473,38.5,18.2296703296703,95,1108.45063747308,-0.850443116741162
24856,528292.325,5333540.164,177,60,117,26.186,1,2013,3,128,319,185,0.841303446555873,-164.8,18.7813186813187,57,1108.45063747308,-0.850443116741162
24856,528292.325,5333540.164,86,76,10,54.838,6,2014,1,84,348,169,0.811319174592461,101.8,17.4461538461538,85,1108.45063747308,-0.850443116741162
24856,528292.325,5333540.164,93,93,0,59.302,5,2015,1,91,347,162,0.84360617588319,-192.4,20.4978021978022,71,1108.45063747308,-0.850443116741162
24856,528292.325,5333540.164,166,99,67,56.192,5,2016,2,100,346,201,0.855810372247192,-4.8,18.6318681318681,101,1108.45063747308,-0.850443116741162
24856,528292.325,5333540.164,0,0,0,76.462,0,2017,0,69,318,186,0.835089765716539,-54.4,19.6516483516484,117,1108.45063747308,-0.850443116741162
24856,528292.325,5333540.164,152,74,78,55.122,0,2018,2,94,348,186,0.809750888975822,-121.8,20.367032967033,92,1108.45063747308,-0.850443116741162
24856,528292.325,5333540.164,137,93,44,64.311,11,2019,1,84,345,176,0.842941160947652,-107,20.478021978022,92,1108.45063747308,-0.850443116741162
24856,528292.325,5333540.164,0,0,0,120.113,0,2020,0,24,323,185,0.833596794058147,-91.9,18.7142857142857,161,1108.45063747308,-0.850443116741162
24857,528292.325,5333308.508,0,0,0,126.399,0,2001,2,39,311,169,0.81763237460846,10.6,17.710989010989,130,1053.37961551605,-0.2856599546662
24857,528292.325,5333308.508,133,71,62,49.466,2,2002,3,100,345,312,0.837745936713864,25.6,17.9494505494505,212,1053.37961551605,-0.2856599546662
24857,528292.325,5333308.508,139,94,45,53.346,10,2003,1,93,331,153,0.780127432835592,-201.3,22.6626373626374,60,1053.37961551605,-0.2856599546662
24857,528292.325,5333308.508,143,94,49,49.727,1,2004,1,101,337,177,0.821106381709823,132.4,17.5076923076923,76,1053.37961551605,-0.2856599546662
24857,528292.325,5333308.508,146,93,53,62.974,2,2005,2,93,309,161,0.839688646256134,-23.3,17.6,68,1053.37961551605,-0.2856599546662
24857,528292.325,5333308.508,187,62,125,62.891,6,2006,3,97,344,224,0.883360677090233,50,18.6131868131868,127,1053.37961551605,-0.2856599546662
24857,528292.325,5333308.508,0,0,0,99.308,0,2007,0,48,303,170,0.827997729556892,269.6,16.9021978021978,122,1053.37961551605,-0.2856599546662
24857,528292.325,5333308.508,86,80,6,72.91,14,2008,1,80,313,184,0.827579196882687,38,17.3098901098901,104,1053.37961551605,-0.2856599546662
24857,528292.325,5333308.508,171,66,105,40.703,0,2009,2,106,312,176,0.853140156044642,34.6,18.2571428571429,70,1053.37961551605,-0.2856599546662
24857,528292.325,5333308.508,160,81,79,43.462,0,2010,2,106,312,170,0.814146706924128,95.1,17.9945054945055,64,1053.37961551605,-0.2856599546662
24857,528292.325,5333308.508,86,72,14,57.574,3,2011,1,76,323,240,0.799889827974585,139.3,17.1164835164835,164,1053.37961551605,-0.2856599546662
24857,528292.325,5333308.508,142,93,49,61.319,5,2012,1,90,303,178,0.847479711930175,38.5,18.2296703296703,88,1053.37961551605,-0.2856599546662
24857,528292.325,5333308.508,171,60,111,44.202,1,2013,2,112,316,170,0.852241211682531,-164.8,18.7813186813187,58,1053.37961551605,-0.2856599546662
24857,528292.325,5333308.508,93,76,17,48.627,3,2014,2,91,345,161,0.805607667996429,101.8,17.4461538461538,70,1053.37961551605,-0.2856599546662
24857,528292.325,5333308.508,0,0,0,55.71,0,2015,0,94,339,161,0.854793420703462,-192.4,20.4978021978022,67,1053.37961551605,-0.2856599546662
24857,528292.325,5333308.508,167,93,74,52.015,5,2016,1,104,340,169,0.852677140869213,-4.8,18.6318681318681,65,1053.37961551605,-0.2856599546662
24857,528292.325,5333308.508,0,0,0,51.832,0,2017,0,91,315,178,0.831868607844455,-54.4,19.6516483516484,87,1053.37961551605,-0.2856599546662
24857,528292.325,5333308.508,86,73,13,121.056,39,2018,1,33,344,185,0.823852374439514,-121.8,20.367032967033,152,1053.37961551605,-0.2856599546662
24857,528292.325,5333308.508,138,94,44,59.142,9,2019,1,89,339,169,0.831820606438367,-107,20.478021978022,80,1053.37961551605,-0.2856599546662
24857,528292.325,5333308.508,0,0,0,45.546,0,2020,0,89,318,177,0.84240701691718,-91.9,18.7142857142857,88,1053.37961551605,-0.2856599546662
24860,528292.325,5332613.539,0,0,0,150.547,0,2001,2,17,317,193,0.846635222518755,10.6,17.710989010989,176,1082.27166242499,-1.37193139880288
24860,528292.325,5332613.539,86,86,0,48.544,1,2002,1,101,336,177,0.82302164171961,25.6,17.9494505494505,76,1082.27166242499,-1.37193139880288
24860,528292.325,5332613.539,139,94,45,67.928,12,2003,1,79,338,170,0.807032592677585,-201.3,22.6626373626374,91,1082.27166242499,-1.37193139880288
24860,528292.325,5332613.539,149,93,56,54.457,4,2004,1,97,327,169,0.795643486831852,132.4,17.5076923076923,72,1082.27166242499,-1.37193139880288
24860,528292.325,5332613.539,147,94,53,67.617,2,2005,2,89,314,192,0.804261540872554,-23.3,17.6,103,1082.27166242499,-1.37193139880288
24860,528292.325,5332613.539,173,93,80,31.643,1,2006,2,122,342,217,0.83356170103045,50,18.6131868131868,95,1082.27166242499,-1.37193139880288
24860,528292.325,5332613.539,0,0,0,61.706,0,2007,0,81,307,216,0.83951635933072,269.6,16.9021978021978,135,1082.27166242499,-1.37193139880288
24860,528292.325,5332613.539,0,0,0,33.651,0,2008,0,114,305,224,0.839250387198373,38,17.3098901098901,110,1082.27166242499,-1.37193139880288
24860,528292.325,5332613.539,158,64,94,37.473,0,2009,2,109,309,169,0.843580759824224,34.6,18.2571428571429,60,1082.27166242499,-1.37193139880288
24860,528292.325,5332613.539,165,99,66,36.908,0,2010,1,112,315,176,0.808482844479092,95.1,17.9945054945055,64,1082.27166242499,-1.37193139880288
24860,528292.325,5332613.539,111,93,18,65.419,3,2011,1,68,328,160,0.831157501709412,139.3,17.1164835164835,92,1082.27166242499,-1.37193139880288
24860,528292.325,5332613.539,149,102,47,50.194,2,2012,2,103,306,192,0.860397095678013,38.5,18.2296703296703,89,1082.27166242499,-1.37193139880288
24860,528292.325,5332613.539,177,49,128,28.34,1,2013,3,126,309,186,0.85982541633016,-164.8,18.7813186813187,60,1082.27166242499,-1.37193139880288
24860,528292.325,5332613.539,93,93,0,48.627,3,2014,2,91,343,201,0.844718844629361,101.8,17.4461538461538,110,1082.27166242499,-1.37193139880288
24860,528292.325,5332613.539,141,95,46,46.702,0,2015,1,102,341,162,0.82909008663665,-192.4,20.4978021978022,60,1082.27166242499,-1.37193139880288
24860,528292.325,5332613.539,150,93,57,55.133,5,2016,1,101,338,178,0.865771168169897,-4.8,18.6318681318681,77,1082.27166242499,-1.37193139880288
24860,528292.325,5332613.539,0,0,0,63.593,0,2017,0,80,320,201,0.814829649020261,-54.4,19.6516483516484,121,1082.27166242499,-1.37193139880288
24860,528292.325,5332613.539,86,71,15,44.452,0,2018,1,103,316,153,0.898532284993062,-121.8,20.367032967033,50,1082.27166242499,-1.37193139880288
24860,528292.325,5332613.539,155,93,62,48.457,7,2019,1,100,336,177,0.821317813271541,-107,20.478021978022,77,1082.27166242499,-1.37193139880288
24860,528292.325,5332613.539,0,0,0,51.284,0,2020,0,83,308,186,0.829834158041859,-91.9,18.7142857142857,103,1082.27166242499,-1.37193139880288
24862,528292.325,5332150.226,0,0,0,152.667,0,2001,1,15,341,184,0.858655215826845,10.6,17.710989010989,169,978.70024907581,1.47700026189309
24862,528292.325,5332150.226,86,86,0,73.437,10,2002,1,79,346,233,0.886169827964657,25.6,17.9494505494505,154,978.70024907581,1.47700026189309
24862,528292.325,5332150.226,146,93,53,59.505,11,2003,1,87,335,176,0.832327108671605,-201.3,22.6626373626374,89,978.70024907581,1.47700026189309
24862,528292.325,5332150.226,137,93,44,67.361,9,2004,2,85,338,240,0.842890002729466,132.4,17.5076923076923,155,978.70024907581,1.47700026189309
24862,528292.325,5332150.226,0,0,0,71.125,0,2005,0,86,318,177,0.867048652102395,-23.3,17.6,91,978.70024907581,1.47700026189309
24862,528292.325,5332150.226,169,70,99,53.669,2,2006,3,104,346,241,0.860327068698257,50,18.6131868131868,137,978.70024907581,1.47700026189309
24862,528292.325,5332150.226,0,0,0,131.297,0,2007,0,20,313,225,0.845837170980355,269.6,16.9021978021978,205,978.70024907581,1.47700026189309
24862,528292.325,5332150.226,0,0,0,27.979,0,2008,0,119,306,256,0.774023227545008,38,17.3098901098901,137,978.70024907581,1.47700026189309
24862,528292.325,5332150.226,160,64,96,42.89,0,2009,2,104,306,153,0.808525542006435,34.6,18.2571428571429,49,978.70024907581,1.47700026189309
24862,528292.325,5332150.226,159,76,83,53.203,3,2010,3,98,314,257,0.801805803385584,95.1,17.9945054945055,159,978.70024907581,1.47700026189309
24862,528292.325,5332150.226,99,70,29,92.4,21,2011,2,42,321,154,0.807078698363829,139.3,17.1164835164835,112,978.70024907581,1.47700026189309
24862,528292.325,5332150.226,126,94,32,59.526,5,2012,1,92,314,170,0.838760241018921,38.5,18.2296703296703,78,978.70024907581,1.47700026189309
24862,528292.325,5332150.226,169,93,76,36.314,1,2013,2,119,313,185,0.832280227438345,-164.8,18.7813186813187,66,978.70024907581,1.47700026189309
24862,528292.325,5332150.226,107,93,14,83.462,15,2014,2,55,352,266,0.829151779272849,101.8,17.4461538461538,211,978.70024907581,1.47700026189309
24862,528292.325,5332150.226,0,0,0,70.485,0,2015,0,80,341,162,0.791842009216955,-192.4,20.4978021978022,82,978.70024907581,1.47700026189309
24862,528292.325,5332150.226,152,102,50,58.38,5,2016,1,98,331,170,0.839921962033514,-4.8,18.6318681318681,72,978.70024907581,1.47700026189309
24862,528292.325,5332150.226,104,93,11,90.135,12,2017,2,58,320,217,0.8049015430154,-54.4,19.6516483516484,159,978.70024907581,1.47700026189309
24862,528292.325,5332150.226,86,78,8,58.59,1,2018,1,91,340,153,0.831631746044137,-121.8,20.367032967033,62,978.70024907581,1.47700026189309
24862,528292.325,5332150.226,0,0,0,61.16,0,2019,0,87,340,162,0.820992808865898,-107,20.478021978022,75,978.70024907581,1.47700026189309
24862,528292.325,5332150.226,0,0,0,102.15,0,2020,0,40,316,194,0.800581102680777,-91.9,18.7142857142857,154,978.70024907581,1.47700026189309
24885,528292.325,5326822.13,86,85,1,34.934,0,2001,2,117,294,193,0.866147977384557,10.6,17.710989010989,76,1248.36680307251,-1.1942760325767
24885,528292.325,5326822.13,154,67,87,29.976,0,2002,3,121,289,232,0.840525641756406,25.6,17.9494505494505,111,1248.36680307251,-1.1942760325767
24885,528292.325,5326822.13,159,95,64,32.076,0,2003,1,115,287,168,0.869120017704543,-201.3,22.6626373626374,53,1248.36680307251,-1.1942760325767
24885,528292.325,5326822.13,148,93,55,28.26,0,2004,2,122,313,185,0.855461681852269,132.4,17.5076923076923,63,1248.36680307251,-1.1942760325767
24885,528292.325,5326822.13,152,94,58,38.287,0,2005,1,115,301,170,0.852924485995092,-23.3,17.6,55,1248.36680307251,-1.1942760325767
24885,528292.325,5326822.13,195,64,131,25.693,1,2006,3,128,328,186,0.859884939096192,50,18.6131868131868,58,1248.36680307251,-1.1942760325767
24885,528292.325,5326822.13,0,0,0,42.208,0,2007,0,100,293,185,0.91835804857353,269.6,16.9021978021978,85,1248.36680307251,-1.1942760325767
24885,528292.325,5326822.13,161,82,79,22.012,0,2008,2,125,304,178,0.843899840987364,38,17.3098901098901,53,1248.36680307251,-1.1942760325767
24885,528292.325,5326822.13,168,61,107,37.473,0,2009,3,109,293,184,0.906255039919885,34.6,18.2571428571429,75,1248.36680307251,-1.1942760325767
24885,528292.325,5326822.13,170,94,76,28.491,0,2010,1,121,290,177,0.845950026531914,95.1,17.9945054945055,56,1248.36680307251,-1.1942760325767
24885,528292.325,5326822.13,0,0,0,33.707,0,2011,0,101,312,161,0.847496152500201,139.3,17.1164835164835,60,1248.36680307251,-1.1942760325767
24885,528292.325,5326822.13,144,93,51,42.059,0,2012,1,112,304,177,0.870164676756309,38.5,18.2296703296703,65,1248.36680307251,-1.1942760325767
24885,528292.325,5326822.13,180,61,119,16.062,1,2013,3,138,300,186,0.84812219274858,-164.8,18.7813186813187,48,1248.36680307251,-1.1942760325767
24885,528292.325,5326822.13,157,68,89,33.282,0,2014,2,112,337,185,0.857716963567653,101.8,17.4461538461538,73,1248.36680307251,-1.1942760325767
24885,528292.325,5326822.13,152,93,59,39.184,0,2015,2,110,341,185,0.816447928305899,-192.4,20.4978021978022,75,1248.36680307251,-1.1942760325767
24885,528292.325,5326822.13,165,94,71,2.097,0,2016,2,152,321,201,0.84275294445505,-4.8,18.6318681318681,49,1248.36680307251,-1.1942760325767
24885,528292.325,5326822.13,138,94,44,35.147,4,2017,1,111,292,170,0.835400405428467,-54.4,19.6516483516484,59,1248.36680307251,-1.1942760325767
24885,528292.325,5326822.13,171,59,112,31.115,0,2018,2,116,290,185,0.864000722824403,-121.8,20.367032967033,69,1248.36680307251,-1.1942760325767
24885,528292.325,5326822.13,151,94,57,28.036,3,2019,1,122,299,170,0.841523614557602,-107,20.478021978022,48,1248.36680307251,-1.1942760325767
24885,528292.325,5326822.13,0,0,0,30.218,0,2020,0,108,276,216,0.77833461738485,-91.9,18.7142857142857,108,1248.36680307251,-1.1942760325767
24987,528523.981,5353925.924,0,0,0,105.59,0,2001,1,57,337,217,0.82372652787179,4.09999999999999,18.2296703296703,160,1086.94131306385,0.934756594125758
24987,528523.981,5353925.924,106,94,12,79.807,10,2002,2,71,340,242,0.827889544955418,18.8,18.3868131868132,171,1086.94131306385,0.934756594125758
24987,528523.981,5353925.924,145,93,52,71.903,16,2003,1,73,341,154,0.790342813682298,-204,23.121978021978,81,1086.94131306385,0.934756594125758
24987,528523.981,5353925.924,187,93,94,37.325,0,2004,2,111,343,225,0.799146912039025,123.8,17.9692307692308,114,1086.94131306385,0.934756594125758
24987,528523.981,5353925.924,154,93,61,66.216,2,2005,2,89,318,162,0.822105620454737,-31.4,18.0615384615385,73,1086.94131306385,0.934756594125758
24987,528523.981,5353925.924,172,93,79,43.947,0,2006,2,110,347,266,0.797381239315598,43,19.0516483516484,156,1086.94131306385,0.934756594125758
24987,528523.981,5353925.924,0,0,0,119.145,0,2007,0,29,303,209,0.84745770600485,258.5,17.3142857142857,180,1086.94131306385,0.934756594125758
24987,528523.981,5353925.924,0,0,0,113.95,0,2008,0,40,324,185,0.823366227206513,29.3,17.7417582417582,145,1086.94131306385,0.934756594125758
24987,528523.981,5353925.924,171,65,106,43.435,0,2009,3,102,335,185,0.853340125732646,27.1,18.689010989011,83,1086.94131306385,0.934756594125758
24987,528523.981,5353925.924,147,85,62,62.139,4,2010,3,89,315,265,0.805999368090535,87.4,18.4241758241758,176,1086.94131306385,0.934756594125758
24987,528523.981,5353925.924,86,61,25,89.452,21,2011,1,42,326,185,0.81767517252019,129,17.5824175824176,143,1086.94131306385,0.934756594125758
24987,528523.981,5353925.924,139,93,46,80.962,8,2012,2,68,316,201,0.84010191782251,29,18.7703296703297,133,1086.94131306385,0.934756594125758
24987,528523.981,5353925.924,150,63,87,63.975,5,2013,3,94,310,201,0.8381663228672,-172.4,19.2857142857143,107,1086.94131306385,0.934756594125758
24987,528523.981,5353925.924,93,53,40,72.279,9,2014,3,63,349,201,0.843981976491068,91.5,17.9450549450549,138,1086.94131306385,0.934756594125758
24987,528523.981,5353925.924,151,94,57,57.036,4,2015,2,92,345,209,0.848026693065671,-197.8,21,117,1086.94131306385,0.934756594125758
24987,528523.981,5353925.924,160,93,67,59.509,5,2016,2,96,348,304,0.814120863714935,-13,19.132967032967,208,1086.94131306385,0.934756594125758
24987,528523.981,5353925.924,111,93,18,90.137,8,2017,2,56,316,258,0.81218457339347,-57.8,20.1032967032967,202,1086.94131306385,0.934756594125758
24987,528523.981,5353925.924,160,66,94,53.387,0,2018,2,94,350,193,0.782377212918873,-125.4,20.7956043956044,99,1086.94131306385,0.934756594125758
24987,528523.981,5353925.924,131,95,36,72.154,14,2019,1,76,333,177,0.802800878683584,-108.1,20.8824175824176,101,1086.94131306385,0.934756594125758
24987,528523.981,5353925.924,0,0,0,89.921,0,2020,0,48,328,201,0.768542015493965,-97.4,19.156043956044,153,1086.94131306385,0.934756594125758
24988,528523.981,5353694.268,127,94,33,73.703,8,2001,3,83,328,169,0.802072336114472,4.09999999999999,18.2296703296703,86,1022.19873364925,0.978997513184398
24988,528523.981,5353694.268,107,94,13,68.243,10,2002,2,81,338,240,0.793079935656649,18.8,18.3868131868132,159,1022.19873364925,0.978997513184398
24988,528523.981,5353694.268,149,93,56,61.13,10,2003,1,83,308,153,0.785296357557004,-204,23.121978021978,70,1022.19873364925,0.978997513184398
24988,528523.981,5353694.268,189,93,96,31.768,0,2004,2,117,341,233,0.786159466184599,123.8,17.9692307692308,116,1022.19873364925,0.978997513184398
24988,528523.981,5353694.268,150,93,57,74.252,2,2005,3,82,315,186,0.799040119034382,-31.4,18.0615384615385,104,1022.19873364925,0.978997513184398
24988,528523.981,5353694.268,172,93,79,40.331,0,2006,2,113,344,266,0.81297642277152,43,19.0516483516484,153,1022.19873364925,0.978997513184398
24988,528523.981,5353694.268,0,0,0,108.558,0,2007,0,39,316,218,0.820387665211644,258.5,17.3142857142857,179,1022.19873364925,0.978997513184398
24988,528523.981,5353694.268,0,0,0,110.721,0,2008,0,43,316,250,0.813600588322294,29.3,17.7417582417582,207,1022.19873364925,0.978997513184398
24988,528523.981,5353694.268,165,63,102,57.985,0,2009,2,90,329,169,0.852418999801057,27.1,18.689010989011,79,1022.19873364925,0.978997513184398
24988,528523.981,5353694.268,144,83,61,63.44,4,2010,3,88,314,258,0.797540166094061,87.4,18.4241758241758,170,1022.19873364925,0.978997513184398
24988,528523.981,5353694.268,86,60,26,68.957,9,2011,1,62,325,169,0.823412136992219,129,17.5824175824176,107,1022.19873364925,0.978997513184398
24988,528523.981,5353694.268,147,93,54,62.22,4,2012,2,87,313,185,0.855153547179467,29,18.7703296703297,98,1022.19873364925,0.978997513184398
24988,528523.981,5353694.268,160,62,98,39.581,0,2013,3,115,306,193,0.830574435239716,-172.4,19.2857142857143,78,1022.19873364925,0.978997513184398
24988,528523.981,5353694.268,93,50,43,47.836,3,2014,3,90,347,200,0.818328973752945,91.5,17.9450549450549,110,1022.19873364925,0.978997513184398
24988,528523.981,5353694.268,149,93,56,58.187,4,2015,2,91,345,217,0.817865902462856,-197.8,21,126,1022.19873364925,0.978997513184398
24988,528523.981,5353694.268,161,93,68,61.574,5,2016,1,94,341,161,0.839458286485809,-13,19.132967032967,67,1022.19873364925,0.978997513184398
24988,528523.981,5353694.268,117,94,23,66.05,6,2017,2,76,303,232,0.810584795179076,-57.8,20.1032967032967,156,1022.19873364925,0.978997513184398
24988,528523.981,5353694.268,162,63,99,48.587,0,2018,2,98,344,145,0.818258049755056,-125.4,20.7956043956044,47,1022.19873364925,0.978997513184398
24988,528523.981,5353694.268,132,95,37,65.003,10,2019,1,82,333,169,0.804431272228825,-108.1,20.8824175824176,87,1022.19873364925,0.978997513184398
24988,528523.981,5353694.268,0,0,0,66.265,0,2020,0,68,324,170,0.781895028195683,-97.4,19.156043956044,102,1022.19873364925,0.978997513184398
24989,528523.981,5353462.611,0,0,0,114.044,0,2001,1,49,332,241,0.832472089484625,4.09999999999999,18.2296703296703,192,966.497400064149,1.31269209609897
24989,528523.981,5353462.611,93,85,8,61.915,6,2002,3,86,323,217,0.860186921667728,18.8,18.3868131868132,131,966.497400064149,1.31269209609897
24989,528523.981,5353462.611,149,108,41,52.238,10,2003,1,92,307,153,0.853953986296908,-204,23.121978021978,61,966.497400064149,1.31269209609897
24989,528523.981,5353462.611,141,94,47,56.33,3,2004,2,93,331,258,0.850001027145578,123.8,17.9692307692308,165,966.497400064149,1.31269209609897
24989,528523.981,5353462.611,0,0,0,123.318,0,2005,0,37,311,161,0.855112280364173,-31.4,18.0615384615385,124,966.497400064149,1.31269209609897
24989,528523.981,5353462.611,167,95,72,47.771,0,2006,1,107,340,162,0.837968577018647,43,19.0516483516484,55,966.497400064149,1.31269209609897
24989,528523.981,5353462.611,0,0,0,106.388,0,2007,0,41,320,226,0.844587325064478,258.5,17.3142857142857,185,966.497400064149,1.31269209609897
24989,528523.981,5353462.611,0,0,0,95.157,0,2008,0,59,303,249,0.843277642837418,29.3,17.7417582417582,190,966.497400064149,1.31269209609897
24989,528523.981,5353462.611,160,71,89,54.211,0,2009,2,93,320,162,0.867751382317444,27.1,18.689010989011,69,966.497400064149,1.31269209609897
24989,528523.981,5353462.611,147,103,44,52.992,2,2010,1,96,305,161,0.830901723874096,87.4,18.4241758241758,65,966.497400064149,1.31269209609897
24989,528523.981,5353462.611,93,61,32,59.124,3,2011,2,72,315,154,0.857425021121497,129,17.5824175824176,82,966.497400064149,1.31269209609897
24989,528523.981,5353462.611,136,94,42,64.999,4,2012,1,84,316,169,0.860030029897689,29,18.7703296703297,85,966.497400064149,1.31269209609897
24989,528523.981,5353462.611,173,93,80,46.116,0,2013,2,109,314,185,0.844593738363826,-172.4,19.2857142857143,76,966.497400064149,1.31269209609897
24989,528523.981,5353462.611,86,74,12,72.279,9,2014,1,63,340,242,0.882505174213781,91.5,17.9450549450549,179,966.497400064149,1.31269209609897
24989,528523.981,5353462.611,138,93,45,65.273,4,2015,2,84,324,226,0.831297314311135,-197.8,21,142,966.497400064149,1.31269209609897
24989,528523.981,5353462.611,148,93,55,70.969,5,2016,1,85,334,153,0.844520844091889,-13,19.132967032967,68,966.497400064149,1.31269209609897
24989,528523.981,5353462.611,117,93,24,76.842,7,2017,2,67,309,226,0.858006847197844,-57.8,20.1032967032967,159,966.497400064149,1.31269209609897
24989,528523.981,5353462.611,160,71,89,48.587,0,2018,2,98,318,145,0.851181184543845,-125.4,20.7956043956044,47,966.497400064149,1.31269209609897
24989,528523.981,5353462.611,126,82,44,61.823,10,2019,2,85,328,161,0.845324736851846,-108.1,20.8824175824176,76,966.497400064149,1.31269209609897
24989,528523.981,5353462.611,0,0,0,68.844,0,2020,0,66,315,169,0.830131538420933,-97.4,19.156043956044,103,966.497400064149,1.31269209609897
24992,528523.981,5352767.642,0,0,0,79.116,0,2001,1,79,312,193,0.831406546707417,4.09999999999999,18.2296703296703,114,944.292825990857,-1.49887005401038
24992,528523.981,5352767.642,93,93,0,63.104,7,2002,2,85,329,192,0.830064020277629,18.8,18.3868131868132,107,944.292825990857,-1.49887005401038
24992,528523.981,5352767.642,146,93,53,55.139,10,2003,1,89,324,153,0.804704719668004,-204,23.121978021978,64,944.292825990857,-1.49887005401038
24992,528523.981,5352767.642,140,94,46,50.99,3,2004,1,98,337,168,0.804608811345623,123.8,17.9692307692308,70,944.292825990857,-1.49887005401038
24992,528523.981,5352767.642,0,0,0,139.527,0,2005,0,22,307,154,0.828794530574741,-31.4,18.0615384615385,132,944.292825990857,-1.49887005401038
24992,528523.981,5352767.642,167,68,99,45.197,0,2006,2,109,343,154,0.850318318859741,43,19.0516483516484,45,944.292825990857,-1.49887005401038
24992,528523.981,5352767.642,0,0,0,83.063,0,2007,0,61,308,193,0.852672684766249,258.5,17.3142857142857,132,944.292825990857,-1.49887005401038
24992,528523.981,5352767.642,86,79,7,108.658,26,2008,1,45,302,168,0.82942459031075,29.3,17.7417582417582,123,944.292825990857,-1.49887005401038
24992,528523.981,5352767.642,164,93,71,54.211,0,2009,1,93,326,177,0.854846132494708,27.1,18.689010989011,84,944.292825990857,-1.49887005401038
24992,528523.981,5352767.642,151,93,58,42.262,0,2010,1,105,303,169,0.817856132351552,87.4,18.4241758241758,64,944.292825990857,-1.49887005401038
24992,528523.981,5352767.642,93,93,0,66.928,7,2011,1,64,337,160,0.830943583777995,129,17.5824175824176,96,944.292825990857,-1.49887005401038
24992,528523.981,5352767.642,139,93,46,69.942,5,2012,1,79,314,161,0.850117640880431,29,18.7703296703297,82,944.292825990857,-1.49887005401038
24992,528523.981,5352767.642,159,64,95,44.976,0,2013,3,110,313,193,0.845784612009079,-172.4,19.2857142857143,83,944.292825990857,-1.49887005401038
24992,528523.981,5352767.642,86,64,22,76.591,12,2014,1,59,330,226,0.861687718917725,91.5,17.9450549450549,167,944.292825990857,-1.49887005401038
24992,528523.981,5352767.642,153,97,56,52.287,2,2015,1,96,342,154,0.852560122407212,-197.8,21,58,944.292825990857,-1.49887005401038
24992,528523.981,5352767.642,158,93,65,64.779,5,2016,1,91,338,176,0.876579804203503,-13,19.132967032967,85,944.292825990857,-1.49887005401038
24992,528523.981,5352767.642,123,93,30,67.15,6,2017,1,75,305,169,0.829575512121338,-57.8,20.1032967032967,94,944.292825990857,-1.49887005401038
24992,528523.981,5352767.642,0,0,0,133.792,0,2018,0,21,345,161,0.827540497170449,-125.4,20.7956043956044,140,944.292825990857,-1.49887005401038
24992,528523.981,5352767.642,125,93,32,58.818,9,2019,1,88,327,162,0.84674863201289,-108.1,20.8824175824176,74,944.292825990857,-1.49887005401038
24992,528523.981,5352767.642,93,93,0,73.6,18,2020,1,62,332,169,0.819030058114891,-97.4,19.156043956044,107,944.292825990857,-1.49887005401038
24993,528523.981,5352535.986,0,0,0,101.385,0,2001,0,61,342,145,0.770737815356762,4.09999999999999,18.2296703296703,84,921.333878881398,0.36305648825104
24993,528523.981,5352535.986,0,0,0,97.318,0,2002,0,57,346,249,0.816458579156606,18.8,18.3868131868132,192,921.333878881398,0.36305648825104
24993,528523.981,5352535.986,150,93,57,60.106,10,2003,1,84,338,145,0.770443948770662,-204,23.121978021978,61,921.333878881398,0.36305648825104
24993,528523.981,5352535.986,128,96,32,75.241,10,2004,1,75,342,168,0.788786084179215,123.8,17.9692307692308,93,921.333878881398,0.36305648825104
24993,528523.981,5352535.986,0,0,0,139.527,0,2005,0,22,318,144,0.815143614846775,-31.4,18.0615384615385,122,921.333878881398,0.36305648825104
24993,528523.981,5352535.986,164,96,68,47.771,0,2006,1,107,349,153,0.82868554633743,43,19.0516483516484,46,921.333878881398,0.36305648825104
24993,528523.981,5352535.986,0,0,0,110.639,0,2007,0,37,314,218,0.838106646669944,258.5,17.3142857142857,181,921.333878881398,0.36305648825104
24993,528523.981,5352535.986,0,0,0,118.448,0,2008,0,36,319,273,0.825609267777222,29.3,17.7417582417582,237,921.333878881398,0.36305648825104
24993,528523.981,5352535.986,141,73,68,88.035,15,2009,3,65,328,193,0.8534348641222,27.1,18.689010989011,128,921.333878881398,0.36305648825104
24993,528523.981,5352535.986,151,93,58,60.851,4,2010,1,90,312,152,0.807188817828938,87.4,18.4241758241758,62,921.333878881398,0.36305648825104
24993,528523.981,5352535.986,119,73,46,76.174,14,2011,3,55,341,266,0.811705752482213,129,17.5824175824176,211,921.333878881398,0.36305648825104
24993,528523.981,5352535.986,132,93,39,73.87,5,2012,2,75,324,249,0.815688349838753,29,18.7703296703297,174,921.333878881398,0.36305648825104
24993,528523.981,5352535.986,161,79,82,57.494,0,2013,2,100,323,178,0.831290156707376,-172.4,19.2857142857143,78,921.333878881398,0.36305648825104
24993,528523.981,5352535.986,0,0,0,74.41,0,2014,0,61,330,289,0.825832835102723,91.5,17.9450549450549,228,921.333878881398,0.36305648825104
24993,528523.981,5352535.986,146,96,50,63.396,4,2015,1,86,350,161,0.827381986042689,-197.8,21,75,921.333878881398,0.36305648825104
24993,528523.981,5352535.986,157,98,59,63.694,5,2016,2,92,344,209,0.842479049308998,-13,19.132967032967,117,921.333878881398,0.36305648825104
24993,528523.981,5352535.986,116,93,23,97.836,10,2017,1,49,313,153,0.806189423658763,-57.8,20.1032967032967,104,921.333878881398,0.36305648825104
24993,528523.981,5352535.986,0,0,0,142.277,0,2018,0,14,346,138,0.788699890452165,-125.4,20.7956043956044,124,921.333878881398,0.36305648825104
24993,528523.981,5352535.986,129,93,36,72.154,14,2019,1,76,344,146,0.80630626895663,-108.1,20.8824175824176,70,921.333878881398,0.36305648825104
24993,528523.981,5352535.986,0,0,0,88.702,0,2020,0,49,337,145,0.778748714087821,-97.4,19.156043956044,96,921.333878881398,0.36305648825104
25060,528523.981,5337015.01,0,0,0,139.123,0,2001,1,30,307,154,0.829194756256426,-14.2,19.5065934065934,124,983.404087273474,-0.0354938905328815
25060,528523.981,5337015.01,86,79,7,47.086,0,2002,1,101,331,248,0.839687857636974,3,19.4725274725275,147,983.404087273474,-0.0354938905328815
25060,528523.981,5337015.01,150,93,57,43.097,3,2003,1,100,326,152,0.822665680408567,-209,24.2648351648352,52,983.404087273474,-0.0354938905328815
25060,528523.981,5337015.01,93,93,0,53.489,0,2004,1,96,332,153,0.819219214604664,104,19.0769230769231,57,983.404087273474,-0.0354938905328815
25060,528523.981,5337015.01,0,0,0,78.309,0,2005,0,78,310,146,0.839556408074955,-49.6,19.2098901098901,68,983.404087273474,-0.0354938905328815
25060,528523.981,5337015.01,177,55,122,58.71,4,2006,2,96,339,153,0.84157370855152,25.1,20.1736263736264,57,983.404087273474,-0.0354938905328815
25060,528523.981,5337015.01,0,0,0,80.565,0,2007,0,64,307,137,0.824749687040338,229.8,18.3494505494505,73,983.404087273474,-0.0354938905328815
25060,528523.981,5337015.01,0,0,0,44.279,0,2008,0,105,315,169,0.830206716280445,8.90000000000001,18.8,64,983.404087273474,-0.0354938905328815
25060,528523.981,5337015.01,153,93,60,46.733,0,2009,1,95,320,153,0.85562269027206,9.4,19.7494505494506,58,983.404087273474,-0.0354938905328815
25060,528523.981,5337015.01,159,108,51,36.691,0,2010,1,108,309,162,0.820881481714011,64.4,19.4725274725275,54,983.404087273474,-0.0354938905328815
25060,528523.981,5337015.01,116,63,53,48.924,2,2011,2,80,322,153,0.847147927491592,103.5,18.7505494505494,73,983.404087273474,-0.0354938905328815
25060,528523.981,5337015.01,0,0,0,59.714,0,2012,0,90,312,154,0.859693703098758,3.2,20.1307692307692,64,983.404087273474,-0.0354938905328815
25060,528523.981,5337015.01,0,0,0,47.834,0,2013,0,107,313,154,0.847207646372238,-190.8,20.5692307692308,47,983.404087273474,-0.0354938905328815
25060,528523.981,5337015.01,77,55,22,60.635,3,2014,1,74,321,144,0.837741862318358,65.4,19.2153846153846,70,983.404087273474,-0.0354938905328815
25060,528523.981,5337015.01,93,81,12,57.061,4,2015,2,93,327,152,0.853266298712872,-212.4,22.3164835164835,59,983.404087273474,-0.0354938905328815
25060,528523.981,5337015.01,153,94,59,77.264,6,2016,1,79,335,161,0.86781953137934,-31.9,20.4131868131868,82,983.404087273474,-0.0354938905328815
25060,528523.981,5337015.01,134,94,40,50.938,5,2017,1,90,324,161,0.834591824856233,-70.8,21.2648351648352,71,983.404087273474,-0.0354938905328815
25060,528523.981,5337015.01,145,137,8,120.736,31,2018,1,32,348,144,0.836035392870601,-135.7,21.9263736263736,112,983.404087273474,-0.0354938905328815
25060,528523.981,5337015.01,93,93,0,48.37,4,2019,1,100,336,161,0.828318412212224,-112.7,22.0065934065934,61,983.404087273474,-0.0354938905328815
25060,528523.981,5337015.01,95,93,2,40.37,3,2020,1,92,318,160,0.83020402814251,-111.3,20.3164835164835,68,983.404087273474,-0.0354938905328815
25061,528523.981,5336783.354,0,0,0,71.197,0,2001,1,86,306,161,0.854391532340206,-14.2,19.5065934065934,75,1033.95672465853,-0.64755077117246
25061,528523.981,5336783.354,85,80,5,45.428,0,2002,1,103,323,241,0.843216335571996,3,19.4725274725275,138,1033.95672465853,-0.64755077117246
25061,528523.981,5336783.354,0,0,0,39.544,0,2003,0,104,305,153,0.834721501124135,-209,24.2648351648352,49,1033.95672465853,-0.64755077117246
25061,528523.981,5336783.354,155,120,35,47.934,0,2004,1,101,326,154,0.873695336281188,104,19.0769230769231,53,1033.95672465853,-0.64755077117246
25061,528523.981,5336783.354,149,86,63,58.417,2,2005,3,97,316,153,0.863383486560063,-49.6,19.2098901098901,56,1033.95672465853,-0.64755077117246
25061,528523.981,5336783.354,176,93,83,58.71,4,2006,1,96,340,160,0.841787002900332,25.1,20.1736263736264,64,1033.95672465853,-0.64755077117246
25061,528523.981,5336783.354,0,0,0,66.849,0,2007,0,76,313,146,0.892217680562974,229.8,18.3494505494505,70,1033.95672465853,-0.64755077117246
25061,528523.981,5336783.354,0,0,0,36.119,0,2008,0,112,317,168,0.823918850263699,8.90000000000001,18.8,56,1033.95672465853,-0.64755077117246
25061,528523.981,5336783.354,152,95,57,41.748,0,2009,1,100,315,161,0.886287596723611,9.4,19.7494505494506,61,1033.95672465853,-0.64755077117246
25061,528523.981,5336783.354,151,109,42,33.149,0,2010,1,112,313,168,0.850955331521668,64.4,19.4725274725275,56,1033.95672465853,-0.64755077117246
25061,528523.981,5336783.354,117,69,48,46.325,0,2011,2,83,334,153,0.841181379101822,103.5,18.7505494505494,70,1033.95672465853,-0.64755077117246
25061,528523.981,5336783.354,86,86,0,52.803,3,2012,1,99,317,154,0.862654748085678,3.2,20.1307692307692,55,1033.95672465853,-0.64755077117246
25061,528523.981,5336783.354,166,93,73,69.609,12,2013,1,87,319,161,0.868703018762732,-190.8,20.5692307692308,74,1033.95672465853,-0.64755077117246
25061,528523.981,5336783.354,0,0,0,53.851,0,2014,0,82,348,153,0.858328755636122,65.4,19.2153846153846,71,1033.95672465853,-0.64755077117246
25061,528523.981,5336783.354,93,93,0,57.061,4,2015,1,93,343,153,0.876746596449141,-212.4,22.3164835164835,60,1033.95672465853,-0.64755077117246
25061,528523.981,5336783.354,130,100,30,72.466,5,2016,1,84,324,169,0.870760285636244,-31.9,20.4131868131868,85,1033.95672465853,-0.64755077117246
25061,528523.981,5336783.354,126,98,28,45.579,5,2017,1,96,326,161,0.83978945885601,-70.8,21.2648351648352,65,1033.95672465853,-0.64755077117246
25061,528523.981,5336783.354,0,0,0,107.097,0,2018,0,44,312,153,0.862277878551632,-135.7,21.9263736263736,109,1033.95672465853,-0.64755077117246
25061,528523.981,5336783.354,130,93,37,43.433,2,2019,1,105,338,160,0.855625032170645,-112.7,22.0065934065934,55,1033.95672465853,-0.64755077117246
25061,528523.981,5336783.354,0,0,0,39.492,0,2020,0,93,310,169,0.85490015658441,-111.3,20.3164835164835,76,1033.95672465853,-0.64755077117246
25062,528523.981,5336551.697,0,0,0,64.99,0,2001,1,91,307,169,0.845994716073944,-14.2,19.5065934065934,78,1052.38883460453,0.309942811525703
25062,528523.981,5336551.697,86,83,3,44.567,0,2002,1,104,301,169,0.84698924110351,3,19.4725274725275,65,1052.38883460453,0.309942811525703
25062,528523.981,5336551.697,93,93,0,37.023,1,2003,1,107,286,160,0.828054936918926,-209,24.2648351648352,53,1052.38883460453,0.309942811525703
25062,528523.981,5336551.697,155,110,45,43.67,0,2004,1,105,321,162,0.847277178507773,104,19.0769230769231,57,1052.38883460453,0.309942811525703
25062,528523.981,5336551.697,146,93,53,59.382,2,2005,2,96,313,153,0.845327014909878,-49.6,19.2098901098901,57,1052.38883460453,0.309942811525703
25062,528523.981,5336551.697,185,93,92,32.024,0,2006,1,120,340,168,0.856486701347282,25.1,20.1736263736264,48,1052.38883460453,0.309942811525703
25062,528523.981,5336551.697,0,0,0,59.346,0,2007,0,83,305,168,0.841371878252908,229.8,18.3494505494505,85,1052.38883460453,0.309942811525703
25062,528523.981,5336551.697,0,0,0,28.073,0,2008,0,119,309,184,0.844064441017811,8.90000000000001,18.8,65,1052.38883460453,0.309942811525703
25062,528523.981,5336551.697,151,93,58,39.905,0,2009,1,102,317,169,0.893893081910492,9.4,19.7494505494506,67,1052.38883460453,0.309942811525703
25062,528523.981,5336551.697,149,103,46,29.89,0,2010,1,116,308,177,0.857278569876677,64.4,19.4725274725275,61,1052.38883460453,0.309942811525703
25062,528523.981,5336551.697,117,68,49,47.177,0,2011,2,82,334,162,0.857051066913271,103.5,18.7505494505494,80,1052.38883460453,0.309942811525703
25062,528523.981,5336551.697,0,0,0,50.533,0,2012,0,102,311,161,0.872536634375188,3.2,20.1307692307692,59,1052.38883460453,0.309942811525703
25062,528523.981,5336551.697,172,94,78,45.704,0,2013,1,109,312,169,0.872537706598648,-190.8,20.5692307692308,60,1052.38883460453,0.309942811525703
25062,528523.981,5336551.697,0,0,0,62.436,0,2014,0,72,344,176,0.863466331756213,65.4,19.2153846153846,104,1052.38883460453,0.309942811525703
25062,528523.981,5336551.697,93,93,0,50.027,0,2015,1,99,340,161,0.878563884301893,-212.4,22.3164835164835,62,1052.38883460453,0.309942811525703
25062,528523.981,5336551.697,129,93,36,61.63,4,2016,1,95,324,177,0.870856947445047,-31.9,20.4131868131868,82,1052.38883460453,0.309942811525703
25062,528523.981,5336551.697,126,97,29,43.904,5,2017,2,98,323,208,0.839292668009936,-70.8,21.2648351648352,110,1052.38883460453,0.309942811525703
25062,528523.981,5336551.697,0,0,0,124.217,0,2018,0,29,310,162,0.856525825035088,-135.7,21.9263736263736,133,1052.38883460453,0.309942811525703
25062,528523.981,5336551.697,129,97,32,42.477,2,2019,1,106,337,169,0.866204973957979,-112.7,22.0065934065934,63,1052.38883460453,0.309942811525703
25062,528523.981,5336551.697,0,0,0,39.492,0,2020,0,93,288,178,0.865331923288635,-111.3,20.3164835164835,85,1052.38883460453,0.309942811525703
25073,528523.981,5334003.477,0,0,0,148.474,0,2001,2,19,339,185,0.847203613028298,10.6,17.710989010989,166,1121.81901968578,-1.46189965852544
25073,528523.981,5334003.477,110,84,26,76.967,10,2002,3,76,343,192,0.827710022206986,25.6,17.9494505494505,116,1121.81901968578,-1.46189965852544
25073,528523.981,5334003.477,0,0,0,71.205,0,2003,0,76,338,168,0.823453623595317,-201.3,22.6626373626374,92,1121.81901968578,-1.46189965852544
25073,528523.981,5334003.477,146,98,48,65.143,7,2004,2,87,340,217,0.838943492259545,132.4,17.5076923076923,130,1121.81901968578,-1.46189965852544
25073,528523.981,5334003.477,134,124,10,97.229,14,2005,1,62,318,178,0.84963412396853,-23.3,17.6,116,1121.81901968578,-1.46189965852544
25073,528523.981,5334003.477,175,64,111,48.352,2,2006,3,108,350,274,0.814921616665735,50,18.6131868131868,166,1121.81901968578,-1.46189965852544
25073,528523.981,5334003.477,0,0,0,133.895,0,2007,0,18,330,208,0.851075395040237,269.6,16.9021978021978,190,1121.81901968578,-1.46189965852544
25073,528523.981,5334003.477,0,0,0,45.444,0,2008,0,104,315,201,0.831816547863182,38,17.3098901098901,97,1121.81901968578,-1.46189965852544
25073,528523.981,5334003.477,149,64,85,65.52,2,2009,3,85,328,193,0.845914352140678,34.6,18.2571428571429,108,1121.81901968578,-1.46189965852544
25073,528523.981,5334003.477,156,103,53,48.194,2,2010,1,102,317,177,0.821932494038156,95.1,17.9945054945055,75,1121.81901968578,-1.46189965852544
25073,528523.981,5334003.477,95,70,25,106.441,28,2011,3,29,331,233,0.803861063175991,139.3,17.1164835164835,204,1121.81901968578,-1.46189965852544
25073,528523.981,5334003.477,0,0,0,70.009,0,2012,0,81,298,162,0.852458379650505,38.5,18.2296703296703,81,1121.81901968578,-1.46189965852544
25073,528523.981,5334003.477,177,60,117,20.056,1,2013,3,134,315,257,0.793075096752559,-164.8,18.7813186813187,123,1121.81901968578,-1.46189965852544
25073,528523.981,5334003.477,94,94,0,46.979,3,2014,1,93,318,168,0.804874099961658,101.8,17.4461538461538,75,1121.81901968578,-1.46189965852544
25073,528523.981,5334003.477,98,95,3,55.71,4,2015,1,94,344,161,0.836804446493327,-192.4,20.4978021978022,67,1121.81901968578,-1.46189965852544
25073,528523.981,5334003.477,166,112,54,45.1,5,2016,1,110,338,201,0.830234980315181,-4.8,18.6318681318681,91,1121.81901968578,-1.46189965852544
25073,528523.981,5334003.477,125,94,31,49.916,7,2017,1,93,318,177,0.819764923429476,-54.4,19.6516483516484,84,1121.81901968578,-1.46189965852544
25073,528523.981,5334003.477,93,93,0,67.638,3,2018,1,83,308,161,0.840856182659992,-121.8,20.367032967033,78,1121.81901968578,-1.46189965852544
25073,528523.981,5334003.477,138,96,42,46.431,7,2019,1,102,337,170,0.814571360916577,-107,20.478021978022,68,1121.81901968578,-1.46189965852544
25073,528523.981,5334003.477,0,0,0,104.513,0,2020,0,38,317,185,0.793919163322086,-91.9,18.7142857142857,147,1121.81901968578,-1.46189965852544
25074,528523.981,5333771.821,0,0,0,142.25,0,2001,2,25,325,176,0.837959986203151,10.6,17.710989010989,151,1073.16726062444,-0.348126489706822
25074,528523.981,5333771.821,123,83,40,50.401,2,2002,2,99,342,177,0.833277731250791,25.6,17.9494505494505,78,1073.16726062444,-0.348126489706822
25074,528523.981,5333771.821,0,0,0,61.57,0,2003,0,85,305,161,0.828055604557815,-201.3,22.6626373626374,76,1073.16726062444,-0.348126489706822
25074,528523.981,5333771.821,145,69,76,49.727,1,2004,3,101,335,185,0.829246025305079,132.4,17.5076923076923,84,1073.16726062444,-0.348126489706822
25074,528523.981,5333771.821,155,106,49,62.974,2,2005,1,93,312,161,0.82613777565352,-23.3,17.6,68,1073.16726062444,-0.348126489706822
25074,528523.981,5333771.821,174,63,111,40.802,2,2006,3,114,347,256,0.807121937945406,50,18.6131868131868,142,1073.16726062444,-0.348126489706822
25074,528523.981,5333771.821,0,0,0,131.297,0,2007,0,20,322,224,0.823904248256612,269.6,16.9021978021978,204,1073.16726062444,-0.348126489706822
25074,528523.981,5333771.821,0,0,0,44.199,0,2008,0,105,316,185,0.81999521794732,38,17.3098901098901,80,1073.16726062444,-0.348126489706822
25074,528523.981,5333771.821,155,66,89,44.024,0,2009,2,103,318,169,0.86483313306344,34.6,18.2571428571429,66,1073.16726062444,-0.348126489706822
25074,528523.981,5333771.821,158,112,46,42.316,0,2010,1,107,315,177,0.81298474719617,95.1,17.9945054945055,70,1073.16726062444,-0.348126489706822
25074,528523.981,5333771.821,115,69,46,66.419,4,2011,3,67,330,234,0.787228999074655,139.3,17.1164835164835,167,1073.16726062444,-0.348126489706822
25074,528523.981,5333771.821,0,0,0,51.881,0,2012,0,101,307,169,0.836339697881816,38.5,18.2296703296703,68,1073.16726062444,-0.348126489706822
25074,528523.981,5333771.821,177,63,114,26.186,1,2013,2,128,318,178,0.828058353357727,-164.8,18.7813186813187,50,1073.16726062444,-0.348126489706822
25074,528523.981,5333771.821,0,0,0,54.838,0,2014,0,84,325,161,0.804820397807964,101.8,17.4461538461538,77,1073.16726062444,-0.348126489706822
25074,528523.981,5333771.821,0,0,0,63.682,0,2015,0,87,341,154,0.841792831699473,-192.4,20.4978021978022,67,1073.16726062444,-0.348126489706822
25074,528523.981,5333771.821,165,93,72,57.274,5,2016,1,99,337,169,0.84880790166307,-4.8,18.6318681318681,70,1073.16726062444,-0.348126489706822
25074,528523.981,5333771.821,127,95,32,52.814,7,2017,2,90,325,201,0.823700576189943,-54.4,19.6516483516484,111,1073.16726062444,-0.348126489706822
25074,528523.981,5333771.821,0,0,0,115.51,0,2018,0,38,312,161,0.831429841766002,-121.8,20.367032967033,123,1073.16726062444,-0.348126489706822
25074,528523.981,5333771.821,135,96,39,63.244,11,2019,1,85,341,169,0.823360039118626,-107,20.478021978022,84,1073.16726062444,-0.348126489706822
25074,528523.981,5333771.821,0,0,0,120.113,0,2020,0,24,321,185,0.816573920055653,-91.9,18.7142857142857,161,1073.16726062444,-0.348126489706822
25075,528523.981,5333540.164,0,0,0,137.719,0,2001,2,29,334,176,0.841190496876548,10.6,17.710989010989,147,1016.78361301075,0.749510216770182
25075,528523.981,5333540.164,131,74,57,55.328,4,2002,2,94,341,168,0.829592553549661,25.6,17.9494505494505,74,1016.78361301075,0.749510216770182
25075,528523.981,5333540.164,139,93,46,48.052,5,2003,1,98,330,153,0.790665061589565,-201.3,22.6626373626374,55,1016.78361301075,0.749510216770182
25075,528523.981,5333540.164,146,100,46,48.576,0,2004,1,102,320,177,0.814192849293818,132.4,17.5076923076923,75,1016.78361301075,0.749510216770182
25075,528523.981,5333540.164,0,0,0,130.752,0,2005,0,31,310,161,0.821415632438714,-23.3,17.6,130,1016.78361301075,0.749510216770182
25075,528523.981,5333540.164,197,62,135,30.589,1,2006,3,123,343,226,0.853723842439316,50,18.6131868131868,103,1016.78361301075,0.749510216770182
25075,528523.981,5333540.164,0,0,0,100.546,0,2007,0,47,324,226,0.819615338178503,269.6,16.9021978021978,179,1016.78361301075,0.749510216770182
25075,528523.981,5333540.164,0,0,0,49.237,0,2008,0,101,314,249,0.814691418787994,38,17.3098901098901,148,1016.78361301075,0.749510216770182
25075,528523.981,5333540.164,169,66,103,49.897,0,2009,2,98,314,169,0.853374646180125,34.6,18.2571428571429,71,1016.78361301075,0.749510216770182
25075,528523.981,5333540.164,159,81,78,44.625,0,2010,2,105,313,177,0.810418098621757,95.1,17.9945054945055,72,1016.78361301075,0.749510216770182
25075,528523.981,5333540.164,85,71,14,68.442,6,2011,1,65,330,161,0.842717041159437,139.3,17.1164835164835,96,1016.78361301075,0.749510216770182
25075,528523.981,5333540.164,142,94,48,53.549,4,2012,1,99,303,168,0.87303185638256,38.5,18.2296703296703,69,1016.78361301075,0.749510216770182
25075,528523.981,5333540.164,176,60,116,32.826,1,2013,2,122,323,177,0.835571012255133,-164.8,18.7813186813187,55,1016.78361301075,0.749510216770182
25075,528523.981,5333540.164,86,77,9,54.838,6,2014,1,84,344,160,0.821060490507885,101.8,17.4461538461538,76,1016.78361301075,0.749510216770182
25075,528523.981,5333540.164,93,93,0,63.682,5,2015,1,87,341,153,0.843007469875938,-192.4,20.4978021978022,66,1016.78361301075,0.749510216770182
25075,528523.981,5333540.164,167,93,74,55.133,5,2016,1,101,336,162,0.846094754623039,-4.8,18.6318681318681,61,1016.78361301075,0.749510216770182
25075,528523.981,5333540.164,0,0,0,54.829,0,2017,0,88,315,169,0.826111300452152,-54.4,19.6516483516484,81,1016.78361301075,0.749510216770182
25075,528523.981,5333540.164,86,73,13,60.936,1,2018,1,89,339,161,0.828963271447941,-121.8,20.367032967033,72,1016.78361301075,0.749510216770182
25075,528523.981,5333540.164,138,95,43,62.193,10,2019,1,86,340,169,0.840155193920497,-107,20.478021978022,83,1016.78361301075,0.749510216770182
25075,528523.981,5333540.164,0,0,0,57.503,0,2020,0,77,321,170,0.84356192075649,-91.9,18.7142857142857,93,1016.78361301075,0.749510216770182
25081,528523.981,5332150.226,0,0,0,143.346,0,2001,1,24,338,170,0.857932574828522,10.6,17.710989010989,146,931.199021821435,0.158718421050758
25081,528523.981,5332150.226,86,86,0,55.328,4,2002,1,94,343,232,0.868965202303176,25.6,17.9494505494505,138,931.199021821435,0.158718421050758
25081,528523.981,5332150.226,140,93,47,78.032,17,2003,1,70,332,169,0.820372333219009,-201.3,22.6626373626374,99,931.199021821435,0.158718421050758
25081,528523.981,5332150.226,138,93,45,64.051,6,2004,2,88,334,232,0.844080324617081,132.4,17.5076923076923,144,931.199021821435,0.158718421050758
25081,528523.981,5332150.226,0,0,0,140.779,0,2005,0,22,315,232,0.860897560780936,-23.3,17.6,210,931.199021821435,0.158718421050758
25081,528523.981,5332150.226,168,69,99,47.033,2,2006,3,109,342,233,0.877586522550607,50,18.6131868131868,124,931.199021821435,0.158718421050758
25081,528523.981,5332150.226,0,0,0,129.97,0,2007,0,21,316,226,0.844864562087766,269.6,16.9021978021978,205,931.199021821435,0.158718421050758
25081,528523.981,5332150.226,0,0,0,42.987,0,2008,0,106,308,233,0.817817854549387,38,17.3098901098901,127,931.199021821435,0.158718421050758
25081,528523.981,5332150.226,163,65,98,44.024,0,2009,2,103,307,161,0.836987316666948,34.6,18.2571428571429,58,931.199021821435,0.158718421050758
25081,528523.981,5332150.226,158,77,81,50.656,3,2010,2,100,313,170,0.809753073197112,95.1,17.9945054945055,70,931.199021821435,0.158718421050758
25081,528523.981,5332150.226,112,70,42,71.527,9,2011,3,62,322,241,0.7992200188388,139.3,17.1164835164835,179,931.199021821435,0.158718421050758
25081,528523.981,5332150.226,126,94,32,62.228,5,2012,1,89,316,170,0.847668875530869,38.5,18.2296703296703,81,931.199021821435,0.158718421050758
25081,528523.981,5332150.226,164,93,71,47.728,1,2013,2,109,315,184,0.83830472335284,-164.8,18.7813186813187,75,931.199021821435,0.158718421050758
25081,528523.981,5332150.226,107,93,14,82.369,15,2014,2,56,342,272,0.812963783944304,101.8,17.4461538461538,216,931.199021821435,0.158718421050758
25081,528523.981,5332150.226,0,0,0,71.485,0,2015,0,79,340,160,0.820797628403947,-192.4,20.4978021978022,81,931.199021821435,0.158718421050758
25081,528523.981,5332150.226,149,103,46,70.464,5,2016,1,87,332,162,0.833978611151802,-4.8,18.6318681318681,75,931.199021821435,0.158718421050758
25081,528523.981,5332150.226,104,93,11,53.815,7,2017,2,89,317,209,0.824900964096743,-54.4,19.6516483516484,120,931.199021821435,0.158718421050758
25081,528523.981,5332150.226,86,77,9,55.122,0,2018,1,94,336,154,0.84087180546829,-121.8,20.367032967033,60,931.199021821435,0.158718421050758
25081,528523.981,5332150.226,93,93,0,55.299,9,2019,1,93,338,168,0.818413504876989,-107,20.478021978022,75,931.199021821435,0.158718421050758
25081,528523.981,5332150.226,0,0,0,105.752,0,2020,0,37,316,170,0.816392190813899,-91.9,18.7142857142857,133,931.199021821435,0.158718421050758
25206,528755.638,5353925.924,0,0,0,86.993,0,2001,3,73,333,208,0.817560277544873,4.09999999999999,18.2296703296703,135,1074.6486361058,-0.479411355710371
25206,528755.638,5353925.924,107,94,13,74.427,10,2002,2,76,338,242,0.805633388575015,18.8,18.3868131868132,166,1074.6486361058,-0.479411355710371
25206,528755.638,5353925.924,141,93,48,70.777,15,2003,1,74,313,162,0.808095430576093,-204,23.121978021978,88,1074.6486361058,-0.479411355710371
25206,528755.638,5353925.924,181,95,86,54.283,3,2004,2,95,333,224,0.794818823970113,123.8,17.9692307692308,129,1074.6486361058,-0.479411355710371
25206,528755.638,5353925.924,151,93,58,74.252,2,2005,4,82,305,209,0.789770608772784,-31.4,18.0615384615385,127,1074.6486361058,-0.479411355710371
25206,528755.638,5353925.924,167,61,106,49.064,0,2006,2,106,346,169,0.772202288697844,43,19.0516483516484,63,1074.6486361058,-0.479411355710371
25206,528755.638,5353925.924,0,0,0,114.838,0,2007,0,33,301,178,0.811907473019064,258.5,17.3142857142857,145,1074.6486361058,-0.479411355710371
25206,528755.638,5353925.924,0,0,0,112.854,0,2008,0,41,317,225,0.83530452527595,29.3,17.7417582417582,184,1074.6486361058,-0.479411355710371
25206,528755.638,5353925.924,169,65,104,45.721,0,2009,3,100,330,184,0.847521856190354,27.1,18.689010989011,84,1074.6486361058,-0.479411355710371
25206,528755.638,5353925.924,152,84,68,54.324,2,2010,3,95,306,256,0.80114447801186,87.4,18.4241758241758,161,1074.6486361058,-0.479411355710371
25206,528755.638,5353925.924,0,0,0,75.156,0,2011,0,56,329,160,0.786524303679238,129,17.5824175824176,104,1074.6486361058,-0.479411355710371
25206,528755.638,5353925.924,143,83,60,64.05,4,2012,2,85,329,177,0.851204975832269,29,18.7703296703297,92,1074.6486361058,-0.479411355710371
25206,528755.638,5353925.924,163,93,70,48.502,0,2013,2,107,321,185,0.812031694916269,-172.4,19.2857142857143,78,1074.6486361058,-0.479411355710371
25206,528755.638,5353925.924,0,0,0,76.591,0,2014,0,59,328,273,0.826697403655219,91.5,17.9450549450549,214,1074.6486361058,-0.479411355710371
25206,528755.638,5353925.924,147,94,53,63.396,4,2015,2,86,342,192,0.811040047771929,-197.8,21,106,1074.6486361058,-0.479411355710371
25206,528755.638,5353925.924,161,93,68,56.27,5,2016,2,99,346,192,0.84817180429512,-13,19.132967032967,93,1074.6486361058,-0.479411355710371
25206,528755.638,5353925.924,127,94,33,53.967,6,2017,2,87,313,216,0.794505226976358,-57.8,20.1032967032967,129,1074.6486361058,-0.479411355710371
25206,528755.638,5353925.924,158,68,90,49.79,0,2018,2,97,345,192,0.775932992577925,-125.4,20.7956043956044,95,1074.6486361058,-0.479411355710371
25206,528755.638,5353925.924,0,0,0,82.076,0,2019,0,68,357,329,0.837588273429224,-108.1,20.8824175824176,261,1074.6486361058,-0.479411355710371
25206,528755.638,5353925.924,0,0,0,57.711,0,2020,0,75,324,193,0.754755706024046,-97.4,19.156043956044,118,1074.6486361058,-0.479411355710371
25207,528755.638,5353694.268,0,0,0,77.834,0,2001,2,80,329,200,0.813548950710991,4.09999999999999,18.2296703296703,120,1014.92745706695,1.43507350502646
25207,528755.638,5353694.268,107,94,13,69.61,10,2002,2,80,339,248,0.803192281479444,18.8,18.3868131868132,168,1014.92745706695,1.43507350502646
25207,528755.638,5353694.268,143,94,49,59.093,10,2003,1,85,305,161,0.828435704069913,-204,23.121978021978,76,1014.92745706695,1.43507350502646
25207,528755.638,5353694.268,180,94,86,56.33,3,2004,2,93,338,209,0.801888004208272,123.8,17.9692307692308,116,1014.92745706695,1.43507350502646
25207,528755.638,5353694.268,151,93,58,71.975,2,2005,4,84,303,218,0.823880700914396,-31.4,18.0615384615385,134,1014.92745706695,1.43507350502646
25207,528755.638,5353694.268,170,60,110,42.719,0,2006,3,111,345,257,0.797957839763587,43,19.0516483516484,146,1014.92745706695,1.43507350502646
25207,528755.638,5353694.268,0,0,0,106.388,0,2007,0,41,317,169,0.855414090712688,258.5,17.3142857142857,128,1014.92745706695,1.43507350502646
25207,528755.638,5353694.268,0,0,0,102.755,0,2008,0,51,309,249,0.82246594819953,29.3,17.7417582417582,198,1014.92745706695,1.43507350502646
25207,528755.638,5353694.268,167,62,105,51.724,0,2009,3,95,325,185,0.854298862823754,27.1,18.689010989011,90,1014.92745706695,1.43507350502646
25207,528755.638,5353694.268,152,83,69,51.691,2,2010,3,97,309,241,0.802608542992086,87.4,18.4241758241758,144,1014.92745706695,1.43507350502646
25207,528755.638,5353694.268,0,0,0,67.939,0,2011,0,63,324,162,0.803086909876184,129,17.5824175824176,99,1014.92745706695,1.43507350502646
25207,528755.638,5353694.268,144,82,62,60.476,4,2012,2,89,324,176,0.850505606356943,29,18.7703296703297,87,1014.92745706695,1.43507350502646
25207,528755.638,5353694.268,163,93,70,37.588,0,2013,2,117,320,192,0.80870277920719,-172.4,19.2857142857143,75,1014.92745706695,1.43507350502646
25207,528755.638,5353694.268,0,0,0,68.195,0,2014,0,67,342,250,0.831287353994595,91.5,17.9450549450549,183,1014.92745706695,1.43507350502646
25207,528755.638,5353694.268,149,99,50,61.527,4,2015,1,88,335,177,0.802631632361676,-197.8,21,89,1014.92745706695,1.43507350502646
25207,528755.638,5353694.268,159,93,66,60.54,5,2016,2,95,339,201,0.855379141484698,-13,19.132967032967,106,1014.92745706695,1.43507350502646
25207,528755.638,5353694.268,132,94,38,56.025,6,2017,1,85,315,162,0.800671967982092,-57.8,20.1032967032967,77,1014.92745706695,1.43507350502646
25207,528755.638,5353694.268,86,70,16,132.523,41,2018,1,22,341,170,0.789007780464133,-125.4,20.7956043956044,148,1014.92745706695,1.43507350502646
25207,528755.638,5353694.268,0,0,0,66.108,0,2019,0,81,346,168,0.808261869443211,-108.1,20.8824175824176,87,1014.92745706695,1.43507350502646
25207,528755.638,5353694.268,0,0,0,54.433,0,2020,0,78,322,169,0.772787037012617,-97.4,19.156043956044,91,1014.92745706695,1.43507350502646
25208,528755.638,5353462.611,0,0,0,105.59,0,2001,1,57,326,162,0.829152784960508,4.09999999999999,18.2296703296703,105,956.910711089587,1.38303737116393
25208,528755.638,5353462.611,86,75,11,64.326,8,2002,1,84,325,232,0.896027547714258,18.8,18.3868131868132,148,956.910711089587,1.38303737116393
25208,528755.638,5353462.611,151,94,57,60.106,10,2003,1,84,307,153,0.798087725588041,-204,23.121978021978,69,956.910711089587,1.38303737116393
25208,528755.638,5353462.611,122,96,26,63.593,7,2004,1,86,333,161,0.825387473289819,123.8,17.9692307692308,75,956.910711089587,1.38303737116393
25208,528755.638,5353462.611,148,93,55,71.975,2,2005,2,84,314,153,0.839247960494718,-31.4,18.0615384615385,69,956.910711089587,1.38303737116393
25208,528755.638,5353462.611,166,82,84,51.604,0,2006,3,104,344,241,0.848022824288219,43,19.0516483516484,137,956.910711089587,1.38303737116393
25208,528755.638,5353462.611,0,0,0,102.949,0,2007,0,44,309,233,0.867888408656584,258.5,17.3142857142857,189,956.910711089587,1.38303737116393
25208,528755.638,5353462.611,0,0,0,87.624,0,2008,0,66,311,160,0.819570734650831,29.3,17.7417582417582,94,956.910711089587,1.38303737116393
25208,528755.638,5353462.611,157,67,90,60.578,1,2009,3,88,322,185,0.852922671603788,27.1,18.689010989011,97,956.910711089587,1.38303737116393
25208,528755.638,5353462.611,161,93,68,46.79,2,2010,2,101,306,240,0.817363948675688,87.4,18.4241758241758,139,956.910711089587,1.38303737116393
25208,528755.638,5353462.611,86,69,17,61.03,3,2011,1,70,317,168,0.820298548806614,129,17.5824175824176,98,956.910711089587,1.38303737116393
25208,528755.638,5353462.611,142,93,49,62.22,4,2012,2,87,318,217,0.828685241049454,29,18.7703296703297,130,956.910711089587,1.38303737116393
25208,528755.638,5353462.611,161,81,80,49.748,0,2013,2,106,321,178,0.819954890439344,-172.4,19.2857142857143,72,956.910711089587,1.38303737116393
25208,528755.638,5353462.611,86,81,5,92.597,16,2014,1,45,338,249,0.88923923641198,91.5,17.9450549450549,204,956.910711089587,1.38303737116393
25208,528755.638,5353462.611,148,94,54,66.223,4,2015,1,83,337,146,0.829521579982252,-197.8,21,63,956.910711089587,1.38303737116393
25208,528755.638,5353462.611,149,99,50,69.977,5,2016,1,86,333,169,0.884000188361808,-13,19.132967032967,83,956.910711089587,1.38303737116393
25208,528755.638,5353462.611,118,93,25,79.342,7,2017,2,65,302,233,0.828523507268437,-57.8,20.1032967032967,168,956.910711089587,1.38303737116393
25208,528755.638,5353462.611,0,0,0,128.668,0,2018,0,25,317,153,0.818122838755263,-125.4,20.7956043956044,128,956.910711089587,1.38303737116393
25208,528755.638,5353462.611,137,83,54,57.858,9,2019,2,89,344,160,0.827700829261007,-108.1,20.8824175824176,71,956.910711089587,1.38303737116393
25208,528755.638,5353462.611,0,0,0,51.386,0,2020,0,81,318,161,0.807979898541596,-97.4,19.156043956044,80,956.910711089587,1.38303737116393
25275,528755.638,5337941.635,0,0,0,151.505,0,2001,1,19,339,224,0.84190205884654,-14.2,19.5065934065934,205,863.943956503446,-0.106245557003189
25275,528755.638,5337941.635,93,93,0,81.069,6,2002,2,69,345,241,0.832974325581576,3,19.4725274725275,172,863.943956503446,-0.106245557003189
25275,528755.638,5337941.635,134,94,40,66.093,12,2003,1,75,341,137,0.829945244880447,-209,24.2648351648352,62,863.943956503446,-0.106245557003189
25275,528755.638,5337941.635,0,0,0,81.157,0,2004,0,69,340,241,0.884098706500106,104,19.0769230769231,172,863.943956503446,-0.106245557003189
25275,528755.638,5337941.635,93,93,0,79.405,2,2005,1,77,319,138,0.847470553377227,-49.6,19.2098901098901,61,863.943956503446,-0.106245557003189
25275,528755.638,5337941.635,174,76,98,57.423,3,2006,3,97,344,256,0.826181397044124,25.1,20.1736263736264,159,863.943956503446,-0.106245557003189
25275,528755.638,5337941.635,0,0,0,100.103,0,2007,0,48,334,241,0.86014509478919,229.8,18.3494505494505,193,863.943956503446,-0.106245557003189
25275,528755.638,5337941.635,0,0,0,124.16,0,2008,0,33,313,232,0.859862290367392,8.90000000000001,18.8,199,863.943956503446,-0.106245557003189
25275,528755.638,5337941.635,93,73,20,72.197,6,2009,2,73,317,137,0.84396553259187,9.4,19.7494505494506,64,863.943956503446,-0.106245557003189
25275,528755.638,5337941.635,153,82,71,67.693,1,2010,3,80,316,256,0.836613390815251,64.4,19.4725274725275,176,863.943956503446,-0.106245557003189
25275,528755.638,5337941.635,123,69,54,64.075,8,2011,3,63,324,210,0.836812681964411,103.5,18.7505494505494,147,863.943956503446,-0.106245557003189
25275,528755.638,5337941.635,0,0,0,83.439,0,2012,0,65,316,200,0.85632349632831,3.2,20.1307692307692,135,863.943956503446,-0.106245557003189
25275,528755.638,5337941.635,169,93,76,53.875,0,2013,2,102,322,281,0.811633685652972,-190.8,20.5692307692308,179,863.943956503446,-0.106245557003189
25275,528755.638,5337941.635,86,81,5,99.019,8,2014,1,39,350,249,0.884933971494797,65.4,19.2153846153846,210,863.943956503446,-0.106245557003189
25275,528755.638,5337941.635,123,94,29,89.757,13,2015,1,61,349,136,0.855942969161775,-212.4,22.3164835164835,75,863.943956503446,-0.106245557003189
25275,528755.638,5337941.635,104,94,10,87.007,12,2016,1,70,348,121,0.852890508178425,-31.9,20.4131868131868,51,863.943956503446,-0.106245557003189
25275,528755.638,5337941.635,93,93,0,84.202,6,2017,2,61,324,209,0.84029527229411,-70.8,21.2648351648352,148,863.943956503446,-0.106245557003189
25275,528755.638,5337941.635,0,0,0,113.612,0,2018,0,38,320,233,0.833635141816214,-135.7,21.9263736263736,195,863.943956503446,-0.106245557003189
25275,528755.638,5337941.635,116,93,23,72.044,9,2019,2,77,340,241,0.831074076976203,-112.7,22.0065934065934,164,863.943956503446,-0.106245557003189
25275,528755.638,5337941.635,0,0,0,84.263,0,2020,0,53,317,184,0.798076009951315,-111.3,20.3164835164835,131,863.943956503446,-0.106245557003189
25276,528755.638,5337709.979,94,93,1,96.713,8,2001,3,67,342,241,0.816402786739421,-14.2,19.5065934065934,174,894.375410365375,1.43306077106993
25276,528755.638,5337709.979,93,93,0,62.806,4,2002,1,85,314,146,0.813578136645237,3,19.4725274725275,61,894.375410365375,1.43306077106993
25276,528755.638,5337709.979,138,93,45,55.649,9,2003,1,86,339,138,0.813046860148326,-209,24.2648351648352,52,894.375410365375,1.43306077106993
25276,528755.638,5337709.979,0,0,0,148.005,0,2004,0,10,340,241,0.868727622855015,104,19.0769230769231,231,894.375410365375,1.43306077106993
25276,528755.638,5337709.979,128,93,35,80.498,2,2005,2,76,317,146,0.845955603472376,-49.6,19.2098901098901,70,894.375410365375,1.43306077106993
25276,528755.638,5337709.979,174,70,104,68.618,5,2006,2,89,348,145,0.848924317405946,25.1,20.1736263736264,56,894.375410365375,1.43306077106993
25276,528755.638,5337709.979,0,0,0,94.352,0,2007,0,53,336,130,0.838499106029055,229.8,18.3494505494505,77,894.375410365375,1.43306077106993
25276,528755.638,5337709.979,0,0,0,52.486,0,2008,0,98,318,232,0.878642127977575,8.90000000000001,18.8,134,894.375410365375,1.43306077106993
25276,528755.638,5337709.979,142,95,47,58.541,0,2009,1,85,325,146,0.844682986451082,9.4,19.7494505494506,61,894.375410365375,1.43306077106993
25276,528755.638,5337709.979,126,93,33,46.755,0,2010,2,98,318,242,0.820317653678706,64.4,19.4725274725275,144,894.375410365375,1.43306077106993
25276,528755.638,5337709.979,109,72,37,76.629,17,2011,3,50,323,233,0.839215579228094,103.5,18.7505494505494,183,894.375410365375,1.43306077106993
25276,528755.638,5337709.979,126,93,33,62.172,4,2012,2,87,315,162,0.857462698372607,3.2,20.1307692307692,75,894.375410365375,1.43306077106993
25276,528755.638,5337709.979,161,93,68,48.952,0,2013,1,106,323,170,0.808311759959512,-190.8,20.5692307692308,64,894.375410365375,1.43306077106993
25276,528755.638,5337709.979,86,79,7,96.833,8,2014,1,41,329,250,0.879256248179611,65.4,19.2153846153846,209,894.375410365375,1.43306077106993
25276,528755.638,5337709.979,0,0,0,78.176,0,2015,0,71,347,146,0.827190430033786,-212.4,22.3164835164835,75,894.375410365375,1.43306077106993
25276,528755.638,5337709.979,125,94,31,89.451,14,2016,1,68,346,152,0.823096688825878,-31.9,20.4131868131868,84,894.375410365375,1.43306077106993
25276,528755.638,5337709.979,0,0,0,84.202,0,2017,0,61,341,152,0.828496308213528,-70.8,21.2648351648352,91,894.375410365375,1.43306077106993
25276,528755.638,5337709.979,0,0,0,138.934,0,2018,0,18,325,152,0.841402303865554,-135.7,21.9263736263736,134,894.375410365375,1.43306077106993
25276,528755.638,5337709.979,118,96,22,72.044,9,2019,1,77,338,160,0.813526097256959,-112.7,22.0065934065934,83,894.375410365375,1.43306077106993
25276,528755.638,5337709.979,0,0,0,84.263,0,2020,0,53,314,178,0.811517203873169,-111.3,20.3164835164835,125,894.375410365375,1.43306077106993
25277,528755.638,5337478.323,129,94,35,71.197,7,2001,1,86,324,168,0.825327128360128,-14.2,19.5065934065934,82,935.649575788205,1.22495674613424
25277,528755.638,5337478.323,93,84,9,53.295,1,2002,2,94,299,153,0.796889203923281,3,19.4725274725275,59,935.649575788205,1.22495674613424
25277,528755.638,5337478.323,143,93,50,46.751,6,2003,1,96,324,145,0.818450689972345,-209,24.2648351648352,49,935.649575788205,1.22495674613424
25277,528755.638,5337478.323,0,0,0,130.32,0,2004,0,23,338,240,0.846872090323568,104,19.0769230769231,217,935.649575788205,1.22495674613424
25277,528755.638,5337478.323,131,93,38,76.135,2,2005,2,80,311,153,0.872619838463096,-49.6,19.2098901098901,73,935.649575788205,1.22495674613424
25277,528755.638,5337478.323,175,66,109,64.115,5,2006,2,92,343,152,0.845313407985157,25.1,20.1736263736264,60,935.649575788205,1.22495674613424
25277,528755.638,5337478.323,0,0,0,84.831,0,2007,0,61,310,138,0.838090186245738,229.8,18.3494505494505,77,935.649575788205,1.22495674613424
25277,528755.638,5337478.323,0,0,0,52.486,0,2008,0,98,316,226,0.89767624452418,8.90000000000001,18.8,128,935.649575788205,1.22495674613424
25277,528755.638,5337478.323,143,93,50,48.881,0,2009,1,93,318,154,0.850701440337331,9.4,19.7494505494506,61,935.649575788205,1.22495674613424
25277,528755.638,5337478.323,127,94,33,40.532,0,2010,1,104,316,169,0.822519869975089,64.4,19.4725274725275,65,935.649575788205,1.22495674613424
25277,528755.638,5337478.323,116,71,45,55.069,3,2011,3,73,320,250,0.827219382950223,103.5,18.7505494505494,177,935.649575788205,1.22495674613424
25277,528755.638,5337478.323,129,103,26,59.714,4,2012,1,90,306,161,0.868192752977174,3.2,20.1307692307692,71,935.649575788205,1.22495674613424
25277,528755.638,5337478.323,163,97,66,50.11,0,2013,1,105,320,168,0.830562134494439,-190.8,20.5692307692308,63,935.649575788205,1.22495674613424
25277,528755.638,5337478.323,86,78,8,81.388,7,2014,1,54,332,146,0.829611675986121,65.4,19.2153846153846,92,935.649575788205,1.22495674613424
25277,528755.638,5337478.323,0,0,0,57.061,0,2015,0,93,343,153,0.835675709988857,-212.4,22.3164835164835,60,935.649575788205,1.22495674613424
25277,528755.638,5337478.323,126,94,32,84.68,10,2016,2,72,320,185,0.838855140475319,-31.9,20.4131868131868,113,935.649575788205,1.22495674613424
25277,528755.638,5337478.323,0,0,0,46.438,0,2017,0,95,327,161,0.818228547804703,-70.8,21.2648351648352,66,935.649575788205,1.22495674613424
25277,528755.638,5337478.323,165,133,32,50.86,0,2018,1,95,314,146,0.857136162412551,-135.7,21.9263736263736,51,935.649575788205,1.22495674613424
25277,528755.638,5337478.323,118,85,33,53.217,5,2019,2,95,337,161,0.8291289843593,-112.7,22.0065934065934,66,935.649575788205,1.22495674613424
25277,528755.638,5337478.323,0,0,0,43.058,0,2020,0,89,307,161,0.824440871131674,-111.3,20.3164835164835,72,935.649575788205,1.22495674613424
25278,528755.638,5337246.666,0,0,0,117.838,0,2001,1,48,306,170,0.846895114751198,-14.2,19.5065934065934,122,935.657232229259,1.5152559169888
25278,528755.638,5337246.666,128,69,59,45.428,0,2002,3,103,293,242,0.836682413775975,3,19.4725274725275,139,935.657232229259,1.5152559169888
25278,528755.638,5337246.666,0,0,0,47.692,0,2003,0,95,324,152,0.827897021156282,-209,24.2648351648352,57,935.657232229259,1.5152559169888
25278,528755.638,5337246.666,0,0,0,149.146,0,2004,0,9,339,161,0.859537722734816,104,19.0769230769231,152,935.657232229259,1.5152559169888
25278,528755.638,5337246.666,157,93,64,66.47,2,2005,2,89,313,153,0.857655070415779,-49.6,19.2098901098901,64,935.657232229259,1.5152559169888
25278,528755.638,5337246.666,181,69,112,45.262,0,2006,2,107,342,153,0.864475168547839,25.1,20.1736263736264,46,935.657232229259,1.5152559169888
25278,528755.638,5337246.666,0,0,0,102.681,0,2007,0,46,310,242,0.814920439558078,229.8,18.3494505494505,196,935.657232229259,1.5152559169888
25278,528755.638,5337246.666,0,0,0,70.554,0,2008,0,82,313,232,0.869688081999473,8.90000000000001,18.8,150,935.657232229259,1.5152559169888
25278,528755.638,5337246.666,156,99,57,41.748,0,2009,1,100,307,161,0.873566939961338,9.4,19.7494505494506,61,935.657232229259,1.5152559169888
25278,528755.638,5337246.666,145,98,47,40.532,0,2010,1,104,308,169,0.843654739721562,64.4,19.4725274725275,65,935.657232229259,1.5152559169888
25278,528755.638,5337246.666,115,69,46,53.325,3,2011,2,75,321,145,0.826538276158591,103.5,18.7505494505494,70,935.657232229259,1.5152559169888
25278,528755.638,5337246.666,0,0,0,58.147,0,2012,0,92,316,161,0.862463088254225,3.2,20.1307692307692,69,935.657232229259,1.5152559169888
25278,528755.638,5337246.666,170,93,77,44.677,0,2013,1,110,328,169,0.850087882373097,-190.8,20.5692307692308,59,935.657232229259,1.5152559169888
25278,528755.638,5337246.666,0,0,0,66.241,0,2014,0,68,328,152,0.86748279616631,65.4,19.2153846153846,84,935.657232229259,1.5152559169888
25278,528755.638,5337246.666,0,0,0,54.636,0,2015,0,95,321,161,0.824072685272682,-212.4,22.3164835164835,66,935.657232229259,1.5152559169888
25278,528755.638,5337246.666,163,97,66,72.466,5,2016,1,84,324,176,0.847861221408473,-31.9,20.4131868131868,92,935.657232229259,1.5152559169888
25278,528755.638,5337246.666,130,93,37,51.887,5,2017,1,89,329,168,0.833960005569392,-70.8,21.2648351648352,79,935.657232229259,1.5152559169888
25278,528755.638,5337246.666,163,145,18,47.469,0,2018,1,98,314,144,0.825105879409838,-135.7,21.9263736263736,46,935.657232229259,1.5152559169888
25278,528755.638,5337246.666,140,94,46,54.192,6,2019,2,94,330,241,0.800914788650002,-112.7,22.0065934065934,147,935.657232229259,1.5152559169888
25278,528755.638,5337246.666,0,0,0,44.874,0,2020,0,87,293,170,0.851123925309994,-111.3,20.3164835164835,83,935.657232229259,1.5152559169888
25279,528755.638,5337015.01,0,0,0,38.354,0,2001,1,114,297,177,0.834538106188551,-14.2,19.5065934065934,63,980.116776058167,-0.910675905257993
25279,528755.638,5337015.01,124,64,60,48.781,0,2002,3,99,290,242,0.83494766709941,3,19.4725274725275,143,980.116776058167,-0.910675905257993
25279,528755.638,5337015.01,0,0,0,46.751,0,2003,0,96,312,153,0.827003998989484,-209,24.2648351648352,57,980.116776058167,-0.910675905257993
25279,528755.638,5337015.01,150,118,32,45.76,0,2004,1,103,320,160,0.830526343836815,104,19.0769230769231,57,980.116776058167,-0.910675905257993
25279,528755.638,5337015.01,145,124,21,87.026,6,2005,1,70,313,154,0.849788321277263,-49.6,19.2098901098901,84,980.116776058167,-0.910675905257993
25279,528755.638,5337015.01,181,69,112,45.262,0,2006,2,107,340,153,0.857427724816947,25.1,20.1736263736264,46,980.116776058167,-0.910675905257993
25279,528755.638,5337015.01,0,0,0,111.107,0,2007,0,39,302,144,0.842238496214311,229.8,18.3494505494505,105,980.116776058167,-0.910675905257993
25279,528755.638,5337015.01,0,0,0,36.119,0,2008,0,112,312,232,0.854107497733444,8.90000000000001,18.8,120,980.116776058167,-0.910675905257993
25279,528755.638,5337015.01,152,93,59,42.704,0,2009,1,99,319,168,0.866133179408188,9.4,19.7494505494506,69,980.116776058167,-0.910675905257993
25279,528755.638,5337015.01,145,93,52,35.777,0,2010,2,109,311,233,0.830762262053283,64.4,19.4725274725275,124,980.116776058167,-0.910675905257993
25279,528755.638,5337015.01,115,72,43,43.851,0,2011,2,86,319,146,0.821448910374334,103.5,18.7505494505494,60,980.116776058167,-0.910675905257993
25279,528755.638,5337015.01,98,95,3,55.878,3,2012,1,95,321,161,0.867032041827063,3.2,20.1307692307692,66,980.116776058167,-0.910675905257993
25279,528755.638,5337015.01,166,93,73,55.12,0,2013,1,101,318,161,0.839353379197177,-190.8,20.5692307692308,60,980.116776058167,-0.910675905257993
25279,528755.638,5337015.01,93,93,0,56.334,3,2014,1,79,347,153,0.836934524783832,65.4,19.2153846153846,74,980.116776058167,-0.910675905257993
25279,528755.638,5337015.01,0,0,0,58.262,0,2015,0,92,328,153,0.851103123189786,-212.4,22.3164835164835,61,980.116776058167,-0.910675905257993
25279,528755.638,5337015.01,162,93,69,72.466,5,2016,1,84,333,153,0.884963817816766,-31.9,20.4131868131868,69,980.116776058167,-0.910675905257993
25279,528755.638,5337015.01,133,94,39,46.438,5,2017,1,95,322,162,0.83572666782709,-70.8,21.2648351648352,67,980.116776058167,-0.910675905257993
25279,528755.638,5337015.01,0,0,0,121.896,0,2018,0,31,320,169,0.800658622116107,-135.7,21.9263736263736,138,980.116776058167,-0.910675905257993
25279,528755.638,5337015.01,144,93,51,43.433,2,2019,1,105,331,154,0.81511521835923,-112.7,22.0065934065934,49,980.116776058167,-0.910675905257993
25279,528755.638,5337015.01,93,93,0,40.37,3,2020,1,92,286,161,0.836987881292284,-111.3,20.3164835164835,69,980.116776058167,-0.910675905257993
25280,528755.638,5336783.354,0,0,0,44.059,0,2001,2,109,302,169,0.842388630323632,-14.2,19.5065934065934,60,1052.91758959115,-0.925379575509913
25280,528755.638,5336783.354,86,75,11,37.568,0,2002,1,112,291,240,0.842327723751785,3,19.4725274725275,128,1052.91758959115,-0.925379575509913
25280,528755.638,5336783.354,151,130,21,38.683,1,2003,1,105,312,153,0.833833094606714,-209,24.2648351648352,48,1052.91758959115,-0.925379575509913
25280,528755.638,5336783.354,140,93,47,50.19,0,2004,1,99,310,162,0.846056203347893,104,19.0769230769231,63,1052.91758959115,-0.925379575509913
25280,528755.638,5336783.354,0,0,0,69.684,0,2005,0,86,314,161,0.854282774644503,-49.6,19.2098901098901,75,1052.91758959115,-0.925379575509913
25280,528755.638,5336783.354,179,67,112,47.582,0,2006,2,105,341,162,0.837165532762429,25.1,20.1736263736264,57,1052.91758959115,-0.925379575509913
25280,528755.638,5336783.354,0,0,0,78.031,0,2007,0,66,309,170,0.801903709765426,229.8,18.3494505494505,104,1052.91758959115,-0.925379575509913
25280,528755.638,5336783.354,0,0,0,29.153,0,2008,0,118,303,184,0.821531541134526,8.90000000000001,18.8,66,1052.91758959115,-0.925379575509913
25280,528755.638,5336783.354,155,65,90,36.436,0,2009,2,106,313,162,0.878906921534634,9.4,19.7494505494506,56,1052.91758959115,-0.925379575509913
25280,528755.638,5336783.354,167,134,33,32.305,0,2010,1,113,312,176,0.837435132677096,64.4,19.4725274725275,63,1052.91758959115,-0.925379575509913
25280,528755.638,5336783.354,86,69,17,44.664,0,2011,1,85,338,154,0.827599116855328,103.5,18.7505494505494,69,1052.91758959115,-0.925379575509913
25280,528755.638,5336783.354,109,93,16,48.963,1,2012,1,104,306,161,0.854260531397481,3.2,20.1307692307692,57,1052.91758959115,-0.925379575509913
25280,528755.638,5336783.354,171,104,67,47.834,0,2013,1,107,306,168,0.857767073617059,-190.8,20.5692307692308,61,1052.91758959115,-0.925379575509913
25280,528755.638,5336783.354,76,56,20,62.436,3,2014,1,72,351,146,0.818054387753587,65.4,19.2153846153846,74,1052.91758959115,-0.925379575509913
25280,528755.638,5336783.354,93,93,0,52.267,1,2015,1,97,338,154,0.8474334828226,-212.4,22.3164835164835,57,1052.91758959115,-0.925379575509913
25280,528755.638,5336783.354,180,93,87,57.488,4,2016,1,99,328,169,0.855694040768971,-31.9,20.4131868131868,70,1052.91758959115,-0.925379575509913
25280,528755.638,5336783.354,129,100,29,47.311,5,2017,1,94,317,162,0.83297484668469,-70.8,21.2648351648352,68,1052.91758959115,-0.925379575509913
25280,528755.638,5336783.354,86,79,7,104.998,25,2018,1,46,309,160,0.820250261897383,-135.7,21.9263736263736,114,1052.91758959115,-0.925379575509913
25280,528755.638,5336783.354,143,125,18,42.477,2,2019,1,106,331,161,0.837511075257547,-112.7,22.0065934065934,55,1052.91758959115,-0.925379575509913
25280,528755.638,5336783.354,0,0,0,45.804,0,2020,0,86,302,170,0.836435868926694,-111.3,20.3164835164835,84,1052.91758959115,-0.925379575509913
25281,528755.638,5336551.697,0,0,0,48.797,0,2001,2,105,297,169,0.849786441420481,-14.2,19.5065934065934,64,1095.72765910343,-0.489793452636023
25281,528755.638,5336551.697,86,77,9,37.568,0,2002,1,112,289,240,0.814302272054006,3,19.4725274725275,128,1095.72765910343,-0.489793452636023
25281,528755.638,5336551.697,146,94,52,37.023,1,2003,1,107,291,160,0.810246241060304,-209,24.2648351648352,53,1095.72765910343,-0.489793452636023
25281,528755.638,5336551.697,139,93,46,43.67,0,2004,1,105,306,162,0.826229651354376,104,19.0769230769231,57,1095.72765910343,-0.489793452636023
25281,528755.638,5336551.697,0,0,0,64.341,0,2005,0,91,314,160,0.842481835741345,-49.6,19.2098901098901,69,1095.72765910343,-0.489793452636023
25281,528755.638,5336551.697,180,67,113,39.784,0,2006,2,112,339,169,0.833711437696839,25.1,20.1736263736264,57,1095.72765910343,-0.489793452636023
25281,528755.638,5336551.697,0,0,0,63.741,0,2007,0,79,301,153,0.83626287273005,229.8,18.3494505494505,74,1095.72765910343,-0.489793452636023
25281,528755.638,5336551.697,0,0,0,22.96,0,2008,0,124,309,177,0.846089841585892,8.90000000000001,18.8,53,1095.72765910343,-0.489793452636023
25281,528755.638,5336551.697,155,72,83,36.436,0,2009,2,106,303,169,0.884530688032238,9.4,19.7494505494506,63,1095.72765910343,-0.489793452636023
25281,528755.638,5336551.697,165,94,71,27.636,0,2010,1,119,312,177,0.839680267203069,64.4,19.4725274725275,58,1095.72765910343,-0.489793452636023
25281,528755.638,5336551.697,86,69,17,39.494,0,2011,1,91,331,161,0.831762885154701,103.5,18.7505494505494,70,1095.72765910343,-0.489793452636023
25281,528755.638,5336551.697,109,93,16,46.564,1,2012,1,107,301,161,0.854857026970839,3.2,20.1307692307692,54,1095.72765910343,-0.489793452636023
25281,528755.638,5336551.697,172,96,76,41.66,0,2013,1,113,303,170,0.867330156886278,-190.8,20.5692307692308,57,1095.72765910343,-0.489793452636023
25281,528755.638,5336551.697,83,58,25,50.38,0,2014,1,86,338,161,0.815116631609328,65.4,19.2153846153846,75,1095.72765910343,-0.489793452636023
25281,528755.638,5336551.697,0,0,0,51.131,0,2015,0,98,274,162,0.830040244130923,-212.4,22.3164835164835,64,1095.72765910343,-0.489793452636023
25281,528755.638,5336551.697,181,93,88,55.433,4,2016,1,101,316,177,0.88689376428749,-31.9,20.4131868131868,76,1095.72765910343,-0.489793452636023
25281,528755.638,5336551.697,131,104,27,37.833,5,2017,1,106,312,177,0.824698031137917,-70.8,21.2648351648352,71,1095.72765910343,-0.489793452636023
25281,528755.638,5336551.697,86,77,9,119.499,38,2018,1,33,293,160,0.865553785056307,-135.7,21.9263736263736,127,1095.72765910343,-0.489793452636023
25281,528755.638,5336551.697,137,94,43,38.672,2,2019,1,110,334,168,0.835459954370734,-112.7,22.0065934065934,58,1095.72765910343,-0.489793452636023
25281,528755.638,5336551.697,0,0,0,38.628,0,2020,0,94,292,184,0.839556215399313,-111.3,20.3164835164835,90,1095.72765910343,-0.489793452636023
25282,528755.638,5336320.041,0,0,0,111.514,0,2001,0,54,334,161,0.847182746927227,-14.2,19.5065934065934,107,1043.99553238156,0.570227000587615
25282,528755.638,5336320.041,86,69,17,44.567,0,2002,1,104,328,161,0.813472250535473,3,19.4725274725275,57,1043.99553238156,0.570227000587615
25282,528755.638,5336320.041,144,94,50,47.692,7,2003,1,95,301,153,0.803050268147131,-209,24.2648351648352,58,1043.99553238156,0.570227000587615
25282,528755.638,5336320.041,120,94,26,57.298,0,2004,1,92,325,168,0.843622896966799,104,19.0769230769231,76,1043.99553238156,0.570227000587615
25282,528755.638,5336320.041,152,121,31,66.47,2,2005,1,89,310,154,0.850237480280847,-49.6,19.2098901098901,65,1043.99553238156,0.570227000587615
25282,528755.638,5336320.041,177,67,110,52.496,1,2006,2,101,343,161,0.836320651181067,25.1,20.1736263736264,60,1043.99553238156,0.570227000587615
25282,528755.638,5336320.041,0,0,0,74.433,0,2007,0,69,295,178,0.819755304702931,229.8,18.3494505494505,109,1043.99553238156,0.570227000587615
25282,528755.638,5336320.041,93,93,0,29.153,0,2008,1,118,313,178,0.855457917712056,8.90000000000001,18.8,60,1043.99553238156,0.570227000587615
25282,528755.638,5336320.041,156,70,86,39.011,0,2009,2,103,297,162,0.862863529501044,9.4,19.7494505494506,59,1043.99553238156,0.570227000587615
25282,528755.638,5336320.041,166,93,73,33.149,0,2010,1,112,310,177,0.852496966460994,64.4,19.4725274725275,65,1043.99553238156,0.570227000587615
25282,528755.638,5336320.041,116,67,49,43.012,0,2011,2,87,336,161,0.826536922095508,103.5,18.7505494505494,74,1043.99553238156,0.570227000587615
25282,528755.638,5336320.041,93,93,0,54.33,3,2012,1,97,336,162,0.873076228358388,3.2,20.1307692307692,65,1043.99553238156,0.570227000587615
25282,528755.638,5336320.041,171,97,74,43.661,0,2013,1,111,310,168,0.857050530625359,-190.8,20.5692307692308,57,1043.99553238156,0.570227000587615
25282,528755.638,5336320.041,0,0,0,71.412,0,2014,0,63,340,169,0.830399721890909,65.4,19.2153846153846,106,1043.99553238156,0.570227000587615
25282,528755.638,5336320.041,0,0,0,59.403,0,2015,0,91,338,160,0.82737772998969,-212.4,22.3164835164835,69,1043.99553238156,0.570227000587615
25282,528755.638,5336320.041,160,107,53,65.695,4,2016,1,91,320,176,0.830687025114818,-31.9,20.4131868131868,85,1043.99553238156,0.570227000587615
25282,528755.638,5336320.041,0,0,0,39.276,0,2017,0,104,326,169,0.799422193936273,-70.8,21.2648351648352,65,1043.99553238156,0.570227000587615
25282,528755.638,5336320.041,0,0,0,123.043,0,2018,0,30,314,144,0.885091804903276,-135.7,21.9263736263736,114,1043.99553238156,0.570227000587615
25282,528755.638,5336320.041,124,93,31,49.342,4,2019,1,99,338,160,0.829281582853748,-112.7,22.0065934065934,61,1043.99553238156,0.570227000587615
25282,528755.638,5336320.041,0,0,0,52.721,0,2020,0,79,313,178,0.831826608598854,-111.3,20.3164835164835,99,1043.99553238156,0.570227000587615
25289,528755.638,5334698.446,0,0,0,48.797,0,2001,1,105,298,169,0.866017377237298,-14.2,19.5065934065934,64,1146.17959603201,1.44606532144345
25289,528755.638,5334698.446,86,81,5,37.568,0,2002,1,112,305,210,0.850387776315492,3,19.4725274725275,98,1146.17959603201,1.44606532144345
25289,528755.638,5334698.446,146,97,49,39.544,1,2003,1,104,317,169,0.841965546719886,-209,24.2648351648352,65,1146.17959603201,1.44606532144345
25289,528755.638,5334698.446,149,83,66,38.762,0,2004,3,110,316,225,0.866633628626534,104,19.0769230769231,115,1146.17959603201,1.44606532144345
25289,528755.638,5334698.446,153,102,51,64.341,2,2005,1,91,310,170,0.871211436887093,-49.6,19.2098901098901,79,1146.17959603201,1.44606532144345
25289,528755.638,5334698.446,189,61,128,33.942,0,2006,2,118,344,170,0.854399903311381,25.1,20.1736263736264,52,1146.17959603201,1.44606532144345
25289,528755.638,5334698.446,0,0,0,86.296,0,2007,0,60,305,201,0.86842184994017,229.8,18.3494505494505,141,1146.17959603201,1.44606532144345
25289,528755.638,5334698.446,0,0,0,24.951,0,2008,0,122,304,218,0.883204786376924,8.90000000000001,18.8,96,1146.17959603201,1.44606532144345
25289,528755.638,5334698.446,164,61,103,37.275,0,2009,2,105,316,168,0.912584894982775,9.4,19.7494505494506,63,1146.17959603201,1.44606532144345
25289,528755.638,5334698.446,140,93,47,34.883,0,2010,2,110,320,224,0.866615785628761,64.4,19.4725274725275,114,1146.17959603201,1.44606532144345
25289,528755.638,5334698.446,86,83,3,53.325,3,2011,1,75,338,177,0.850998726729581,103.5,18.7505494505494,102,1146.17959603201,1.44606532144345
25289,528755.638,5334698.446,0,0,0,63.026,0,2012,0,86,307,185,0.864673109439418,3.2,20.1307692307692,99,1146.17959603201,1.44606532144345
25289,528755.638,5334698.446,175,93,82,39.744,0,2013,2,115,311,193,0.847055433056213,-190.8,20.5692307692308,78,1146.17959603201,1.44606532144345
25289,528755.638,5334698.446,97,63,34,50.38,0,2014,3,86,315,224,0.827283322186432,65.4,19.2153846153846,138,1146.17959603201,1.44606532144345
25289,528755.638,5334698.446,0,0,0,53.435,0,2015,0,96,349,161,0.855822227354732,-212.4,22.3164835164835,65,1146.17959603201,1.44606532144345
25289,528755.638,5334698.446,142,93,49,59.597,4,2016,2,97,343,218,0.880038799445644,-31.9,20.4131868131868,121,1146.17959603201,1.44606532144345
25289,528755.638,5334698.446,0,0,0,92.125,0,2017,0,54,314,216,0.86597549239784,-70.8,21.2648351648352,162,1146.17959603201,1.44606532144345
25289,528755.638,5334698.446,86,70,16,46.395,0,2018,1,99,324,233,0.851950048980798,-135.7,21.9263736263736,134,1146.17959603201,1.44606532144345
25289,528755.638,5334698.446,150,93,57,47.365,4,2019,2,101,343,185,0.860936313375155,-112.7,22.0065934065934,84,1146.17959603201,1.44606532144345
25289,528755.638,5334698.446,0,0,0,46.748,0,2020,0,85,290,184,0.850262344030218,-111.3,20.3164835164835,99,1146.17959603201,1.44606532144345
25291,528755.638,5334235.134,0,0,0,149.421,0,2001,2,21,337,177,0.803028884979843,-14.2,19.5065934065934,156,1154.13504024592,-1.10071471203799
25291,528755.638,5334235.134,86,85,1,75.885,6,2002,1,74,296,193,0.824626635434338,3,19.4725274725275,119,1154.13504024592,-1.10071471203799
25291,528755.638,5334235.134,146,98,48,53.082,9,2003,1,89,312,176,0.80566910377417,-209,24.2648351648352,87,1154.13504024592,-1.10071471203799
25291,528755.638,5334235.134,141,58,83,72.008,5,2004,3,78,334,185,0.822085496450421,104,19.0769230769231,107,1154.13504024592,-1.10071471203799
25291,528755.638,5334235.134,142,93,49,72.914,2,2005,2,83,310,234,0.863436086948687,-49.6,19.2098901098901,151,1154.13504024592,-1.10071471203799
25291,528755.638,5334235.134,183,62,121,34.906,0,2006,3,117,348,216,0.844572333955449,25.1,20.1736263736264,99,1154.13504024592,-1.10071471203799
25291,528755.638,5334235.134,0,0,0,117.619,0,2007,0,33,304,210,0.857803893916513,229.8,18.3494505494505,177,1154.13504024592,-1.10071471203799
25291,528755.638,5334235.134,0,0,0,117.252,0,2008,0,39,315,240,0.835712598007819,8.90000000000001,18.8,201,1154.13504024592,-1.10071471203799
25291,528755.638,5334235.134,169,69,100,41.748,0,2009,2,100,310,178,0.858195986569691,9.4,19.7494505494506,78,1154.13504024592,-1.10071471203799
25291,528755.638,5334235.134,158,94,64,47.876,0,2010,1,97,314,177,0.821714410671114,64.4,19.4725274725275,80,1154.13504024592,-1.10071471203799
25291,528755.638,5334235.134,86,69,17,111.077,35,2011,1,17,326,226,0.78576008160518,103.5,18.7505494505494,209,1154.13504024592,-1.10071471203799
25291,528755.638,5334235.134,138,94,44,68.523,4,2012,1,80,313,161,0.824592011716105,3.2,20.1307692307692,81,1154.13504024592,-1.10071471203799
25291,528755.638,5334235.134,175,93,82,40.689,0,2013,2,114,317,224,0.807406211436172,-190.8,20.5692307692308,110,1154.13504024592,-1.10071471203799
25291,528755.638,5334235.134,145,81,64,50.38,0,2014,5,86,317,225,0.808913367711177,65.4,19.2153846153846,139,1154.13504024592,-1.10071471203799
25291,528755.638,5334235.134,149,94,55,62.614,4,2015,2,88,340,225,0.81719651089241,-212.4,22.3164835164835,137,1154.13504024592,-1.10071471203799
25291,528755.638,5334235.134,159,93,66,58.538,4,2016,2,98,344,200,0.841626357458474,-31.9,20.4131868131868,102,1154.13504024592,-1.10071471203799
25291,528755.638,5334235.134,112,96,16,89.995,7,2017,2,56,316,209,0.808131960045054,-70.8,21.2648351648352,153,1154.13504024592,-1.10071471203799
25291,528755.638,5334235.134,86,75,11,131.871,39,2018,1,23,328,201,0.794305703255394,-135.7,21.9263736263736,178,1154.13504024592,-1.10071471203799
25291,528755.638,5334235.134,151,95,56,57.835,6,2019,1,90,334,177,0.799822639503007,-112.7,22.0065934065934,87,1154.13504024592,-1.10071471203799
25291,528755.638,5334235.134,0,0,0,81.917,0,2020,0,55,322,193,0.794829835919157,-111.3,20.3164835164835,138,1154.13504024592,-1.10071471203799
25292,528755.638,5334003.477,0,0,0,146.433,0,2001,1,21,337,178,0.858262441810809,10.6,17.710989010989,157,1099.84886513251,-0.71635601468526
25292,528755.638,5334003.477,95,93,2,79.171,10,2002,1,74,343,178,0.839743485673625,25.6,17.9494505494505,104,1099.84886513251,-0.71635601468526
25292,528755.638,5334003.477,140,93,47,64.72,11,2003,1,82,339,177,0.821995436777535,-201.3,22.6626373626374,95,1099.84886513251,-0.71635601468526
25292,528755.638,5334003.477,135,97,38,58.742,4,2004,1,93,337,185,0.840267275982166,132.4,17.5076923076923,92,1099.84886513251,-0.71635601468526
25292,528755.638,5334003.477,151,118,33,73.431,2,2005,1,84,320,170,0.845364283843261,-23.3,17.6,86,1099.84886513251,-0.71635601468526
25292,528755.638,5334003.477,179,93,86,39.623,2,2006,2,115,347,224,0.843356253682904,50,18.6131868131868,109,1099.84886513251,-0.71635601468526
25292,528755.638,5334003.477,0,0,0,105.637,0,2007,0,43,305,218,0.849070277591756,269.6,16.9021978021978,175,1099.84886513251,-0.71635601468526
25292,528755.638,5334003.477,0,0,0,131.417,0,2008,0,26,311,249,0.824624638577905,38,17.3098901098901,223,1099.84886513251,-0.71635601468526
25292,528755.638,5334003.477,155,66,89,51.112,0,2009,3,97,334,201,0.837281614579924,34.6,18.2571428571429,104,1099.84886513251,-0.71635601468526
25292,528755.638,5334003.477,162,93,69,48.194,2,2010,2,102,316,193,0.824818958321871,95.1,17.9945054945055,91,1099.84886513251,-0.71635601468526
25292,528755.638,5334003.477,86,70,16,115.617,36,2011,1,21,333,177,0.819612312141089,139.3,17.1164835164835,156,1099.84886513251,-0.71635601468526
25292,528755.638,5334003.477,127,94,33,65.041,5,2012,1,86,321,176,0.797932246126754,38.5,18.2296703296703,90,1099.84886513251,-0.71635601468526
25292,528755.638,5334003.477,171,107,64,36.314,1,2013,1,119,311,193,0.745187182942454,-164.8,18.7813186813187,74,1099.84886513251,-0.71635601468526
25292,528755.638,5334003.477,93,75,18,46.979,3,2014,3,93,324,193,0.771455015311262,101.8,17.4461538461538,100,1099.84886513251,-0.71635601468526
25292,528755.638,5334003.477,0,0,0,50.973,0,2015,0,98,336,170,0.732240768163771,-192.4,20.4978021978022,72,1099.84886513251,-0.71635601468526
25292,528755.638,5334003.477,159,109,50,55.133,5,2016,1,101,324,184,0.837876122464153,-4.8,18.6318681318681,83,1099.84886513251,-0.71635601468526
25292,528755.638,5334003.477,121,93,28,39.802,7,2017,2,105,305,184,0.784426153438951,-54.4,19.6516483516484,79,1099.84886513251,-0.71635601468526
25292,528755.638,5334003.477,86,68,18,51.499,0,2018,1,97,307,154,0.824299582080706,-121.8,20.367032967033,57,1099.84886513251,-0.71635601468526
25292,528755.638,5334003.477,136,79,57,35.239,3,2019,2,114,336,169,0.787215927488817,-107,20.478021978022,55,1099.84886513251,-0.71635601468526
25292,528755.638,5334003.477,0,0,0,35.189,0,2020,0,101,313,186,0.76045545080661,-91.9,18.7142857142857,85,1099.84886513251,-0.71635601468526
25293,528755.638,5333771.821,0,0,0,131.142,0,2001,1,35,316,176,0.871037366773164,10.6,17.710989010989,141,1016.37296173195,0.634268057279803
25293,528755.638,5333771.821,99,93,6,45.794,1,2002,1,104,342,176,0.845386659568335,25.6,17.9494505494505,72,1016.37296173195,0.634268057279803
25293,528755.638,5333771.821,140,94,46,51.198,8,2003,1,95,326,153,0.81857180464922,-201.3,22.6626373626374,58,1016.37296173195,0.634268057279803
25293,528755.638,5333771.821,135,96,39,49.727,1,2004,1,101,325,178,0.853407643132856,132.4,17.5076923076923,77,1016.37296173195,0.634268057279803
25293,528755.638,5333771.821,154,93,61,61.868,2,2005,2,94,317,160,0.853922734162927,-23.3,17.6,66,1016.37296173195,0.634268057279803
25293,528755.638,5333771.821,182,93,89,34.941,2,2006,2,119,344,232,0.838146693997164,50,18.6131868131868,113,1016.37296173195,0.634268057279803
25293,528755.638,5333771.821,0,0,0,92.587,0,2007,0,54,303,225,0.821949901436172,269.6,16.9021978021978,171,1016.37296173195,0.634268057279803
25293,528755.638,5333771.821,0,0,0,31.275,0,2008,0,116,309,248,0.826201756187214,38,17.3098901098901,132,1016.37296173195,0.634268057279803
25293,528755.638,5333771.821,158,65,93,41.78,0,2009,2,105,319,169,0.857407060178588,34.6,18.2571428571429,64,1016.37296173195,0.634268057279803
25293,528755.638,5333771.821,160,93,67,37.95,0,2010,1,111,314,170,0.828405071338757,95.1,17.9945054945055,59,1016.37296173195,0.634268057279803
25293,528755.638,5333771.821,86,69,17,62.464,3,2011,1,71,332,161,0.822100320906474,139.3,17.1164835164835,90,1016.37296173195,0.634268057279803
25293,528755.638,5333771.821,127,93,34,53.549,4,2012,1,99,322,169,0.852878859189645,38.5,18.2296703296703,70,1016.37296173195,0.634268057279803
25293,528755.638,5333771.821,172,103,69,37.506,1,2013,1,118,320,178,0.822487318120975,-164.8,18.7813186813187,60,1016.37296173195,0.634268057279803
25293,528755.638,5333771.821,93,78,15,54.838,6,2014,2,84,329,154,0.81149313629146,101.8,17.4461538461538,70,1016.37296173195,0.634268057279803
25293,528755.638,5333771.821,0,0,0,58.119,0,2015,0,92,341,153,0.817931984131981,-192.4,20.4978021978022,61,1016.37296173195,0.634268057279803
25293,528755.638,5333771.821,157,94,63,65.023,5,2016,1,92,330,177,0.854026497717673,-4.8,18.6318681318681,85,1016.37296173195,0.634268057279803
25293,528755.638,5333771.821,121,93,28,41.325,7,2017,1,103,310,170,0.808849304851731,-54.4,19.6516483516484,67,1016.37296173195,0.634268057279803
25293,528755.638,5333771.821,86,68,18,59.76,1,2018,1,90,310,153,0.83471525331767,-121.8,20.367032967033,63,1016.37296173195,0.634268057279803
25293,528755.638,5333771.821,131,79,52,41.579,3,2019,2,107,337,168,0.818558591815603,-107,20.478021978022,61,1016.37296173195,0.634268057279803
25293,528755.638,5333771.821,0,0,0,46.469,0,2020,0,88,308,177,0.828169871851023,-91.9,18.7142857142857,89,1016.37296173195,0.634268057279803
25299,528755.638,5332381.883,0,0,0,134.386,0,2001,1,32,335,168,0.841177778250599,10.6,17.710989010989,136,999.92178865582,-0.826035525468868
25299,528755.638,5332381.883,93,78,15,65.452,7,2002,3,85,344,241,0.807808727794663,25.6,17.9494505494505,156,999.92178865582,-0.826035525468868
25299,528755.638,5332381.883,151,97,54,53.346,10,2003,1,93,329,153,0.794591028226382,-201.3,22.6626373626374,60,999.92178865582,-0.826035525468868
25299,528755.638,5332381.883,141,96,45,56.651,4,2004,1,95,331,162,0.786343300097541,132.4,17.5076923076923,67,999.92178865582,-0.826035525468868
25299,528755.638,5332381.883,0,0,0,80.19,0,2005,0,78,308,153,0.770429371587046,-23.3,17.6,75,999.92178865582,-0.826035525468868
25299,528755.638,5332381.883,170,65,105,44.475,2,2006,3,111,344,241,0.80582774366825,50,18.6131868131868,130,999.92178865582,-0.826035525468868
25299,528755.638,5332381.883,0,0,0,92.587,0,2007,0,54,297,217,0.775218781549361,269.6,16.9021978021978,163,999.92178865582,-0.826035525468868
25299,528755.638,5332381.883,81,53,28,34.834,0,2008,1,113,310,177,0.806273829342576,38,17.3098901098901,64,999.92178865582,-0.826035525468868
25299,528755.638,5332381.883,161,68,93,49.897,0,2009,2,98,312,176,0.837852832371895,34.6,18.2571428571429,78,999.92178865582,-0.826035525468868
25299,528755.638,5332381.883,162,80,82,36.908,0,2010,3,112,311,209,0.798722014066406,95.1,17.9945054945055,97,999.92178865582,-0.826035525468868
25299,528755.638,5332381.883,82,68,14,56.587,3,2011,1,77,333,241,0.763408394853356,139.3,17.1164835164835,164,999.92178865582,-0.826035525468868
25299,528755.638,5332381.883,134,94,40,60.415,5,2012,1,91,311,177,0.850188585689208,38.5,18.2296703296703,86,999.92178865582,-0.826035525468868
25299,528755.638,5332381.883,177,79,98,38.668,1,2013,2,117,300,178,0.826419846894463,-164.8,18.7813186813187,61,999.92178865582,-0.826035525468868
25299,528755.638,5332381.883,93,93,0,64.861,7,2014,2,73,345,186,0.814311852641842,101.8,17.4461538461538,113,999.92178865582,-0.826035525468868
25299,528755.638,5332381.883,148,93,55,60.502,5,2015,1,90,338,152,0.813790164411271,-192.4,20.4978021978022,62,999.92178865582,-0.826035525468868
25299,528755.638,5332381.883,160,100,60,61.721,5,2016,1,95,332,178,0.832969277516001,-4.8,18.6318681318681,83,999.92178865582,-0.826035525468868
25299,528755.638,5332381.883,0,0,0,52.814,0,2017,0,90,313,170,0.796886881001901,-54.4,19.6516483516484,80,999.92178865582,-0.826035525468868
25299,528755.638,5332381.883,86,74,12,115.51,34,2018,1,38,338,162,0.830744156209061,-121.8,20.367032967033,124,999.92178865582,-0.826035525468868
25299,528755.638,5332381.883,132,99,33,54.356,9,2019,1,94,342,169,0.812653219276067,-107,20.478021978022,75,999.92178865582,-0.826035525468868
25299,528755.638,5332381.883,0,0,0,65.841,0,2020,0,70,318,184,0.808073240034213,-91.9,18.7142857142857,114,999.92178865582,-0.826035525468868
25300,528755.638,5332150.226,0,0,0,134.386,0,2001,0,32,346,170,0.844902549548278,10.6,17.710989010989,138,932.752291152306,-1.51848776236874
25300,528755.638,5332150.226,0,0,0,58.523,0,2002,0,91,344,240,0.821459070391626,25.6,17.9494505494505,149,932.752291152306,-1.51848776236874
25300,528755.638,5332150.226,104,93,11,83.998,18,2003,1,65,332,169,0.815109669532931,-201.3,22.6626373626374,104,932.752291152306,-1.51848776236874
25300,528755.638,5332150.226,0,0,0,70.75,0,2004,0,82,336,232,0.828297940961117,132.4,17.5076923076923,150,932.752291152306,-1.51848776236874
25300,528755.638,5332150.226,128,93,35,79.067,2,2005,2,79,315,161,0.825921277963124,-23.3,17.6,82,932.752291152306,-1.51848776236874
25300,528755.638,5332150.226,166,68,98,51.052,2,2006,3,106,343,265,0.829429787712194,50,18.6131868131868,159,932.752291152306,-1.51848776236874
25300,528755.638,5332150.226,0,0,0,105.637,0,2007,0,43,301,233,0.86042117385909,269.6,16.9021978021978,190,932.752291152306,-1.51848776236874
25300,528755.638,5332150.226,86,86,0,48.007,2,2008,1,102,314,185,0.826225843575722,38,17.3098901098901,83,932.752291152306,-1.51848776236874
25300,528755.638,5332150.226,157,68,89,52.341,0,2009,2,96,309,161,0.848174946203092,34.6,18.2571428571429,65,932.752291152306,-1.51848776236874
25300,528755.638,5332150.226,159,94,65,50.656,3,2010,1,100,315,169,0.807550497248302,95.1,17.9945054945055,69,932.752291152306,-1.51848776236874
25300,528755.638,5332150.226,86,74,12,96.627,21,2011,1,38,333,241,0.815028720278904,139.3,17.1164835164835,203,932.752291152306,-1.51848776236874
25300,528755.638,5332150.226,127,94,33,74.082,6,2012,1,77,308,178,0.856849194899945,38.5,18.2296703296703,101,932.752291152306,-1.51848776236874
25300,528755.638,5332150.226,166,63,103,51.461,1,2013,2,106,302,170,0.839211228042396,-164.8,18.7813186813187,64,932.752291152306,-1.51848776236874
25300,528755.638,5332150.226,105,94,11,66.777,7,2014,1,71,346,170,0.815713507229403,101.8,17.4461538461538,99,932.752291152306,-1.51848776236874
25300,528755.638,5332150.226,0,0,0,64.646,0,2015,0,86,339,153,0.827559687904788,-192.4,20.4978021978022,67,932.752291152306,-1.51848776236874
25300,528755.638,5332150.226,0,0,0,86.836,0,2016,0,71,333,162,0.836158293868754,-4.8,18.6318681318681,91,932.752291152306,-1.51848776236874
25300,528755.638,5332150.226,0,0,0,62.456,0,2017,0,81,319,200,0.803998478688044,-54.4,19.6516483516484,119,932.752291152306,-1.51848776236874
25300,528755.638,5332150.226,86,78,8,108.328,27,2018,1,45,337,152,0.787361528692027,-121.8,20.367032967033,107,932.752291152306,-1.51848776236874
25300,528755.638,5332150.226,124,94,30,59.142,9,2019,1,89,332,168,0.811641422373178,-107,20.478021978022,79,932.752291152306,-1.51848776236874
25300,528755.638,5332150.226,0,0,0,73.351,0,2020,0,64,317,178,0.807120463823829,-91.9,18.7142857142857,114,932.752291152306,-1.51848776236874
25324,528755.638,5326590.474,86,83,3,40.414,2,2001,0,112,291,186,0.876660762475612,10.6,17.710989010989,74,1281.74695399717,-0.861504009431412
25324,528755.638,5326590.474,154,71,83,24.68,0,2002,2,126,285,177,0.8335820312628,25.6,17.9494505494505,51,1281.74695399717,-0.861504009431412
25324,528755.638,5326590.474,152,84,68,31.199,0,2003,2,116,308,178,0.828685321279962,-201.3,22.6626373626374,62,1281.74695399717,-0.861504009431412
25324,528755.638,5326590.474,173,72,101,23.759,0,2004,2,127,297,201,0.855199953137204,132.4,17.5076923076923,74,1281.74695399717,-0.861504009431412
25324,528755.638,5326590.474,147,104,43,32.852,0,2005,2,120,307,200,0.859313761853544,-23.3,17.6,80,1281.74695399717,-0.861504009431412
25324,528755.638,5326590.474,188,93,95,49.699,2,2006,2,107,334,185,0.835127228146035,50,18.6131868131868,78,1281.74695399717,-0.861504009431412
25324,528755.638,5326590.474,0,0,0,36.375,0,2007,0,107,295,201,0.869639291085356,269.6,16.9021978021978,94,1281.74695399717,-0.861504009431412
25324,528755.638,5326590.474,86,57,29,17.673,0,2008,1,130,298,193,0.867842128635046,38,17.3098901098901,63,1281.74695399717,-0.861504009431412
25324,528755.638,5326590.474,178,64,114,38.559,0,2009,2,108,293,184,0.920289468024184,34.6,18.2571428571429,76,1281.74695399717,-0.861504009431412
25324,528755.638,5326590.474,171,123,48,24.254,0,2010,1,126,294,201,0.856916252428849,95.1,17.9945054945055,75,1281.74695399717,-0.861504009431412
25324,528755.638,5326590.474,93,65,28,33.707,0,2011,2,101,315,154,0.826243820936315,139.3,17.1164835164835,53,1281.74695399717,-0.861504009431412
25324,528755.638,5326590.474,152,97,55,39.998,0,2012,1,114,312,178,0.892189188709494,38.5,18.2296703296703,64,1281.74695399717,-0.861504009431412
25324,528755.638,5326590.474,171,67,104,41.912,1,2013,2,114,299,178,0.871619545771842,-164.8,18.7813186813187,64,1281.74695399717,-0.861504009431412
25324,528755.638,5326590.474,148,73,75,19.356,0,2014,3,131,340,193,0.871158526237588,101.8,17.4461538461538,62,1281.74695399717,-0.861504009431412
25324,528755.638,5326590.474,156,93,63,39.184,0,2015,1,110,300,170,0.879887332724236,-192.4,20.4978021978022,60,1281.74695399717,-0.861504009431412
25324,528755.638,5326590.474,168,114,54,30.993,0,2016,1,123,332,201,0.862729617518184,-4.8,18.6318681318681,78,1281.74695399717,-0.861504009431412
25324,528755.638,5326590.474,0,0,0,33.624,0,2017,0,113,292,177,0.839654813255342,-54.4,19.6516483516484,64,1281.74695399717,-0.861504009431412
25324,528755.638,5326590.474,171,65,106,30.213,0,2018,2,117,337,177,0.876948720044256,-121.8,20.367032967033,60,1281.74695399717,-0.861504009431412
25324,528755.638,5326590.474,151,93,58,27.154,3,2019,1,123,320,178,0.877015412580306,-107,20.478021978022,55,1281.74695399717,-0.861504009431412
25324,528755.638,5326590.474,0,0,0,28.922,0,2020,0,110,299,224,0.865908291971699,-91.9,18.7142857142857,114,1281.74695399717,-0.861504009431412
25425,528987.294,5353925.924,0,0,0,76.502,0,2001,3,81,332,200,0.810844292942721,4.09999999999999,18.2296703296703,119,1057.67438929234,1.17348844640222
25425,528987.294,5353925.924,107,94,13,76.554,10,2002,2,74,338,249,0.791170108905391,18.8,18.3868131868132,175,1057.67438929234,1.17348844640222
25425,528987.294,5353925.924,147,101,46,54.166,10,2003,1,90,331,153,0.808856104932915,-204,23.121978021978,63,1057.67438929234,1.17348844640222
25425,528987.294,5353925.924,183,94,89,46.42,0,2004,2,102,341,192,0.775509722859956,123.8,17.9692307692308,90,1057.67438929234,1.17348844640222
25425,528987.294,5353925.924,152,93,59,71.975,2,2005,2,84,308,153,0.804234125275735,-31.4,18.0615384615385,69,1057.67438929234,1.17348844640222
25425,528987.294,5353925.924,167,61,106,52.88,0,2006,2,103,347,160,0.794402416290303,43,19.0516483516484,57,1057.67438929234,1.17348844640222
25425,528987.294,5353925.924,0,0,0,115.907,0,2007,0,32,316,177,0.820033207089034,258.5,17.3142857142857,145,1057.67438929234,1.17348844640222
25425,528987.294,5353925.924,0,0,0,113.95,0,2008,0,40,311,225,0.832727306905848,29.3,17.7417582417582,185,1057.67438929234,1.17348844640222
25425,528987.294,5353925.924,171,63,108,39.188,0,2009,2,106,332,176,0.843848571997328,27.1,18.689010989011,70,1057.67438929234,1.17348844640222
25425,528987.294,5353925.924,153,84,69,44.49,0,2010,2,103,309,177,0.799515301299901,87.4,18.4241758241758,74,1057.67438929234,1.17348844640222
25425,528987.294,5353925.924,0,0,0,79.223,0,2011,0,52,329,248,0.761328239006782,129,17.5824175824176,196,1057.67438929234,1.17348844640222
25425,528987.294,5353925.924,141,83,58,65.969,4,2012,3,83,328,185,0.881568646120526,29,18.7703296703297,102,1057.67438929234,1.17348844640222
25425,528987.294,5353925.924,162,93,69,53.653,0,2013,1,103,323,178,0.815434990312076,-172.4,19.2857142857143,75,1057.67438929234,1.17348844640222
25425,528987.294,5353925.924,0,0,0,78.757,0,2014,0,57,326,257,0.859173766801047,91.5,17.9450549450549,200,1057.67438929234,1.17348844640222
25425,528987.294,5353925.924,147,94,53,62.457,4,2015,1,87,335,169,0.807333074366565,-197.8,21,82,1057.67438929234,1.17348844640222
25425,528987.294,5353925.924,159,93,66,61.574,5,2016,1,94,339,169,0.84858312625522,-13,19.132967032967,75,1057.67438929234,1.17348844640222
25425,528987.294,5353925.924,132,93,39,56.025,6,2017,2,85,317,249,0.783664890113494,-57.8,20.1032967032967,164,1057.67438929234,1.17348844640222
25425,528987.294,5353925.924,86,70,16,128.668,40,2018,1,25,344,178,0.767400644094233,-125.4,20.7956043956044,153,1057.67438929234,1.17348844640222
25425,528987.294,5353925.924,0,0,0,63.922,0,2019,0,83,348,161,0.782077012103886,-108.1,20.8824175824176,78,1057.67438929234,1.17348844640222
25425,528987.294,5353925.924,0,0,0,67.535,0,2020,0,67,325,170,0.750757057723847,-97.4,19.156043956044,103,1057.67438929234,1.17348844640222
25426,528987.294,5353694.268,0,0,0,75.086,0,2001,1,82,330,218,0.791978462110083,4.09999999999999,18.2296703296703,136,1005.48533646612,1.34287108054072
25426,528987.294,5353694.268,108,94,14,72.31,10,2002,2,78,338,240,0.81308227544052,18.8,18.3868131868132,162,1005.48533646612,1.34287108054072
25426,528987.294,5353694.268,144,94,50,58.092,10,2003,1,86,306,146,0.803518042932595,-204,23.121978021978,60,1005.48533646612,1.34287108054072
25426,528987.294,5353694.268,182,94,88,52.151,3,2004,2,97,339,216,0.80101808275702,123.8,17.9692307692308,119,1005.48533646612,1.34287108054072
25426,528987.294,5353694.268,151,93,58,76.501,2,2005,4,80,305,209,0.814059078069874,-31.4,18.0615384615385,129,1005.48533646612,1.34287108054072
25426,528987.294,5353694.268,171,60,111,49.064,0,2006,3,106,346,265,0.801507880400627,43,19.0516483516484,159,1005.48533646612,1.34287108054072
25426,528987.294,5353694.268,0,0,0,111.678,0,2007,0,36,313,162,0.825856388121203,258.5,17.3142857142857,126,1005.48533646612,1.34287108054072
25426,528987.294,5353694.268,0,0,0,106.648,0,2008,0,47,313,248,0.829807529243857,29.3,17.7417582417582,201,1005.48533646612,1.34287108054072
25426,528987.294,5353694.268,165,64,101,63.153,1,2009,3,86,329,185,0.851498360158,27.1,18.689010989011,99,1005.48533646612,1.34287108054072
25426,528987.294,5353694.268,152,82,70,54.324,2,2010,2,95,310,162,0.81029631228003,87.4,18.4241758241758,67,1005.48533646612,1.34287108054072
25426,528987.294,5353694.268,93,93,0,68.957,9,2011,2,62,326,225,0.811333822760168,129,17.5824175824176,163,1005.48533646612,1.34287108054072
25426,528987.294,5353694.268,141,82,59,65.969,4,2012,3,83,326,185,0.88446373392677,29,18.7703296703297,102,1005.48533646612,1.34287108054072
25426,528987.294,5353694.268,163,95,68,49.748,0,2013,1,106,321,176,0.796277616748111,-172.4,19.2857142857143,70,1005.48533646612,1.34287108054072
25426,528987.294,5353694.268,0,0,0,70.205,0,2014,0,65,325,257,0.859449329623986,91.5,17.9450549450549,192,1005.48533646612,1.34287108054072
25426,528987.294,5353694.268,149,99,50,62.457,4,2015,1,87,334,145,0.786407368642634,-197.8,21,58,1005.48533646612,1.34287108054072
25426,528987.294,5353694.268,162,93,69,58.439,5,2016,1,97,333,160,0.840382218314769,-13,19.132967032967,63,1005.48533646612,1.34287108054072
25426,528987.294,5353694.268,130,94,36,54.984,6,2017,2,86,310,217,0.788031692010061,-57.8,20.1032967032967,131,1005.48533646612,1.34287108054072
25426,528987.294,5353694.268,154,67,87,55.675,1,2018,2,92,342,153,0.77508712610234,-125.4,20.7956043956044,61,1005.48533646612,1.34287108054072
25426,528987.294,5353694.268,0,0,0,62.862,0,2019,0,84,347,160,0.787090908916717,-108.1,20.8824175824176,76,1005.48533646612,1.34287108054072
25426,528987.294,5353694.268,0,0,0,54.433,0,2020,0,78,320,160,0.746506075926507,-97.4,19.156043956044,82,1005.48533646612,1.34287108054072
25427,528987.294,5353462.611,0,0,0,112.993,0,2001,1,50,330,201,0.812738233561221,4.09999999999999,18.2296703296703,151,948.25057776649,-0.891646624277517
25427,528987.294,5353462.611,86,76,10,69.61,10,2002,1,80,328,233,0.885160051739189,18.8,18.3868131868132,153,948.25057776649,-0.891646624277517
25427,528987.294,5353462.611,155,107,48,54.166,10,2003,1,90,306,145,0.785409742304497,-204,23.121978021978,55,948.25057776649,-0.891646624277517
25427,528987.294,5353462.611,125,99,26,65.775,9,2004,1,84,332,161,0.802526165734117,123.8,17.9692307692308,77,948.25057776649,-0.891646624277517
25427,528987.294,5353462.611,148,93,55,74.252,2,2005,4,82,315,217,0.83894684553802,-31.4,18.0615384615385,135,948.25057776649,-0.891646624277517
25427,528987.294,5353462.611,171,82,89,47.771,0,2006,3,107,344,249,0.839286799463673,43,19.0516483516484,142,948.25057776649,-0.891646624277517
25427,528987.294,5353462.611,0,0,0,105.302,0,2007,0,42,310,248,0.825931286203526,258.5,17.3142857142857,206,948.25057776649,-0.891646624277517
25427,528987.294,5353462.611,0,0,0,86.526,0,2008,0,67,314,242,0.839343526224218,29.3,17.7417582417582,175,948.25057776649,-0.891646624277517
25427,528987.294,5353462.611,159,70,89,48.075,0,2009,3,98,327,193,0.84675030140266,27.1,18.689010989011,95,948.25057776649,-0.891646624277517
25427,528987.294,5353462.611,161,93,68,49.185,2,2010,2,99,307,241,0.802206771847695,87.4,18.4241758241758,142,948.25057776649,-0.891646624277517
25427,528987.294,5353462.611,86,69,17,59.124,3,2011,1,72,317,216,0.819901137067732,129,17.5824175824176,144,948.25057776649,-0.891646624277517
25427,528987.294,5353462.611,138,93,45,65.969,4,2012,1,83,319,177,0.849685059726715,29,18.7703296703297,94,948.25057776649,-0.891646624277517
25427,528987.294,5353462.611,161,81,80,48.502,0,2013,2,107,323,168,0.812897771223836,-172.4,19.2857142857143,61,948.25057776649,-0.891646624277517
25427,528987.294,5353462.611,86,80,6,96.994,19,2014,1,41,339,242,0.898615177338207,91.5,17.9450549450549,201,948.25057776649,-0.891646624277517
25427,528987.294,5353462.611,148,94,54,65.273,4,2015,2,84,338,210,0.791778972129465,-197.8,21,126,948.25057776649,-0.891646624277517
25427,528987.294,5353462.611,147,97,50,73.902,7,2016,1,82,333,168,0.857792045815415,-13,19.132967032967,86,948.25057776649,-0.891646624277517
25427,528987.294,5353462.611,119,93,26,67.15,6,2017,2,75,304,225,0.823088342123697,-57.8,20.1032967032967,150,948.25057776649,-0.891646624277517
25427,528987.294,5353462.611,150,132,18,57.999,1,2018,1,90,317,137,0.795540025201869,-125.4,20.7956043956044,47,948.25057776649,-0.891646624277517
25427,528987.294,5353462.611,134,83,51,65.003,10,2019,2,82,343,152,0.787459234806972,-108.1,20.8824175824176,70,948.25057776649,-0.891646624277517
25427,528987.294,5353462.611,0,0,0,54.433,0,2020,0,78,321,153,0.771940279589102,-97.4,19.156043956044,75,948.25057776649,-0.891646624277517
25428,528987.294,5353230.955,0,0,0,95.888,0,2001,1,66,328,162,0.855152402354719,4.09999999999999,18.2296703296703,96,895.790572114164,-1.26812727772533
25428,528987.294,5353230.955,86,76,10,65.588,9,2002,1,83,322,232,0.867971609492094,18.8,18.3868131868132,149,895.790572114164,-1.26812727772533
25428,528987.294,5353230.955,151,95,56,58.092,10,2003,2,86,329,202,0.827319930142537,-204,23.121978021978,116,895.790572114164,-1.26812727772533
25428,528987.294,5353230.955,113,94,19,60.42,4,2004,1,89,334,168,0.86549188457452,123.8,17.9692307692308,79,895.790572114164,-1.26812727772533
25428,528987.294,5353230.955,147,93,54,70.827,2,2005,3,85,318,209,0.870099037015243,-31.4,18.0615384615385,124,895.790572114164,-1.26812727772533
25428,528987.294,5353230.955,170,85,85,47.771,0,2006,3,107,341,234,0.862007522334351,43,19.0516483516484,127,895.790572114164,-1.26812727772533
25428,528987.294,5353230.955,0,0,0,113.776,0,2007,0,34,323,233,0.876635460742592,258.5,17.3142857142857,199,895.790572114164,-1.26812727772533
25428,528987.294,5353230.955,0,0,0,96.115,0,2008,0,58,311,225,0.872426011719006,29.3,17.7417582417582,167,895.790572114164,-1.26812727772533
25428,528987.294,5353230.955,163,70,93,49.275,0,2009,3,97,326,217,0.872517054985356,27.1,18.689010989011,120,895.790572114164,-1.26812727772533
25428,528987.294,5353230.955,160,93,67,46.79,2,2010,2,101,299,202,0.836301591470634,87.4,18.4241758241758,101,895.790572114164,-1.26812727772533
25428,528987.294,5353230.955,93,69,24,56.262,3,2011,3,75,317,226,0.835864590164175,129,17.5824175824176,151,895.790572114164,-1.26812727772533
25428,528987.294,5353230.955,129,93,36,69.942,5,2012,2,79,318,218,0.85142221054281,29,18.7703296703297,139,895.790572114164,-1.26812727772533
25428,528987.294,5353230.955,161,81,80,49.748,0,2013,3,106,320,234,0.853391419089517,-172.4,19.2857142857143,128,895.790572114164,-1.26812727772533
25428,528987.294,5353230.955,86,81,5,74.41,11,2014,1,61,337,138,0.807707698237797,91.5,17.9450549450549,77,895.790572114164,-1.26812727772533
25428,528987.294,5353230.955,147,94,53,64.333,4,2015,2,85,339,217,0.846849844355446,-197.8,21,132,895.790572114164,-1.26812727772533
25428,528987.294,5353230.955,147,96,51,71.945,6,2016,1,84,337,168,0.879434729322347,-13,19.132967032967,84,895.790572114164,-1.26812727772533
25428,528987.294,5353230.955,119,93,26,71.76,6,2017,2,71,302,217,0.872376850692413,-57.8,20.1032967032967,146,895.790572114164,-1.26812727772533
25428,528987.294,5353230.955,0,0,0,128.668,0,2018,0,25,319,144,0.830737187989584,-125.4,20.7956043956044,119,895.790572114164,-1.26812727772533
25428,528987.294,5353230.955,134,83,51,69.632,13,2019,3,78,344,216,0.847894701661822,-108.1,20.8824175824176,138,895.790572114164,-1.26812727772533
25428,528987.294,5353230.955,0,0,0,58.861,0,2020,0,74,316,224,0.841452367935741,-97.4,19.156043956044,150,895.790572114164,-1.26812727772533
25494,528987.294,5337941.635,0,0,0,147.352,0,2001,1,23,339,248,0.832530176572305,-14.2,19.5065934065934,225,821.516968196014,-1.40847009427163
25494,528987.294,5337941.635,93,93,0,78.946,6,2002,2,71,345,249,0.836919970073152,3,19.4725274725275,178,821.516968196014,-1.40847009427163
25494,528987.294,5337941.635,140,94,46,60.169,10,2003,1,81,338,137,0.82810882855808,-209,24.2648351648352,56,821.516968196014,-1.40847009427163
25494,528987.294,5337941.635,0,0,0,76.142,0,2004,0,74,338,240,0.855463551082219,104,19.0769230769231,166,821.516968196014,-1.40847009427163
25494,528987.294,5337941.635,134,93,41,73.991,2,2005,2,82,318,137,0.850201574659249,-49.6,19.2098901098901,55,821.516968196014,-1.40847009427163
25494,528987.294,5337941.635,188,75,113,10.599,0,2006,3,143,339,249,0.84383077230695,25.1,20.1736263736264,106,821.516968196014,-1.40847009427163
25494,528987.294,5337941.635,0,0,0,109.992,0,2007,0,40,333,241,0.8661932377176,229.8,18.3494505494505,201,821.516968196014,-1.40847009427163
25494,528987.294,5337941.635,0,0,0,105.615,0,2008,0,50,313,233,0.858232025478402,8.90000000000001,18.8,183,821.516968196014,-1.40847009427163
25494,528987.294,5337941.635,93,74,19,68.479,6,2009,3,76,323,184,0.8457560298159,9.4,19.7494505494506,108,821.516968196014,-1.40847009427163
25494,528987.294,5337941.635,153,83,70,65.338,1,2010,2,82,317,161,0.831508457967104,64.4,19.4725274725275,79,821.516968196014,-1.40847009427163
25494,528987.294,5337941.635,120,69,51,67.96,11,2011,3,59,331,225,0.835718183158911,103.5,18.7505494505494,166,821.516968196014,-1.40847009427163
25494,528987.294,5337941.635,0,0,0,87.569,0,2012,0,61,312,145,0.850917572567388,3.2,20.1307692307692,84,821.516968196014,-1.40847009427163
25494,528987.294,5337941.635,172,72,100,52.58,0,2013,2,103,319,160,0.784242425056791,-190.8,20.5692307692308,57,821.516968196014,-1.40847009427163
25494,528987.294,5337941.635,86,79,7,100.083,8,2014,1,38,349,233,0.879234376068725,65.4,19.2153846153846,195,821.516968196014,-1.40847009427163
25494,528987.294,5337941.635,123,94,29,85.969,11,2015,1,64,347,137,0.8466688278984,-212.4,22.3164835164835,73,821.516968196014,-1.40847009427163
25494,528987.294,5337941.635,104,94,10,85.829,11,2016,1,71,346,122,0.847416461921961,-31.9,20.4131868131868,51,821.516968196014,-1.40847009427163
25494,528987.294,5337941.635,94,94,0,76.462,6,2017,2,67,324,209,0.836773347925464,-70.8,21.2648351648352,142,821.516968196014,-1.40847009427163
25494,528987.294,5337941.635,0,0,0,111.392,0,2018,0,40,321,128,0.83353547140849,-135.7,21.9263736263736,88,821.516968196014,-1.40847009427163
25494,528987.294,5337941.635,113,93,20,76.11,9,2019,2,74,340,233,0.823728646415726,-112.7,22.0065934065934,159,821.516968196014,-1.40847009427163
25494,528987.294,5337941.635,0,0,0,69.854,0,2020,0,65,316,184,0.807211710118637,-111.3,20.3164835164835,119,821.516968196014,-1.40847009427163
25495,528987.294,5337709.979,126,94,32,81.949,8,2001,1,78,328,137,0.788812475269167,-14.2,19.5065934065934,59,860.738174789286,1.41609483671356
25495,528987.294,5337709.979,93,93,0,66.538,6,2002,2,82,333,241,0.831806524719529,3,19.4725274725275,159,860.738174789286,1.41609483671356
25495,528987.294,5337709.979,138,93,45,55.649,9,2003,1,86,334,138,0.800325061812722,-209,24.2648351648352,52,860.738174789286,1.41609483671356
25495,528987.294,5337709.979,0,0,0,90.016,0,2004,0,60,338,233,0.834304272696116,104,19.0769230769231,173,860.738174789286,1.41609483671356
25495,528987.294,5337709.979,128,93,35,82.683,2,2005,2,74,316,138,0.834761515940424,-49.6,19.2098901098901,64,860.738174789286,1.41609483671356
25495,528987.294,5337709.979,181,69,112,28.392,0,2006,3,124,342,250,0.825278827841858,25.1,20.1736263736264,126,860.738174789286,1.41609483671356
25495,528987.294,5337709.979,0,0,0,94.352,0,2007,0,53,334,193,0.835164042777951,229.8,18.3494505494505,140,860.738174789286,1.41609483671356
25495,528987.294,5337709.979,0,0,0,59.138,0,2008,0,92,316,248,0.837518728034487,8.90000000000001,18.8,156,860.738174789286,1.41609483671356
25495,528987.294,5337709.979,142,94,48,58.541,0,2009,1,85,328,168,0.842260518844001,9.4,19.7494505494506,83,860.738174789286,1.41609483671356
25495,528987.294,5337709.979,124,94,30,52.616,0,2010,2,93,316,242,0.806733101740528,64.4,19.4725274725275,149,860.738174789286,1.41609483671356
25495,528987.294,5337709.979,114,72,42,63.131,7,2011,3,64,322,249,0.8233813269388,103.5,18.7505494505494,185,860.738174789286,1.41609483671356
25495,528987.294,5337709.979,126,93,33,66.624,4,2012,2,82,316,160,0.843896293405179,3.2,20.1307692307692,78,860.738174789286,1.41609483671356
25495,528987.294,5337709.979,160,93,67,55.12,0,2013,2,101,321,274,0.771384167500481,-190.8,20.5692307692308,173,860.738174789286,1.41609483671356
25495,528987.294,5337709.979,86,79,7,94.583,7,2014,1,43,324,265,0.81700024145169,65.4,19.2153846153846,222,860.738174789286,1.41609483671356
25495,528987.294,5337709.979,0,0,0,69.551,0,2015,0,80,348,137,0.827886352837592,-212.4,22.3164835164835,57,860.738174789286,1.41609483671356
25495,528987.294,5337709.979,125,94,31,92.008,16,2016,1,66,341,137,0.81960116822173,-31.9,20.4131868131868,71,860.738174789286,1.41609483671356
25495,528987.294,5337709.979,0,0,0,65.718,0,2017,0,76,332,153,0.807735028371463,-70.8,21.2648351648352,77,860.738174789286,1.41609483671356
25495,528987.294,5337709.979,164,135,29,54.126,0,2018,1,92,321,137,0.83629063204221,-135.7,21.9263736263736,45,860.738174789286,1.41609483671356
25495,528987.294,5337709.979,120,100,20,63.826,6,2019,1,84,342,153,0.807616096158488,-112.7,22.0065934065934,69,860.738174789286,1.41609483671356
25495,528987.294,5337709.979,0,0,0,53.777,0,2020,0,78,314,177,0.794913079634278,-111.3,20.3164835164835,99,860.738174789286,1.41609483671356
25496,528987.294,5337478.323,0,0,0,103.887,0,2001,0,61,318,162,0.81387424946201,-14.2,19.5065934065934,101,926.414899778737,1.52398410839105
25496,528987.294,5337478.323,93,83,10,59.408,1,2002,2,88,296,154,0.766961570340188,3,19.4725274725275,66,926.414899778737,1.52398410839105
25496,528987.294,5337478.323,144,93,51,43.097,3,2003,1,100,332,146,0.804981349977405,-209,24.2648351648352,46,926.414899778737,1.52398410839105
25496,528987.294,5337478.323,0,0,0,52.452,0,2004,0,97,341,225,0.788358642943001,104,19.0769230769231,128,926.414899778737,1.52398410839105
25496,528987.294,5337478.323,131,93,38,78.309,2,2005,2,78,317,152,0.833451532677086,-49.6,19.2098901098901,74,926.414899778737,1.52398410839105
25496,528987.294,5337478.323,181,70,111,48.767,0,2006,3,104,344,274,0.820555658394886,25.1,20.1736263736264,170,926.414899778737,1.52398410839105
25496,528987.294,5337478.323,0,0,0,84.831,0,2007,0,61,312,137,0.815796208825678,229.8,18.3494505494505,76,926.414899778737,1.52398410839105
25496,528987.294,5337478.323,0,0,0,55.713,0,2008,0,95,318,249,0.842248960313287,8.90000000000001,18.8,154,926.414899778737,1.52398410839105
25496,528987.294,5337478.323,144,101,43,49.992,0,2009,1,92,322,162,0.849402791463804,9.4,19.7494505494506,70,926.414899778737,1.52398410839105
25496,528987.294,5337478.323,129,103,26,39.552,0,2010,2,105,317,240,0.806447842587938,64.4,19.4725274725275,135,926.414899778737,1.52398410839105
25496,528987.294,5337478.323,115,72,43,62.197,6,2011,3,65,324,241,0.811160312646952,103.5,18.7505494505494,176,926.414899778737,1.52398410839105
25496,528987.294,5337478.323,0,0,0,63.026,0,2012,0,86,308,160,0.858861304236857,3.2,20.1307692307692,74,926.414899778737,1.52398410839105
25496,528987.294,5337478.323,163,103,60,48.952,0,2013,1,106,318,168,0.825647510447038,-190.8,20.5692307692308,62,926.414899778737,1.52398410839105
25496,528987.294,5337478.323,83,76,7,92.257,7,2014,1,45,322,248,0.809980484832754,65.4,19.2153846153846,203,926.414899778737,1.52398410839105
25496,528987.294,5337478.323,93,93,0,57.061,4,2015,1,93,350,154,0.802164075447808,-212.4,22.3164835164835,61,926.414899778737,1.52398410839105
25496,528987.294,5337478.323,126,94,32,89.451,14,2016,1,68,327,169,0.842521757299665,-31.9,20.4131868131868,101,926.414899778737,1.52398410839105
25496,528987.294,5337478.323,93,93,0,50.938,5,2017,1,90,330,161,0.808142118456685,-70.8,21.2648351648352,71,926.414899778737,1.52398410839105
25496,528987.294,5337478.323,0,0,0,133.303,0,2018,0,22,317,145,0.839463404202966,-135.7,21.9263736263736,123,926.414899778737,1.52398410839105
25496,528987.294,5337478.323,120,85,35,55.996,6,2019,2,92,338,160,0.823091427676392,-112.7,22.0065934065934,68,926.414899778737,1.52398410839105
25496,528987.294,5337478.323,0,0,0,48.685,0,2020,0,83,307,169,0.809332527692162,-111.3,20.3164835164835,86,926.414899778737,1.52398410839105
25497,528987.294,5337246.666,0,0,0,130.85,0,2001,1,37,309,168,0.829946243609083,-14.2,19.5065934065934,131,973.200667961555,-1.25007475165113
25497,528987.294,5337246.666,128,69,59,52.355,1,2002,3,95,306,241,0.828982137736407,3,19.4725274725275,146,973.200667961555,-1.25007475165113
25497,528987.294,5337246.666,0,0,0,42.204,0,2003,0,101,337,153,0.816090513245612,-209,24.2648351648352,52,973.200667961555,-1.25007475165113
25497,528987.294,5337246.666,142,131,11,64.548,4,2004,1,85,341,161,0.810506810811676,104,19.0769230769231,76,973.200667961555,-1.25007475165113
25497,528987.294,5337246.666,152,93,59,76.135,2,2005,2,80,312,154,0.84487918073791,-49.6,19.2098901098901,74,973.200667961555,-1.25007475165113
25497,528987.294,5337246.666,175,66,109,67.08,5,2006,3,90,343,257,0.819131485656377,25.1,20.1736263736264,167,973.200667961555,-1.25007475165113
25497,528987.294,5337246.666,0,0,0,94.352,0,2007,0,53,318,154,0.818739626492997,229.8,18.3494505494505,101,973.200667961555,-1.25007475165113
25497,528987.294,5337246.666,0,0,0,68.329,0,2008,0,84,316,177,0.838931838613347,8.90000000000001,18.8,93,973.200667961555,-1.25007475165113
25497,528987.294,5337246.666,152,93,59,43.681,0,2009,1,98,312,161,0.86653377136322,9.4,19.7494505494506,63,973.200667961555,-1.25007475165113
25497,528987.294,5337246.666,146,101,45,39.552,0,2010,2,105,312,248,0.818651707575164,64.4,19.4725274725275,143,973.200667961555,-1.25007475165113
25497,528987.294,5337246.666,114,70,44,59.451,3,2011,3,68,322,257,0.818780836944886,103.5,18.7505494505494,189,973.200667961555,-1.25007475165113
25497,528987.294,5337246.666,0,0,0,64.79,0,2012,0,84,305,161,0.865977698856969,3.2,20.1307692307692,77,973.200667961555,-1.25007475165113
25497,528987.294,5337246.666,167,96,71,50.11,0,2013,1,105,328,162,0.828636772429903,-190.8,20.5692307692308,57,973.200667961555,-1.25007475165113
25497,528987.294,5337246.666,0,0,0,69.288,0,2014,0,65,333,145,0.866226268092528,65.4,19.2153846153846,80,973.200667961555,-1.25007475165113
25497,528987.294,5337246.666,0,0,0,54.636,0,2015,0,95,330,145,0.800560744003263,-212.4,22.3164835164835,50,973.200667961555,-1.25007475165113
25497,528987.294,5337246.666,166,93,73,71.538,4,2016,1,85,327,169,0.872628119596723,-31.9,20.4131868131868,84,973.200667961555,-1.25007475165113
25497,528987.294,5337246.666,129,94,35,61.347,5,2017,1,80,330,169,0.814038644976639,-70.8,21.2648351648352,89,973.200667961555,-1.25007475165113
25497,528987.294,5337246.666,162,146,16,48.573,0,2018,1,97,316,145,0.832106117002341,-135.7,21.9263736263736,48,973.200667961555,-1.25007475165113
25497,528987.294,5337246.666,140,93,47,55.996,6,2019,1,92,336,153,0.790672223666121,-112.7,22.0065934065934,61,973.200667961555,-1.25007475165113
25497,528987.294,5337246.666,0,0,0,112.155,0,2020,0,31,305,170,0.821024252303043,-111.3,20.3164835164835,139,973.200667961555,-1.25007475165113
25498,528987.294,5337015.01,0,0,0,120.01,0,2001,1,46,303,168,0.842472368065104,-14.2,19.5065934065934,122,1019.93212790065,1.51029891631228
25498,528987.294,5337015.01,124,65,59,49.65,0,2002,3,98,287,242,0.813389489363243,3,19.4725274725275,144,1019.93212790065,1.51029891631228
25498,528987.294,5337015.01,0,0,0,45.822,0,2003,0,97,332,160,0.825564185411053,-209,24.2648351648352,63,1019.93212790065,1.51029891631228
25498,528987.294,5337015.01,143,133,10,54.446,0,2004,1,95,333,169,0.84736647624193,104,19.0769230769231,74,1019.93212790065,1.51029891631228
25498,528987.294,5337015.01,152,93,59,72.914,2,2005,2,83,309,154,0.844930953077085,-49.6,19.2098901098901,71,1019.93212790065,1.51029891631228
25498,528987.294,5337015.01,177,66,111,56.165,2,2006,3,98,342,226,0.836413626868162,25.1,20.1736263736264,128,1019.93212790065,1.51029891631228
25498,528987.294,5337015.01,0,0,0,122.128,0,2007,0,29,313,145,0.83117345101633,229.8,18.3494505494505,116,1019.93212790065,1.51029891631228
25498,528987.294,5337015.01,0,0,0,67.241,0,2008,0,85,314,185,0.828655475640568,8.90000000000001,18.8,100,1019.93212790065,1.51029891631228
25498,528987.294,5337015.01,152,93,59,39.905,0,2009,1,102,337,168,0.864682796526848,9.4,19.7494505494506,66,1019.93212790065,1.51029891631228
25498,528987.294,5337015.01,145,93,52,39.552,0,2010,1,105,310,169,0.827950165024873,64.4,19.4725274725275,64,1019.93212790065,1.51029891631228
25498,528987.294,5337015.01,114,70,44,56.801,3,2011,3,71,322,248,0.792396040700808,103.5,18.7505494505494,177,1019.93212790065,1.51029891631228
25498,528987.294,5337015.01,100,96,4,58.925,4,2012,1,91,310,161,0.862499637618748,3.2,20.1307692307692,70,1019.93212790065,1.51029891631228
25498,528987.294,5337015.01,171,93,78,47.834,0,2013,1,107,322,161,0.844324120709753,-190.8,20.5692307692308,54,1019.93212790065,1.51029891631228
25498,528987.294,5337015.01,0,0,0,65.263,0,2014,0,69,342,160,0.816969100724181,65.4,19.2153846153846,91,1019.93212790065,1.51029891631228
25498,528987.294,5337015.01,0,0,0,43.985,0,2015,0,105,316,153,0.843811042829883,-212.4,22.3164835164835,48,1019.93212790065,1.51029891631228
25498,528987.294,5337015.01,169,101,68,52.443,4,2016,1,104,338,177,0.861148422671893,-31.9,20.4131868131868,73,1019.93212790065,1.51029891631228
25498,528987.294,5337015.01,129,93,36,59.13,5,2017,1,82,323,161,0.812685013045079,-70.8,21.2648351648352,79,1019.93212790065,1.51029891631228
25498,528987.294,5337015.01,161,147,14,49.707,0,2018,1,96,315,137,0.796652251138165,-135.7,21.9263736263736,41,1019.93212790065,1.51029891631228
25498,528987.294,5337015.01,142,94,48,46.363,4,2019,1,102,337,154,0.78997717893871,-112.7,22.0065934065934,52,1019.93212790065,1.51029891631228
25498,528987.294,5337015.01,93,93,0,42.161,5,2020,1,90,303,162,0.816729931878504,-111.3,20.3164835164835,72,1019.93212790065,1.51029891631228
25499,528987.294,5336783.354,0,0,0,133.401,0,2001,2,35,301,170,0.851816901932937,-14.2,19.5065934065934,135,1074.96672745206,-1.10474053450085
25499,528987.294,5336783.354,86,75,11,36.712,0,2002,1,113,292,234,0.830068272466957,3,19.4725274725275,121,1074.96672745206,-1.10474053450085
25499,528987.294,5336783.354,147,97,50,38.683,1,2003,1,105,327,154,0.810799176213311,-209,24.2648351648352,49,1074.96672745206,-1.10474053450085
25499,528987.294,5336783.354,140,93,47,47.934,0,2004,1,101,310,168,0.84039657713759,104,19.0769230769231,67,1074.96672745206,-1.10474053450085
25499,528987.294,5336783.354,0,0,0,90.187,0,2005,0,67,313,160,0.824425864489597,-49.6,19.2098901098901,93,1074.96672745206,-1.10474053450085
25499,528987.294,5336783.354,178,66,112,46.425,0,2006,2,106,341,168,0.82984777554375,25.1,20.1736263736264,62,1074.96672745206,-1.10474053450085
25499,528987.294,5336783.354,0,0,0,83.351,0,2007,0,62,312,170,0.797116605603039,229.8,18.3494505494505,108,1074.96672745206,-1.10474053450085
25499,528987.294,5336783.354,0,0,0,31.419,0,2008,0,116,300,184,0.831838705957231,8.90000000000001,18.8,68,1074.96672745206,-1.10474053450085
25499,528987.294,5336783.354,153,66,87,39.011,0,2009,2,103,306,169,0.871026421842306,9.4,19.7494505494506,66,1074.96672745206,-1.10474053450085
25499,528987.294,5336783.354,166,119,47,32.305,0,2010,1,113,314,177,0.838453051791843,64.4,19.4725274725275,64,1074.96672745206,-1.10474053450085
25499,528987.294,5336783.354,86,70,16,44.664,0,2011,1,85,338,194,0.780936894836491,103.5,18.7505494505494,109,1074.96672745206,-1.10474053450085
25499,528987.294,5336783.354,109,93,16,54.33,3,2012,1,97,306,161,0.843550531596024,3.2,20.1307692307692,64,1074.96672745206,-1.10474053450085
25499,528987.294,5336783.354,170,93,77,45.704,0,2013,1,109,299,169,0.857167949314975,-190.8,20.5692307692308,60,1074.96672745206,-1.10474053450085
25499,528987.294,5336783.354,68,53,15,62.436,3,2014,1,72,353,153,0.816522875372118,65.4,19.2153846153846,81,1074.96672745206,-1.10474053450085
25499,528987.294,5336783.354,93,93,0,48.956,0,2015,1,100,340,161,0.846937880118742,-212.4,22.3164835164835,61,1074.96672745206,-1.10474053450085
25499,528987.294,5336783.354,182,93,89,51.406,4,2016,1,105,332,178,0.862772140173349,-31.9,20.4131868131868,73,1074.96672745206,-1.10474053450085
25499,528987.294,5336783.354,129,103,26,48.198,5,2017,1,93,319,168,0.816779743568118,-70.8,21.2648351648352,75,1074.96672745206,-1.10474053450085
25499,528987.294,5336783.354,86,79,7,119.499,38,2018,1,33,307,160,0.826119797416981,-135.7,21.9263736263736,127,1074.96672745206,-1.10474053450085
25499,528987.294,5336783.354,141,113,28,47.365,4,2019,1,101,336,160,0.813712837192647,-112.7,22.0065934065934,59,1074.96672745206,-1.10474053450085
25499,528987.294,5336783.354,0,0,0,111.017,0,2020,0,32,314,169,0.818358656123432,-111.3,20.3164835164835,137,1074.96672745206,-1.10474053450085
25500,528987.294,5336551.697,0,0,0,61.609,0,2001,2,94,291,170,0.848971797264022,-14.2,19.5065934065934,76,1129.62184154845,-0.129494391414017
25500,528987.294,5336551.697,86,73,13,37.568,0,2002,1,112,292,240,0.826986117690064,3,19.4725274725275,128,1129.62184154845,-0.129494391414017
25500,528987.294,5336551.697,146,94,52,35.448,1,2003,1,109,319,161,0.796345171147465,-209,24.2648351648352,52,1129.62184154845,-0.129494391414017
25500,528987.294,5336551.697,140,93,47,45.76,0,2004,1,103,307,162,0.817744320791716,104,19.0769230769231,59,1129.62184154845,-0.129494391414017
25500,528987.294,5336551.697,0,0,0,63.307,0,2005,0,92,306,161,0.831166469004147,-49.6,19.2098901098901,69,1129.62184154845,-0.129494391414017
25500,528987.294,5336551.697,179,64,115,42.98,0,2006,2,109,338,169,0.818072438533164,25.1,20.1736263736264,60,1129.62184154845,-0.129494391414017
25500,528987.294,5336551.697,0,0,0,61.55,0,2007,0,81,295,160,0.821297723618173,229.8,18.3494505494505,79,1129.62184154845,-0.129494391414017
25500,528987.294,5336551.697,0,0,0,16.034,0,2008,0,132,302,210,0.837314954941194,8.90000000000001,18.8,78,1129.62184154845,-0.129494391414017
25500,528987.294,5336551.697,156,71,85,32.947,0,2009,2,110,305,169,0.869477455453288,9.4,19.7494505494506,59,1129.62184154845,-0.129494391414017
25500,528987.294,5336551.697,164,93,71,28.367,0,2010,2,118,312,202,0.793090670337875,64.4,19.4725274725275,84,1129.62184154845,-0.129494391414017
25500,528987.294,5336551.697,86,69,17,39.494,0,2011,1,91,333,193,0.774014137932751,103.5,18.7505494505494,102,1129.62184154845,-0.129494391414017
25500,528987.294,5336551.697,109,93,16,47.401,1,2012,1,106,299,161,0.845262097776816,3.2,20.1307692307692,55,1129.62184154845,-0.129494391414017
25500,528987.294,5336551.697,173,93,80,40.689,0,2013,1,114,300,170,0.856185179446398,-190.8,20.5692307692308,56,1129.62184154845,-0.129494391414017
25500,528987.294,5336551.697,86,59,27,48.678,0,2014,1,88,325,161,0.807414349295418,65.4,19.2153846153846,73,1129.62184154845,-0.129494391414017
25500,528987.294,5336551.697,93,93,0,43.066,0,2015,1,106,294,168,0.825868747964343,-212.4,22.3164835164835,62,1129.62184154845,-0.129494391414017
25500,528987.294,5336551.697,181,93,88,55.433,4,2016,1,101,320,177,0.884671838312249,-31.9,20.4131868131868,76,1129.62184154845,-0.129494391414017
25500,528987.294,5336551.697,128,98,30,39.276,5,2017,1,104,315,177,0.815181467209755,-70.8,21.2648351648352,73,1129.62184154845,-0.129494391414017
25500,528987.294,5336551.697,86,78,8,123.043,39,2018,1,30,302,160,0.862398306623659,-135.7,21.9263736263736,130,1129.62184154845,-0.129494391414017
25500,528987.294,5336551.697,137,94,43,39.604,2,2019,1,109,336,169,0.827592015613159,-112.7,22.0065934065934,60,1129.62184154845,-0.129494391414017
25500,528987.294,5336551.697,0,0,0,42.161,0,2020,0,90,277,185,0.831194074911568,-111.3,20.3164835164835,95,1129.62184154845,-0.129494391414017
25501,528987.294,5336320.041,0,0,0,53.54,0,2001,1,101,303,169,0.844260557014176,-14.2,19.5065934065934,68,1087.86588210536,-1.50081732722045
25501,528987.294,5336320.041,86,58,28,39.312,0,2002,1,110,312,162,0.785630111299747,3,19.4725274725275,52,1087.86588210536,-1.50081732722045
25501,528987.294,5336320.041,145,94,51,43.097,3,2003,1,100,280,153,0.781173138518007,-209,24.2648351648352,53,1087.86588210536,-1.50081732722045
25501,528987.294,5336320.041,129,93,36,44.704,0,2004,1,104,326,169,0.835622368201843,104,19.0769230769231,65,1087.86588210536,-1.50081732722045
25501,528987.294,5336320.041,158,93,65,60.337,2,2005,1,95,308,154,0.850446517590025,-49.6,19.2098901098901,59,1087.86588210536,-1.50081732722045
25501,528987.294,5336320.041,177,66,111,46.425,0,2006,2,106,344,162,0.824183675305673,25.1,20.1736263736264,56,1087.86588210536,-1.50081732722045
25501,528987.294,5336320.041,0,0,0,74.433,0,2007,0,69,313,186,0.797238789464669,229.8,18.3494505494505,117,1087.86588210536,-1.50081732722045
25501,528987.294,5336320.041,93,93,0,24.951,0,2008,2,122,310,185,0.843757687799077,8.90000000000001,18.8,63,1087.86588210536,-1.50081732722045
25501,528987.294,5336320.041,157,69,88,37.275,0,2009,2,105,293,169,0.858184697044121,9.4,19.7494505494506,64,1087.86588210536,-1.50081732722045
25501,528987.294,5336320.041,167,94,73,32.305,0,2010,1,113,307,178,0.821931520500061,64.4,19.4725274725275,65,1087.86588210536,-1.50081732722045
25501,528987.294,5336320.041,116,62,54,44.664,0,2011,3,85,337,226,0.772635524021837,103.5,18.7505494505494,141,1087.86588210536,-1.50081732722045
25501,528987.294,5336320.041,93,93,0,53.563,3,2012,1,98,327,162,0.853912587142512,3.2,20.1307692307692,64,1087.86588210536,-1.50081732722045
25501,528987.294,5336320.041,170,96,74,42.653,0,2013,1,112,315,169,0.852603931834694,-190.8,20.5692307692308,57,1087.86588210536,-1.50081732722045
25501,528987.294,5336320.041,0,0,0,60.635,0,2014,0,74,339,169,0.830840820696684,65.4,19.2153846153846,95,1087.86588210536,-1.50081732722045
25501,528987.294,5336320.041,93,93,0,52.267,1,2015,1,97,339,161,0.812597111272396,-212.4,22.3164835164835,64,1087.86588210536,-1.50081732722045
25501,528987.294,5336320.041,157,94,63,72.466,5,2016,1,84,317,160,0.790350283268535,-31.9,20.4131868131868,76,1087.86588210536,-1.50081732722045
25501,528987.294,5336320.041,97,95,2,37.093,5,2017,1,107,322,177,0.793156762370929,-70.8,21.2648351648352,70,1087.86588210536,-1.50081732722045
25501,528987.294,5336320.041,0,0,0,111.392,0,2018,0,40,309,144,0.878504823540295,-135.7,21.9263736263736,104,1087.86588210536,-1.50081732722045
25501,528987.294,5336320.041,126,98,28,46.363,4,2019,1,102,339,162,0.80212826580045,-112.7,22.0065934065934,60,1087.86588210536,-1.50081732722045
25501,528987.294,5336320.041,0,0,0,52.721,0,2020,0,79,312,184,0.831661598453295,-111.3,20.3164835164835,105,1087.86588210536,-1.50081732722045
25502,528987.294,5336088.384,0,0,0,130.85,0,2001,0,37,324,168,0.837840413120903,-14.2,19.5065934065934,131,1028.96826643236,1.37535605383228
25502,528987.294,5336088.384,86,64,22,49.65,0,2002,1,98,299,160,0.808645107745633,3,19.4725274725275,62,1028.96826643236,1.37535605383228
25502,528987.294,5336088.384,147,93,54,56.519,9,2003,1,85,238,144,0.79510175066931,-209,24.2648351648352,59,1028.96826643236,1.37535605383228
25502,528987.294,5336088.384,135,93,42,45.76,0,2004,1,103,326,162,0.836639330825953,104,19.0769230769231,59,1028.96826643236,1.37535605383228
25502,528987.294,5336088.384,152,121,31,69.684,2,2005,1,86,310,153,0.859574625876532,-49.6,19.2098901098901,67,1028.96826643236,1.37535605383228
25502,528987.294,5336088.384,177,66,111,48.767,0,2006,2,104,346,161,0.840860971898205,25.1,20.1736263736264,57,1028.96826643236,1.37535605383228
25502,528987.294,5336088.384,0,0,0,72.138,0,2007,0,71,299,169,0.822251692967706,229.8,18.3494505494505,98,1028.96826643236,1.37535605383228
25502,528987.294,5336088.384,0,0,0,33.811,0,2008,0,114,315,177,0.849101142050393,8.90000000000001,18.8,63,1028.96826643236,1.37535605383228
25502,528987.294,5336088.384,158,70,88,43.681,0,2009,2,98,298,160,0.858275516918401,9.4,19.7494505494506,62,1028.96826643236,1.37535605383228
25502,528987.294,5336088.384,167,93,74,38.581,0,2010,1,106,308,176,0.827189368404369,64.4,19.4725274725275,70,1028.96826643236,1.37535605383228
25502,528987.294,5336088.384,116,63,53,55.936,3,2011,3,72,345,241,0.801559444450555,103.5,18.7505494505494,169,1028.96826643236,1.37535605383228
25502,528987.294,5336088.384,93,93,0,62.172,4,2012,1,87,338,161,0.852560437348958,3.2,20.1307692307692,74,1028.96826643236,1.37535605383228
25502,528987.294,5336088.384,172,93,79,45.704,0,2013,1,109,323,161,0.867416217307614,-190.8,20.5692307692308,52,1028.96826643236,1.37535605383228
25502,528987.294,5336088.384,0,0,0,76.948,0,2014,0,58,344,161,0.833896344270801,65.4,19.2153846153846,103,1028.96826643236,1.37535605383228
25502,528987.294,5336088.384,93,93,0,59.403,4,2015,1,91,347,154,0.83736511777645,-212.4,22.3164835164835,63,1028.96826643236,1.37535605383228
25502,528987.294,5336088.384,157,94,63,71.538,4,2016,1,85,310,154,0.818211094191404,-31.9,20.4131868131868,69,1028.96826643236,1.37535605383228
25502,528987.294,5336088.384,0,0,0,37.093,0,2017,0,107,322,168,0.79002458035647,-70.8,21.2648351648352,61,1028.96826643236,1.37535605383228
25502,528987.294,5336088.384,86,86,0,125.424,39,2018,1,28,316,169,0.811040737006999,-135.7,21.9263736263736,141,1028.96826643236,1.37535605383228
25502,528987.294,5336088.384,125,96,29,58.784,6,2019,1,89,341,161,0.845989167668939,-112.7,22.0065934065934,72,1028.96826643236,1.37535605383228
25502,528987.294,5336088.384,0,0,0,68.556,0,2020,0,66,318,176,0.824154058149122,-111.3,20.3164835164835,110,1028.96826643236,1.37535605383228
25508,528987.294,5334698.446,0,0,0,125.81,0,2001,1,41,310,169,0.845483205209304,-14.2,19.5065934065934,128,1203.49579755563,-0.848346921213358
25508,528987.294,5334698.446,86,79,7,44.567,0,2002,1,104,303,192,0.817507229013601,3,19.4725274725275,88,1203.49579755563,-0.848346921213358
25508,528987.294,5334698.446,146,93,53,37.843,1,2003,1,106,313,169,0.82009088818221,-209,24.2648351648352,63,1203.49579755563,-0.848346921213358
25508,528987.294,5334698.446,150,83,67,37.796,0,2004,3,111,328,241,0.832791643795473,104,19.0769230769231,130,1203.49579755563,-0.848346921213358
25508,528987.294,5334698.446,155,100,55,59.382,2,2005,1,96,314,170,0.865589824297682,-49.6,19.2098901098901,74,1203.49579755563,-0.848346921213358
25508,528987.294,5334698.446,184,61,123,41.884,0,2006,3,110,338,216,0.835917394080787,25.1,20.1736263736264,106,1203.49579755563,-0.848346921213358
25508,528987.294,5334698.446,0,0,0,71.033,0,2007,0,72,306,177,0.85347496543196,229.8,18.3494505494505,105,1203.49579755563,-0.848346921213358
25508,528987.294,5334698.446,0,0,0,32.603,0,2008,0,115,306,185,0.835789570132496,8.90000000000001,18.8,70,1203.49579755563,-0.848346921213358
25508,528987.294,5334698.446,156,61,95,47.794,0,2009,2,94,325,161,0.866093917882142,9.4,19.7494505494506,67,1203.49579755563,-0.848346921213358
25508,528987.294,5334698.446,138,93,45,34.883,0,2010,2,110,290,224,0.860886529457483,64.4,19.4725274725275,114,1203.49579755563,-0.848346921213358
25508,528987.294,5334698.446,93,70,23,43.012,0,2011,2,87,326,177,0.832995340001747,103.5,18.7505494505494,90,1203.49579755563,-0.848346921213358
25508,528987.294,5334698.446,0,0,0,54.33,0,2012,0,97,310,184,0.844022178897383,3.2,20.1307692307692,87,1203.49579755563,-0.848346921213358
25508,528987.294,5334698.446,177,93,84,37.901,0,2013,1,117,305,177,0.823611774810984,-190.8,20.5692307692308,60,1203.49579755563,-0.848346921213358
25508,528987.294,5334698.446,86,61,25,45.442,0,2014,1,92,317,274,0.828111725697293,65.4,19.2153846153846,182,1203.49579755563,-0.848346921213358
25508,528987.294,5334698.446,93,93,0,50.027,0,2015,1,99,346,161,0.828597878162815,-212.4,22.3164835164835,62,1203.49579755563,-0.848346921213358
25508,528987.294,5334698.446,148,93,55,60.635,4,2016,2,96,341,202,0.838906768418937,-31.9,20.4131868131868,106,1203.49579755563,-0.848346921213358
25508,528987.294,5334698.446,0,0,0,50.01,0,2017,0,91,304,170,0.855002311414611,-70.8,21.2648351648352,79,1203.49579755563,-0.848346921213358
25508,528987.294,5334698.446,86,67,19,78.017,9,2018,1,71,322,202,0.78776936222692,-135.7,21.9263736263736,131,1203.49579755563,-0.848346921213358
25508,528987.294,5334698.446,154,93,61,42.477,2,2019,1,106,341,170,0.837012354880919,-112.7,22.0065934065934,64,1203.49579755563,-0.848346921213358
25508,528987.294,5334698.446,0,0,0,42.161,0,2020,0,90,265,185,0.850577522558968,-111.3,20.3164835164835,95,1203.49579755563,-0.848346921213358
25509,528987.294,5334466.79,0,0,0,140.321,0,2001,2,29,328,184,0.840990401519661,-14.2,19.5065934065934,155,1220.26970591091,-1.33591363409827
25509,528987.294,5334466.79,93,84,9,37.568,0,2002,3,112,300,210,0.815990215930762,3,19.4725274725275,98,1220.26970591091,-1.33591363409827
25509,528987.294,5334466.79,144,94,50,37.023,1,2003,1,107,307,168,0.783761529301595,-209,24.2648351648352,61,1220.26970591091,-1.33591363409827
25509,528987.294,5334466.79,150,57,93,35.887,0,2004,3,113,331,186,0.829988147622922,104,19.0769230769231,73,1220.26970591091,-1.33591363409827
25509,528987.294,5334466.79,0,0,0,70.755,0,2005,0,85,310,177,0.849065932640097,-49.6,19.2098901098901,92,1220.26970591091,-1.33591363409827
25509,528987.294,5334466.79,182,62,120,37.791,0,2006,2,114,345,184,0.819785541822409,25.1,20.1736263736264,70,1220.26970591091,-1.33591363409827
25509,528987.294,5334466.79,0,0,0,62.647,0,2007,0,80,299,185,0.822698763078156,229.8,18.3494505494505,105,1220.26970591091,-1.33591363409827
25509,528987.294,5334466.79,0,0,0,27.013,0,2008,0,120,314,185,0.814696813841199,8.90000000000001,18.8,65,1220.26970591091,-1.33591363409827
25509,528987.294,5334466.79,168,69,99,37.275,0,2009,2,105,306,153,0.854170169577427,9.4,19.7494505494506,48,1220.26970591091,-1.33591363409827
25509,528987.294,5334466.79,162,93,69,37.626,0,2010,1,107,314,170,0.819879927121376,64.4,19.4725274725275,63,1220.26970591091,-1.33591363409827
25509,528987.294,5334466.79,86,69,17,94.541,22,2011,1,32,327,226,0.779440196885311,103.5,18.7505494505494,194,1220.26970591091,-1.33591363409827
25509,528987.294,5334466.79,143,96,47,51.29,1,2012,1,101,315,177,0.870381420160514,3.2,20.1307692307692,76,1220.26970591091,-1.33591363409827
25509,528987.294,5334466.79,173,93,80,38.828,0,2013,1,116,306,178,0.837323820684584,-190.8,20.5692307692308,62,1220.26970591091,-1.33591363409827
25509,528987.294,5334466.79,149,70,79,43.898,0,2014,2,94,345,208,0.808978825386562,65.4,19.2153846153846,114,1220.26970591091,-1.33591363409827
25509,528987.294,5334466.79,157,94,63,45.905,0,2015,2,103,344,201,0.749310389891842,-212.4,22.3164835164835,98,1220.26970591091,-1.33591363409827
25509,528987.294,5334466.79,160,93,67,60.635,4,2016,2,96,343,201,0.840282669310871,-31.9,20.4131868131868,105,1220.26970591091,-1.33591363409827
25509,528987.294,5334466.79,110,93,17,55.893,5,2017,2,85,319,201,0.838299102647284,-70.8,21.2648351648352,116,1220.26970591091,-1.33591363409827
25509,528987.294,5334466.79,152,75,77,45.344,0,2018,2,100,321,201,0.788676017909703,-135.7,21.9263736263736,101,1220.26970591091,-1.33591363409827
25509,528987.294,5334466.79,157,93,64,41.524,2,2019,1,107,333,170,0.818622855903308,-112.7,22.0065934065934,63,1220.26970591091,-1.33591363409827
25509,528987.294,5334466.79,0,0,0,44.874,0,2020,0,87,320,185,0.82002819809444,-111.3,20.3164835164835,98,1220.26970591091,-1.33591363409827
25510,528987.294,5334235.134,0,0,0,146.262,0,2001,2,24,330,185,0.79047432437876,-14.2,19.5065934065934,161,1181.42894348089,0.464665246013528
25510,528987.294,5334235.134,93,84,9,41.929,0,2002,3,107,299,194,0.754193356847931,3,19.4725274725275,87,1181.42894348089,0.464665246013528
25510,528987.294,5334235.134,142,94,48,54.787,9,2003,1,87,308,170,0.76332976415495,-209,24.2648351648352,83,1181.42894348089,0.464665246013528
25510,528987.294,5334235.134,146,56,90,46.838,0,2004,3,102,335,185,0.766533872217181,104,19.0769230769231,83,1181.42894348089,0.464665246013528
25510,528987.294,5334235.134,137,93,44,71.834,2,2005,4,84,311,234,0.775804070928325,-49.6,19.2098901098901,150,1181.42894348089,0.464665246013528
25510,528987.294,5334235.134,181,62,119,32.024,0,2006,3,120,346,193,0.768832127695999,25.1,20.1736263736264,73,1181.42894348089,0.464665246013528
25510,528987.294,5334235.134,0,0,0,95.446,0,2007,0,52,312,178,0.799858497218211,229.8,18.3494505494505,126,1181.42894348089,0.464665246013528
25510,528987.294,5334235.134,0,0,0,29.153,0,2008,0,118,318,178,0.793101319659328,8.90000000000001,18.8,60,1181.42894348089,0.464665246013528
25510,528987.294,5334235.134,165,70,95,49.992,0,2009,2,92,307,161,0.807912660602762,9.4,19.7494505494506,69,1181.42894348089,0.464665246013528
25510,528987.294,5334235.134,160,93,67,42.533,0,2010,2,102,318,225,0.786227969288942,64.4,19.4725274725275,123,1181.42894348089,0.464665246013528
25510,528987.294,5334235.134,86,69,17,111.077,35,2011,1,17,325,225,0.737094410218346,103.5,18.7505494505494,208,1181.42894348089,0.464665246013528
25510,528987.294,5334235.134,141,95,46,54.33,3,2012,1,97,314,177,0.817163920632695,3.2,20.1307692307692,80,1181.42894348089,0.464665246013528
25510,528987.294,5334235.134,171,94,77,40.689,0,2013,2,114,316,193,0.771376845971638,-190.8,20.5692307692308,79,1181.42894348089,0.464665246013528
25510,528987.294,5334235.134,147,78,69,49.523,0,2014,5,87,344,216,0.72577712312892,65.4,19.2153846153846,129,1181.42894348089,0.464665246013528
25510,528987.294,5334235.134,151,94,57,50.027,0,2015,1,99,335,178,0.744869424564816,-212.4,22.3164835164835,79,1181.42894348089,0.464665246013528
25510,528987.294,5334235.134,160,95,65,53.445,4,2016,2,103,342,210,0.77041065417477,-31.9,20.4131868131868,107,1181.42894348089,0.464665246013528
25510,528987.294,5334235.134,111,93,18,80.313,6,2017,2,64,317,209,0.778437385044457,-70.8,21.2648351648352,145,1181.42894348089,0.464665246013528
25510,528987.294,5334235.134,153,75,78,51.946,0,2018,2,94,319,184,0.791775681104394,-135.7,21.9263736263736,90,1181.42894348089,0.464665246013528
25510,528987.294,5334235.134,152,94,58,50.316,4,2019,1,98,332,169,0.769633440884464,-112.7,22.0065934065934,71,1181.42894348089,0.464665246013528
25510,528987.294,5334235.134,0,0,0,71.078,0,2020,0,64,321,192,0.74736107379023,-111.3,20.3164835164835,128,1181.42894348089,0.464665246013528
25511,528987.294,5334003.477,0,0,0,138.86,0,2001,1,28,332,177,0.84800071672686,10.6,17.710989010989,149,1091.16363847996,-1.31473004388117
25511,528987.294,5334003.477,98,93,5,42.934,0,2002,1,107,341,177,0.843731051235538,25.6,17.9494505494505,70,1091.16363847996,-1.31473004388117
25511,528987.294,5334003.477,139,93,46,63.664,11,2003,1,83,334,177,0.832466337895742,-201.3,22.6626373626374,94,1091.16363847996,-1.31473004388117
25511,528987.294,5334003.477,135,96,39,56.651,4,2004,2,95,338,216,0.831901392351421,132.4,17.5076923076923,121,1091.16363847996,-1.31473004388117
25511,528987.294,5334003.477,153,114,39,59.718,2,2005,1,96,318,177,0.842004847381048,-23.3,17.6,81,1091.16363847996,-1.31473004388117
25511,528987.294,5334003.477,183,93,90,32.717,1,2006,2,121,346,201,0.8358205832732,50,18.6131868131868,80,1091.16363847996,-1.31473004388117
25511,528987.294,5334003.477,0,0,0,111.028,0,2007,0,38,305,208,0.835744700561711,269.6,16.9021978021978,170,1091.16363847996,-1.31473004388117
25511,528987.294,5334003.477,0,0,0,122.769,0,2008,0,34,310,256,0.808986969924053,38,17.3098901098901,222,1091.16363847996,-1.31473004388117
25511,528987.294,5334003.477,159,66,93,44.024,0,2009,3,103,324,232,0.839847219580495,34.6,18.2571428571429,129,1091.16363847996,-1.31473004388117
25511,528987.294,5334003.477,162,93,69,42.316,0,2010,2,107,317,193,0.83379332422315,95.1,17.9945054945055,86,1091.16363847996,-1.31473004388117
25511,528987.294,5334003.477,86,70,16,91.357,21,2011,1,43,331,210,0.824342558532541,139.3,17.1164835164835,167,1091.16363847996,-1.31473004388117
25511,528987.294,5334003.477,127,94,33,48.485,2,2012,1,105,338,177,0.774157965983393,38.5,18.2296703296703,72,1091.16363847996,-1.31473004388117
25511,528987.294,5334003.477,173,108,65,29.446,1,2013,1,125,312,185,0.759774426196483,-164.8,18.7813186813187,60,1091.16363847996,-1.31473004388117
25511,528987.294,5334003.477,93,75,18,46.979,3,2014,3,93,338,202,0.737573693686967,101.8,17.4461538461538,109,1091.16363847996,-1.31473004388117
25511,528987.294,5334003.477,0,0,0,44.708,0,2015,0,104,331,178,0.732197476020962,-192.4,20.4978021978022,74,1091.16363847996,-1.31473004388117
25511,528987.294,5334003.477,159,93,66,53.061,5,2016,2,103,321,192,0.834723082231316,-4.8,18.6318681318681,89,1091.16363847996,-1.31473004388117
25511,528987.294,5334003.477,122,93,29,33.624,3,2017,1,113,305,177,0.776199936678974,-54.4,19.6516483516484,64,1091.16363847996,-1.31473004388117
25511,528987.294,5334003.477,86,68,18,52.727,0,2018,1,96,305,161,0.821092390407463,-121.8,20.367032967033,65,1091.16363847996,-1.31473004388117
25511,528987.294,5334003.477,136,79,57,36.935,3,2019,2,112,336,178,0.793616139515185,-107,20.478021978022,66,1091.16363847996,-1.31473004388117
25511,528987.294,5334003.477,0,0,0,34.434,0,2020,0,102,308,192,0.784234338708177,-91.9,18.7142857142857,90,1091.16363847996,-1.31473004388117
25518,528987.294,5332381.883,0,0,0,116.193,0,2001,1,48,327,160,0.824581732972789,10.6,17.710989010989,112,930.342528200929,1.31199592801749
25518,528987.294,5332381.883,93,76,17,61.892,4,2002,2,88,342,161,0.821304500108388,25.6,17.9494505494505,73,930.342528200929,1.31199592801749
25518,528987.294,5332381.883,150,102,48,51.198,8,2003,1,95,327,146,0.790376385855955,-201.3,22.6626373626374,51,930.342528200929,1.31199592801749
25518,528987.294,5332381.883,141,99,42,53.271,4,2004,1,98,332,162,0.790547159079892,132.4,17.5076923076923,64,930.342528200929,1.31199592801749
25518,528987.294,5332381.883,0,0,0,81.315,0,2005,0,77,309,152,0.805874745968152,-23.3,17.6,75,930.342528200929,1.31199592801749
25518,528987.294,5332381.883,168,65,103,48.352,2,2006,2,108,343,161,0.815256407172044,50,18.6131868131868,53,930.342528200929,1.31199592801749
25518,528987.294,5332381.883,0,0,0,82.884,0,2007,0,62,299,145,0.782178780080238,269.6,16.9021978021978,83,930.342528200929,1.31199592801749
25518,528987.294,5332381.883,81,54,27,44.199,2,2008,1,105,312,177,0.821880032035414,38,17.3098901098901,72,930.342528200929,1.31199592801749
25518,528987.294,5332381.883,162,68,94,49.897,0,2009,2,98,314,161,0.843957079893578,34.6,18.2571428571429,63,930.342528200929,1.31199592801749
25518,528987.294,5332381.883,162,80,82,41.192,0,2010,3,108,311,241,0.79516978909366,95.1,17.9945054945055,133,930.342528200929,1.31199592801749
25518,528987.294,5332381.883,82,68,14,55.595,3,2011,1,78,323,138,0.79278664506548,139.3,17.1164835164835,60,930.342528200929,1.31199592801749
25518,528987.294,5332381.883,135,93,42,60.415,5,2012,1,91,317,162,0.847844688681674,38.5,18.2296703296703,71,930.342528200929,1.31199592801749
25518,528987.294,5332381.883,177,79,98,46.54,1,2013,2,110,302,169,0.836680302530969,-164.8,18.7813186813187,59,930.342528200929,1.31199592801749
25518,528987.294,5332381.883,98,96,2,66.777,7,2014,2,71,344,210,0.824691980045202,101.8,17.4461538461538,139,930.342528200929,1.31199592801749
25518,528987.294,5332381.883,149,93,56,59.302,5,2015,1,91,339,146,0.843128361747889,-192.4,20.4978021978022,55,930.342528200929,1.31199592801749
25518,528987.294,5332381.883,162,105,57,62.805,5,2016,1,94,328,162,0.840563144738724,-4.8,18.6318681318681,68,930.342528200929,1.31199592801749
25518,528987.294,5332381.883,0,0,0,53.815,0,2017,0,89,321,201,0.807056901387029,-54.4,19.6516483516484,112,930.342528200929,1.31199592801749
25518,528987.294,5332381.883,86,76,10,131.811,40,2018,1,24,336,161,0.822843053882651,-121.8,20.367032967033,137,930.342528200929,1.31199592801749
25518,528987.294,5332381.883,129,99,30,55.299,9,2019,1,93,342,154,0.805353593202566,-107,20.478021978022,61,930.342528200929,1.31199592801749
25518,528987.294,5332381.883,0,0,0,69.619,0,2020,0,67,316,162,0.809464433791746,-91.9,18.7142857142857,95,930.342528200929,1.31199592801749
25519,528987.294,5332150.226,0,0,0,128.789,0,2001,1,37,344,154,0.814222404431412,10.6,17.710989010989,117,928.176258181994,-0.698821187918545
25519,528987.294,5332150.226,0,0,0,60.751,0,2002,0,89,340,161,0.812293480237686,25.6,17.9494505494505,72,928.176258181994,-0.698821187918545
25519,528987.294,5332150.226,119,94,25,57.471,11,2003,1,89,328,152,0.792479656284107,-201.3,22.6626373626374,63,928.176258181994,-0.698821187918545
25519,528987.294,5332150.226,0,0,0,62.967,0,2004,0,89,334,169,0.817418107683231,132.4,17.5076923076923,80,928.176258181994,-0.698821187918545
25519,528987.294,5332150.226,0,0,0,118.343,0,2005,0,43,314,154,0.816575314459863,-23.3,17.6,111,928.176258181994,-0.698821187918545
25519,528987.294,5332150.226,172,67,105,44.475,2,2006,3,111,343,266,0.825819077196279,50,18.6131868131868,155,928.176258181994,-0.698821187918545
25519,528987.294,5332150.226,0,0,0,95.825,0,2007,0,51,301,240,0.852819424710861,269.6,16.9021978021978,189,928.176258181994,-0.698821187918545
25519,528987.294,5332150.226,86,85,1,46.721,2,2008,1,103,314,185,0.834250121233662,38,17.3098901098901,82,928.176258181994,-0.698821187918545
25519,528987.294,5332150.226,151,67,84,59.545,0,2009,2,90,303,162,0.843507399934927,34.6,18.2571428571429,72,928.176258181994,-0.698821187918545
25519,528987.294,5332150.226,162,93,69,43.462,0,2010,1,106,315,162,0.804629925812582,95.1,17.9945054945055,56,928.176258181994,-0.698821187918545
25519,528987.294,5332150.226,86,74,12,66.419,4,2011,1,67,332,234,0.80819939728208,139.3,17.1164835164835,167,928.176258181994,-0.698821187918545
25519,528987.294,5332150.226,133,94,39,57.804,4,2012,1,94,308,169,0.855677477353128,38.5,18.2296703296703,75,928.176258181994,-0.698821187918545
25519,528987.294,5332150.226,166,63,103,51.461,1,2013,2,106,311,162,0.827297774179864,-164.8,18.7813186813187,56,928.176258181994,-0.698821187918545
25519,528987.294,5332150.226,107,94,13,66.777,7,2014,2,71,346,265,0.80167021883312,101.8,17.4461538461538,194,928.176258181994,-0.698821187918545
25519,528987.294,5332150.226,0,0,0,62.724,0,2015,0,88,338,146,0.827057738255836,-192.4,20.4978021978022,58,928.176258181994,-0.698821187918545
25519,528987.294,5332150.226,0,0,0,69.426,0,2016,0,88,335,153,0.88164400628482,-4.8,18.6318681318681,65,928.176258181994,-0.698821187918545
25519,528987.294,5332150.226,0,0,0,61.308,0,2017,0,82,318,202,0.805085035618716,-54.4,19.6516483516484,120,928.176258181994,-0.698821187918545
25519,528987.294,5332150.226,159,77,82,52.727,0,2018,2,96,337,138,0.793802479135213,-121.8,20.367032967033,42,928.176258181994,-0.698821187918545
25519,528987.294,5332150.226,128,99,29,60.144,9,2019,1,88,331,160,0.801768111608496,-107,20.478021978022,72,928.176258181994,-0.698821187918545
25519,528987.294,5332150.226,0,0,0,74.544,0,2020,0,63,349,170,0.812213383792467,-91.9,18.7142857142857,107,928.176258181994,-0.698821187918545
25534,528987.294,5328675.381,0,0,0,30.439,0,2001,1,121,300,194,0.878698100953323,10.6,17.710989010989,73,1076.11291197691,1.4915679843484
25534,528987.294,5328675.381,93,93,0,23.586,0,2002,2,127,298,185,0.845926936964124,25.6,17.9494505494505,58,1076.11291197691,1.4915679843484
25534,528987.294,5328675.381,141,93,48,41.134,1,2003,1,105,305,169,0.860178982602597,-201.3,22.6626373626374,64,1076.11291197691,1.4915679843484
25534,528987.294,5328675.381,152,93,59,32.816,0,2004,2,117,308,185,0.860813940750117,132.4,17.5076923076923,68,1076.11291197691,1.4915679843484
25534,528987.294,5328675.381,141,93,48,54.962,1,2005,2,100,303,169,0.884712763319022,-23.3,17.6,69,1076.11291197691,1.4915679843484
25534,528987.294,5328675.381,189,93,96,32.717,1,2006,1,121,317,169,0.870239048293444,50,18.6131868131868,48,1076.11291197691,1.4915679843484
25534,528987.294,5328675.381,0,0,0,54.308,0,2007,0,88,294,225,0.876015142762294,269.6,16.9021978021978,137,1076.11291197691,1.4915679843484
25534,528987.294,5328675.381,0,0,0,30.139,0,2008,0,117,306,177,0.875778310700562,38,17.3098901098901,60,1076.11291197691,1.4915679843484
25534,528987.294,5328675.381,155,93,62,40.703,0,2009,1,106,301,162,0.897624165847002,34.6,18.2571428571429,56,1076.11291197691,1.4915679843484
25534,528987.294,5328675.381,114,93,21,36.908,0,2010,2,112,306,194,0.880349625035779,95.1,17.9945054945055,82,1076.11291197691,1.4915679843484
25534,528987.294,5328675.381,103,93,10,40.024,0,2011,2,94,329,226,0.844795607408663,139.3,17.1164835164835,132,1076.11291197691,1.4915679843484
25534,528987.294,5328675.381,145,94,51,49.336,2,2012,1,104,301,176,0.895741039061614,38.5,18.2296703296703,72,1076.11291197691,1.4915679843484
25534,528987.294,5328675.381,177,102,75,31.708,1,2013,1,123,309,186,0.882563184807761,-164.8,18.7813186813187,63,1076.11291197691,1.4915679843484
25534,528987.294,5328675.381,0,0,0,43.031,0,2014,0,98,332,177,0.878982023467514,101.8,17.4461538461538,79,1076.11291197691,1.4915679843484
25534,528987.294,5328675.381,93,93,0,39.184,0,2015,1,110,335,177,0.861000996881126,-192.4,20.4978021978022,67,1076.11291197691,1.4915679843484
25534,528987.294,5328675.381,100,96,4,66.149,5,2016,1,91,333,185,0.89605389148474,-4.8,18.6318681318681,94,1076.11291197691,1.4915679843484
25534,528987.294,5328675.381,93,93,0,39.048,7,2017,1,106,306,177,0.870642834748682,-54.4,19.6516483516484,71,1076.11291197691,1.4915679843484
25534,528987.294,5328675.381,86,85,1,44.452,0,2018,1,103,306,178,0.856636777742503,-121.8,20.367032967033,75,1076.11291197691,1.4915679843484
25534,528987.294,5328675.381,132,93,39,32.592,3,2019,1,117,331,177,0.881725969485441,-107,20.478021978022,60,1076.11291197691,1.4915679843484
25534,528987.294,5328675.381,0,0,0,39.255,0,2020,0,96,289,178,0.83430388314368,-91.9,18.7142857142857,82,1076.11291197691,1.4915679843484
25543,528987.294,5326590.474,86,82,4,39.323,1,2001,0,113,293,185,0.880469583867454,10.6,17.710989010989,72,1344.18690212461,-0.710383514105464
25543,528987.294,5326590.474,153,71,82,13.602,0,2002,2,137,287,184,0.813394315973096,25.6,17.9494505494505,47,1344.18690212461,-0.710383514105464
25543,528987.294,5326590.474,158,93,65,19.199,0,2003,2,130,292,184,0.874075893769715,-201.3,22.6626373626374,54,1344.18690212461,-0.710383514105464
25543,528987.294,5326590.474,173,56,117,20.946,0,2004,3,130,291,208,0.86414743189114,132.4,17.5076923076923,78,1344.18690212461,-0.710383514105464
25543,528987.294,5326590.474,156,93,63,30.849,0,2005,2,122,308,192,0.866603100590935,-23.3,17.6,70,1344.18690212461,-0.710383514105464
25543,528987.294,5326590.474,196,149,47,28.544,1,2006,1,125,315,169,0.827082930509771,50,18.6131868131868,44,1344.18690212461,-0.710383514105464
25543,528987.294,5326590.474,93,93,0,46.958,1,2007,2,95,289,201,0.862912870987203,269.6,16.9021978021978,106,1344.18690212461,-0.710383514105464
25543,528987.294,5326590.474,127,52,75,17.673,0,2008,3,130,295,186,0.869718745010268,38,17.3098901098901,56,1344.18690212461,-0.710383514105464
25543,528987.294,5326590.474,172,61,111,47.509,0,2009,3,100,289,193,0.877159264429246,34.6,18.2571428571429,93,1344.18690212461,-0.710383514105464
25543,528987.294,5326590.474,174,127,47,17.864,0,2010,1,133,292,184,0.850858703986983,95.1,17.9945054945055,51,1344.18690212461,-0.710383514105464
25543,528987.294,5326590.474,93,65,28,28.884,0,2011,2,107,313,169,0.836681210529362,139.3,17.1164835164835,62,1344.18690212461,-0.710383514105464
25543,528987.294,5326590.474,159,93,66,24.948,0,2012,1,128,319,178,0.886797398101274,38.5,18.2296703296703,50,1344.18690212461,-0.710383514105464
25543,528987.294,5326590.474,172,68,104,41.912,1,2013,3,114,291,194,0.871528633265571,-164.8,18.7813186813187,80,1344.18690212461,-0.710383514105464
25543,528987.294,5326590.474,148,65,83,25.812,0,2014,3,123,351,193,0.86440478717839,101.8,17.4461538461538,70,1344.18690212461,-0.710383514105464
25543,528987.294,5326590.474,158,106,52,38.306,0,2015,1,111,307,177,0.868965906314495,-192.4,20.4978021978022,66,1344.18690212461,-0.710383514105464
25543,528987.294,5326590.474,164,94,70,22.863,0,2016,2,131,342,201,0.866572042284533,-4.8,18.6318681318681,70,1344.18690212461,-0.710383514105464
25543,528987.294,5326590.474,93,93,0,32.877,3,2017,1,114,297,177,0.849485589016614,-54.4,19.6516483516484,63,1344.18690212461,-0.710383514105464
25543,528987.294,5326590.474,157,66,91,49.092,0,2018,2,99,340,184,0.867126777745509,-121.8,20.367032967033,85,1344.18690212461,-0.710383514105464
25543,528987.294,5326590.474,154,114,40,16.635,0,2019,1,134,306,185,0.863074736896566,-107,20.478021978022,51,1344.18690212461,-0.710383514105464
25543,528987.294,5326590.474,0,0,0,28.29,0,2020,0,111,301,209,0.834811616689627,-91.9,18.7142857142857,98,1344.18690212461,-0.710383514105464
25544,528987.294,5326358.817,86,83,3,33.821,0,2001,2,118,318,193,0.868339616853385,10.6,17.710989010989,75,1344.97284609472,1.3622590099406
25544,528987.294,5326358.817,152,79,73,16.451,0,2002,3,134,285,185,0.849333730057372,25.6,17.9494505494505,51,1344.97284609472,1.3622590099406
25544,528987.294,5326358.817,149,93,56,22.408,0,2003,1,126,296,178,0.855169478597094,-201.3,22.6626373626374,52,1344.97284609472,1.3622590099406
25544,528987.294,5326358.817,173,57,116,24.673,0,2004,3,126,308,194,0.854484490590067,132.4,17.5076923076923,68,1344.97284609472,1.3622590099406
25544,528987.294,5326358.817,158,93,65,25.886,0,2005,2,127,305,186,0.846309125632969,-23.3,17.6,59,1344.97284609472,1.3622590099406
25544,528987.294,5326358.817,191,93,98,37.273,2,2006,1,117,324,177,0.816947432768604,50,18.6131868131868,60,1344.97284609472,1.3622590099406
25544,528987.294,5326358.817,0,0,0,37.144,0,2007,0,106,288,209,0.862709900390843,269.6,16.9021978021978,103,1344.97284609472,1.3622590099406
25544,528987.294,5326358.817,125,53,72,19.328,0,2008,3,128,295,192,0.8570615633883,38,17.3098901098901,64,1344.97284609472,1.3622590099406
25544,528987.294,5326358.817,179,63,116,24.543,0,2009,2,123,294,184,0.909362333180225,34.6,18.2571428571429,61,1344.97284609472,1.3622590099406
25544,528987.294,5326358.817,170,93,77,15.838,0,2010,2,135,287,185,0.812535102362244,95.1,17.9945054945055,50,1344.97284609472,1.3622590099406
25544,528987.294,5326358.817,85,64,21,28.121,0,2011,1,108,313,161,0.806847812176701,139.3,17.1164835164835,53,1344.97284609472,1.3622590099406
25544,528987.294,5326358.817,153,94,59,27.051,0,2012,2,126,296,185,0.897576654338815,38.5,18.2296703296703,59,1344.97284609472,1.3622590099406
25544,528987.294,5326358.817,179,63,116,11.908,1,2013,3,142,296,209,0.875280721928834,-164.8,18.7813186813187,67,1344.97284609472,1.3622590099406
25544,528987.294,5326358.817,147,69,78,25.001,0,2014,3,124,337,193,0.856025455987639,101.8,17.4461538461538,69,1344.97284609472,1.3622590099406
25544,528987.294,5326358.817,155,105,50,39.184,0,2015,1,110,300,185,0.85874887450652,-192.4,20.4978021978022,75,1344.97284609472,1.3622590099406
25544,528987.294,5326358.817,170,102,68,20.998,0,2016,1,133,336,186,0.892385779474307,-4.8,18.6318681318681,53,1344.97284609472,1.3622590099406
25544,528987.294,5326358.817,0,0,0,29.841,0,2017,0,118,290,193,0.861651888163221,-54.4,19.6516483516484,75,1344.97284609472,1.3622590099406
25544,528987.294,5326358.817,171,64,107,33.866,0,2018,2,113,317,185,0.863696925287589,-121.8,20.367032967033,72,1344.97284609472,1.3622590099406
25544,528987.294,5326358.817,152,98,54,25.379,2,2019,2,125,311,192,0.851559733241034,-107,20.478021978022,67,1344.97284609472,1.3622590099406
25544,528987.294,5326358.817,0,0,0,27.063,0,2020,0,113,302,210,0.808063128298204,-91.9,18.7142857142857,97,1344.97284609472,1.3622590099406
25644,529218.95,5353925.924,0,0,0,75.086,0,2001,0,82,336,153,0.803861792427021,4.09999999999999,18.2296703296703,71,1015.52642746123,1.13839557043304
25644,529218.95,5353925.924,86,66,20,105.778,19,2002,1,50,334,241,0.812782025268804,18.8,18.3868131868132,191,1015.52642746123,1.13839557043304
25644,529218.95,5353925.924,145,94,51,59.093,10,2003,1,85,335,154,0.887869032564529,-204,23.121978021978,69,1015.52642746123,1.13839557043304
25644,529218.95,5353925.924,142,93,49,58.364,3,2004,1,91,334,162,0.793997191384659,123.8,17.9692307692308,71,1015.52642746123,1.13839557043304
25644,529218.95,5353925.924,147,93,54,73.117,2,2005,2,83,308,160,0.852957867692199,-31.4,18.0615384615385,77,1015.52642746123,1.13839557043304
25644,529218.95,5353925.924,163,93,70,52.88,0,2006,2,103,346,241,0.819612786993022,43,19.0516483516484,138,1015.52642746123,1.13839557043304
25644,529218.95,5353925.924,0,0,0,119.145,0,2007,0,29,312,154,0.855878662970831,258.5,17.3142857142857,125,1015.52642746123,1.13839557043304
25644,529218.95,5353925.924,0,0,0,107.647,0,2008,0,46,311,232,0.845964442409753,29.3,17.7417582417582,186,1015.52642746123,1.13839557043304
25644,529218.95,5353925.924,163,63,100,40.211,0,2009,3,105,329,194,0.835409696824991,27.1,18.689010989011,89,1015.52642746123,1.13839557043304
25644,529218.95,5353925.924,162,93,69,42.262,0,2010,1,105,317,177,0.809671918849475,87.4,18.4241758241758,72,1015.52642746123,1.13839557043304
25644,529218.95,5353925.924,93,73,20,67.939,8,2011,3,63,326,217,0.819702057673292,129,17.5824175824176,154,1015.52642746123,1.13839557043304
25644,529218.95,5353925.924,143,83,60,67.94,4,2012,3,81,327,185,0.824658981377943,29,18.7703296703297,104,1015.52642746123,1.13839557043304
25644,529218.95,5353925.924,163,93,70,51.019,0,2013,1,105,305,177,0.860276358032599,-172.4,19.2857142857143,72,1015.52642746123,1.13839557043304
25644,529218.95,5353925.924,82,56,26,80.922,13,2014,1,55,325,234,0.880025110554635,91.5,17.9450549450549,179,1015.52642746123,1.13839557043304
25644,529218.95,5353925.924,141,93,48,80.615,9,2015,2,69,339,192,0.814148239709466,-197.8,21,123,1015.52642746123,1.13839557043304
25644,529218.95,5353925.924,159,93,66,59.509,5,2016,1,96,339,161,0.839360500409499,-13,19.132967032967,65,1015.52642746123,1.13839557043304
25644,529218.95,5353925.924,112,93,19,80.585,7,2017,2,64,307,225,0.812454766493584,-57.8,20.1032967032967,161,1015.52642746123,1.13839557043304
25644,529218.95,5353925.924,86,67,19,60.344,2,2018,1,88,322,161,0.796253637026375,-125.4,20.7956043956044,73,1015.52642746123,1.13839557043304
25644,529218.95,5353925.924,129,94,35,62.862,10,2019,1,84,305,153,0.79271467296648,-108.1,20.8824175824176,69,1015.52642746123,1.13839557043304
25644,529218.95,5353925.924,0,0,0,63.771,0,2020,0,70,323,161,0.778232516521494,-97.4,19.156043956044,91,1015.52642746123,1.13839557043304
25645,529218.95,5353694.268,0,0,0,80.393,0,2001,1,78,337,146,0.821601872724807,4.09999999999999,18.2296703296703,68,990.243875001573,1.40302800694263
25645,529218.95,5353694.268,86,66,20,120.304,24,2002,1,38,335,242,0.800288025685215,18.8,18.3868131868132,204,990.243875001573,1.40302800694263
25645,529218.95,5353694.268,145,93,52,61.13,10,2003,1,83,335,160,0.869920961692426,-204,23.121978021978,77,990.243875001573,1.40302800694263
25645,529218.95,5353694.268,142,97,45,63.593,7,2004,2,86,339,192,0.788063649881085,123.8,17.9692307692308,106,990.243875001573,1.40302800694263
25645,529218.95,5353694.268,146,93,53,81.033,2,2005,2,76,310,153,0.837182674570398,-31.4,18.0615384615385,77,990.243875001573,1.40302800694263
25645,529218.95,5353694.268,169,93,76,51.604,0,2006,1,104,347,146,0.81435849602179,43,19.0516483516484,42,990.243875001573,1.40302800694263
25645,529218.95,5353694.268,0,0,0,119.145,0,2007,0,29,314,152,0.851831475434514,258.5,17.3142857142857,123,990.243875001573,1.40302800694263
25645,529218.95,5353694.268,0,0,0,119.533,0,2008,0,35,314,234,0.843679763502294,29.3,17.7417582417582,199,990.243875001573,1.40302800694263
25645,529218.95,5353694.268,162,65,97,44.562,0,2009,3,101,330,193,0.838501047521177,27.1,18.689010989011,92,990.243875001573,1.40302800694263
25645,529218.95,5353694.268,161,93,68,50.424,2,2010,1,98,315,161,0.807867759862135,87.4,18.4241758241758,63,990.243875001573,1.40302800694263
25645,529218.95,5353694.268,86,72,14,66.928,7,2011,1,64,325,225,0.836633898895635,129,17.5824175824176,161,990.243875001573,1.40302800694263
25645,529218.95,5353694.268,144,83,61,67.94,4,2012,3,81,326,208,0.829911732883197,29,18.7703296703297,127,990.243875001573,1.40302800694263
25645,529218.95,5353694.268,162,93,69,53.653,0,2013,1,103,306,170,0.847550608568222,-172.4,19.2857142857143,67,990.243875001573,1.40302800694263
25645,529218.95,5353694.268,83,56,27,84.303,15,2014,1,52,325,242,0.946712207436963,91.5,17.9450549450549,190,990.243875001573,1.40302800694263
25645,529218.95,5353694.268,145,94,51,70.137,5,2015,1,79,337,154,0.826474714870763,-197.8,21,75,990.243875001573,1.40302800694263
25645,529218.95,5353694.268,159,93,66,61.574,5,2016,1,94,338,161,0.837139469597045,-13,19.132967032967,67,990.243875001573,1.40302800694263
25645,529218.95,5353694.268,117,96,21,68.266,6,2017,2,74,306,233,0.784180849197612,-57.8,20.1032967032967,159,990.243875001573,1.40302800694263
25645,529218.95,5353694.268,86,67,19,62.56,2,2018,1,86,319,145,0.807600263166232,-125.4,20.7956043956044,59,990.243875001573,1.40302800694263
25645,529218.95,5353694.268,132,98,34,61.823,10,2019,1,85,305,145,0.798175008037044,-108.1,20.8824175824176,60,990.243875001573,1.40302800694263
25645,529218.95,5353694.268,0,0,0,71.245,0,2020,0,64,322,154,0.76561156133876,-97.4,19.156043956044,90,990.243875001573,1.40302800694263
25647,529218.95,5353230.955,0,0,0,94.708,0,2001,1,67,328,224,0.86276644746172,4.09999999999999,18.2296703296703,157,904.713452995436,1.16265341424269
25647,529218.95,5353230.955,111,72,39,71,10,2002,3,79,333,224,0.862057520267277,18.8,18.3868131868132,145,904.713452995436,1.16265341424269
25647,529218.95,5353230.955,138,94,44,59.093,10,2003,1,85,329,169,0.92199114763199,-204,23.121978021978,84,904.713452995436,1.16265341424269
25647,529218.95,5353230.955,140,94,46,62.523,6,2004,2,87,334,233,0.855019931986049,123.8,17.9692307692308,146,904.713452995436,1.16265341424269
25647,529218.95,5353230.955,148,93,55,74.252,2,2005,4,82,307,224,0.861802890688158,-31.4,18.0615384615385,142,904.713452995436,1.16265341424269
25647,529218.95,5353230.955,169,63,106,46.473,0,2006,3,108,341,241,0.858378383304937,43,19.0516483516484,133,904.713452995436,1.16265341424269
25647,529218.95,5353230.955,0,0,0,95.516,0,2007,0,50,324,234,0.868490942134523,258.5,17.3142857142857,184,904.713452995436,1.16265341424269
25647,529218.95,5353230.955,0,0,0,88.736,0,2008,0,65,306,226,0.865393994731169,29.3,17.7417582417582,161,904.713452995436,1.16265341424269
25647,529218.95,5353230.955,156,94,62,65.557,3,2009,2,84,323,217,0.859888893538221,27.1,18.689010989011,133,904.713452995436,1.16265341424269
25647,529218.95,5353230.955,163,93,70,46.79,2,2010,2,101,308,234,0.82941396719702,87.4,18.4241758241758,133,904.713452995436,1.16265341424269
25647,529218.95,5353230.955,86,71,15,59.124,3,2011,1,72,320,160,0.864717521123333,129,17.5824175824176,88,904.713452995436,1.16265341424269
25647,529218.95,5353230.955,145,83,62,60.476,4,2012,3,89,313,216,0.848974555983728,29,18.7703296703297,127,904.713452995436,1.16265341424269
25647,529218.95,5353230.955,170,66,104,48.502,0,2013,2,107,322,176,0.858422220695333,-172.4,19.2857142857143,69,904.713452995436,1.16265341424269
25647,529218.95,5353230.955,0,0,0,78.757,0,2014,0,57,323,233,0.83623027693038,91.5,17.9450549450549,176,904.713452995436,1.16265341424269
25647,529218.95,5353230.955,136,94,42,72.158,5,2015,1,77,332,153,0.859184274391697,-197.8,21,76,904.713452995436,1.16265341424269
25647,529218.95,5353230.955,140,98,42,71.945,6,2016,1,84,335,153,0.856420950238736,-13,19.132967032967,69,904.713452995436,1.16265341424269
25647,529218.95,5353230.955,117,97,20,75.587,6,2017,2,68,307,218,0.853141917089094,-57.8,20.1032967032967,150,904.713452995436,1.16265341424269
25647,529218.95,5353230.955,158,80,78,49.79,0,2018,2,97,324,137,0.836057131712427,-125.4,20.7956043956044,40,904.713452995436,1.16265341424269
25647,529218.95,5353230.955,122,94,28,74.849,14,2019,2,74,328,218,0.83515351629715,-108.1,20.8824175824176,144,904.713452995436,1.16265341424269
25647,529218.95,5353230.955,0,0,0,79.35,0,2020,0,57,320,233,0.830170669447031,-97.4,19.156043956044,176,904.713452995436,1.16265341424269
25718,529218.95,5336783.354,0,0,0,152.557,0,2001,1,18,292,185,0.883720065902881,-14.2,19.5065934065934,167,1073.53338104034,0.0288792123786043
25718,529218.95,5336783.354,133,74,59,51.436,1,2002,3,96,327,241,0.833275053455429,3,19.4725274725275,145,1073.53338104034,0.0288792123786043
25718,529218.95,5336783.354,153,97,56,40.421,1,2003,1,103,337,154,0.810784253359509,-209,24.2648351648352,51,1073.53338104034,0.0288792123786043
25718,529218.95,5336783.354,152,93,59,46.838,0,2004,1,102,336,169,0.839554403180797,104,19.0769230769231,67,1073.53338104034,0.0288792123786043
25718,529218.95,5336783.354,0,0,0,135.837,0,2005,0,26,315,162,0.833369173689788,-49.6,19.2098901098901,136,1073.53338104034,0.0288792123786043
25718,529218.95,5336783.354,185,67,118,47.582,0,2006,3,105,341,225,0.882168354098337,25.1,20.1736263736264,120,1073.53338104034,0.0288792123786043
25718,529218.95,5336783.354,0,0,0,92.222,0,2007,0,55,321,184,0.824881686791739,229.8,18.3494505494505,129,1073.53338104034,0.0288792123786043
25718,529218.95,5336783.354,86,85,1,27.013,0,2008,1,120,313,178,0.848499756558964,8.90000000000001,18.8,58,1073.53338104034,0.0288792123786043
25718,529218.95,5336783.354,169,109,60,40.816,0,2009,1,101,324,169,0.873578292726771,9.4,19.7494505494506,68,1073.53338104034,0.0288792123786043
25718,529218.95,5336783.354,163,93,70,35.777,0,2010,2,109,316,210,0.816959277302691,64.4,19.4725274725275,101,1073.53338104034,0.0288792123786043
25718,529218.95,5336783.354,86,70,16,71.845,12,2011,1,55,343,217,0.785980020505182,103.5,18.7505494505494,162,1073.53338104034,0.0288792123786043
25718,529218.95,5336783.354,127,99,28,58.925,4,2012,1,91,325,162,0.828995889407135,3.2,20.1307692307692,71,1073.53338104034,0.0288792123786043
25718,529218.95,5336783.354,170,93,77,45.704,0,2013,1,109,306,170,0.850117299348962,-190.8,20.5692307692308,61,1073.53338104034,0.0288792123786043
25718,529218.95,5336783.354,93,61,32,58.016,3,2014,3,77,355,328,0.927631057188729,65.4,19.2153846153846,251,1073.53338104034,0.0288792123786043
25718,529218.95,5336783.354,152,104,48,52.267,1,2015,1,97,348,161,0.843403684844335,-212.4,22.3164835164835,64,1073.53338104034,0.0288792123786043
25718,529218.95,5336783.354,162,96,66,63.64,4,2016,1,93,339,169,0.81393038139738,-31.9,20.4131868131868,76,1073.53338104034,0.0288792123786043
25718,529218.95,5336783.354,0,0,0,50.01,0,2017,0,91,321,162,0.810637356159063,-70.8,21.2648351648352,71,1073.53338104034,0.0288792123786043
25718,529218.95,5336783.354,86,78,8,118.275,37,2018,1,34,317,178,0.743849098697636,-135.7,21.9263736263736,144,1073.53338104034,0.0288792123786043
25718,529218.95,5336783.354,142,80,62,48.37,4,2019,2,100,328,153,0.787294994459721,-112.7,22.0065934065934,53,1073.53338104034,0.0288792123786043
25718,529218.95,5336783.354,0,0,0,121.236,0,2020,0,22,319,177,0.797034402063164,-111.3,20.3164835164835,155,1073.53338104034,0.0288792123786043
25719,529218.95,5336551.697,0,0,0,140.321,0,2001,2,29,299,178,0.86185941952131,-14.2,19.5065934065934,149,1128.2984195173,-1.49678325724208
25719,529218.95,5336551.697,134,77,57,44.567,0,2002,2,104,321,178,0.83895897578779,3,19.4725274725275,74,1128.2984195173,-1.49678325724208
25719,529218.95,5336551.697,156,118,38,37.023,1,2003,1,107,323,161,0.805649370134964,-209,24.2648351648352,54,1128.2984195173,-1.49678325724208
25719,529218.95,5336551.697,151,93,58,46.838,0,2004,1,102,308,170,0.84783200833641,104,19.0769230769231,68,1128.2984195173,-1.49678325724208
25719,529218.95,5336551.697,0,0,0,63.307,0,2005,0,92,308,161,0.830182341212441,-49.6,19.2098901098901,69,1128.2984195173,-1.49678325724208
25719,529218.95,5336551.697,186,64,122,47.582,0,2006,3,105,339,224,0.902549002992401,25.1,20.1736263736264,119,1128.2984195173,-1.49678325724208
25719,529218.95,5336551.697,0,0,0,75.602,0,2007,0,68,302,177,0.807828906088762,229.8,18.3494505494505,109,1128.2984195173,-1.49678325724208
25719,529218.95,5336551.697,86,79,7,21.062,0,2008,1,126,304,185,0.842266979093838,8.90000000000001,18.8,59,1128.2984195173,-1.49678325724208
25719,529218.95,5336551.697,167,93,74,39.905,0,2009,1,102,312,168,0.858198692451004,9.4,19.7494505494506,66,1128.2984195173,-1.49678325724208
25719,529218.95,5336551.697,165,109,56,29.89,0,2010,2,116,312,202,0.800527452484355,64.4,19.4725274725275,86,1128.2984195173,-1.49678325724208
25719,529218.95,5336551.697,86,69,17,41.246,0,2011,1,89,336,217,0.774031279519319,103.5,18.7505494505494,128,1128.2984195173,-1.49678325724208
25719,529218.95,5336551.697,128,93,35,46.564,1,2012,1,107,323,168,0.83299018295515,3.2,20.1307692307692,61,1128.2984195173,-1.49678325724208
25719,529218.95,5336551.697,169,93,76,43.661,0,2013,1,111,293,176,0.852465974703548,-190.8,20.5692307692308,65,1128.2984195173,-1.49678325724208
25719,529218.95,5336551.697,77,54,23,48.678,0,2014,1,88,349,185,0.844573512177945,65.4,19.2153846153846,97,1128.2984195173,-1.49678325724208
25719,529218.95,5336551.697,152,104,48,44.933,0,2015,1,104,313,168,0.829176637396113,-212.4,22.3164835164835,64,1128.2984195173,-1.49678325724208
25719,529218.95,5336551.697,161,94,67,56.453,4,2016,1,100,336,177,0.850251518671689,-31.9,20.4131868131868,77,1128.2984195173,-1.49678325724208
25719,529218.95,5336551.697,104,97,7,45.579,5,2017,1,96,317,170,0.814741948503699,-70.8,21.2648351648352,74,1128.2984195173,-1.49678325724208
25719,529218.95,5336551.697,85,77,8,115.899,35,2018,1,36,308,192,0.77722543199292,-135.7,21.9263736263736,156,1128.2984195173,-1.49678325724208
25719,529218.95,5336551.697,143,78,65,42.477,2,2019,2,106,328,161,0.781283237246771,-112.7,22.0065934065934,55,1128.2984195173,-1.49678325724208
25719,529218.95,5336551.697,0,0,0,87.981,0,2020,0,50,318,185,0.817999695328844,-111.3,20.3164835164835,135,1128.2984195173,-1.49678325724208
25720,529218.95,5336320.041,0,0,0,62.708,0,2001,1,93,297,177,0.870294547806019,-14.2,19.5065934065934,84,1137.379136655,-0.0514186935839241
25720,529218.95,5336320.041,86,62,24,37.568,0,2002,1,112,315,170,0.816387505211678,3,19.4725274725275,58,1137.379136655,-0.0514186935839241
25720,529218.95,5336320.041,145,94,51,40.421,1,2003,1,103,278,152,0.781289839813062,-209,24.2648351648352,49,1137.379136655,-0.0514186935839241
25720,529218.95,5336320.041,143,93,50,43.67,0,2004,1,105,328,170,0.83509011471121,104,19.0769230769231,65,1137.379136655,-0.0514186935839241
25720,529218.95,5336320.041,156,107,49,58.417,2,2005,1,97,310,161,0.838350130520459,-49.6,19.2098901098901,64,1137.379136655,-0.0514186935839241
25720,529218.95,5336320.041,183,65,118,61.319,5,2006,2,94,340,160,0.827248854249579,25.1,20.1736263736264,66,1137.379136655,-0.0514186935839241
25720,529218.95,5336320.041,0,0,0,79.276,0,2007,0,65,297,194,0.771107757708984,229.8,18.3494505494505,129,1137.379136655,-0.0514186935839241
25720,529218.95,5336320.041,93,93,0,25.972,0,2008,1,121,306,170,0.864877693899656,8.90000000000001,18.8,49,1137.379136655,-0.0514186935839241
25720,529218.95,5336320.041,156,67,89,34.72,0,2009,2,108,299,169,0.838559785860413,9.4,19.7494505494506,61,1137.379136655,-0.0514186935839241
25720,529218.95,5336320.041,168,110,58,29.89,0,2010,1,116,306,184,0.820109631846407,64.4,19.4725274725275,68,1137.379136655,-0.0514186935839241
25720,529218.95,5336320.041,85,81,4,41.246,0,2011,1,89,337,224,0.770805605454465,103.5,18.7505494505494,135,1137.379136655,-0.0514186935839241
25720,529218.95,5336320.041,127,97,30,53.563,3,2012,1,98,303,168,0.834207196904739,3.2,20.1307692307692,70,1137.379136655,-0.0514186935839241
25720,529218.95,5336320.041,0,0,0,42.653,0,2013,0,112,301,169,0.844079067020842,-190.8,20.5692307692308,57,1137.379136655,-0.0514186935839241
25720,529218.95,5336320.041,0,0,0,53.851,0,2014,0,82,338,169,0.830131211135824,65.4,19.2153846153846,87,1137.379136655,-0.0514186935839241
25720,529218.95,5336320.041,0,0,0,47.919,0,2015,0,101,331,161,0.807467472597851,-212.4,22.3164835164835,60,1137.379136655,-0.0514186935839241
25720,529218.95,5336320.041,165,118,47,57.488,4,2016,1,99,316,169,0.826567865424898,-31.9,20.4131868131868,70,1137.379136655,-0.0514186935839241
25720,529218.95,5336320.041,126,93,33,36.341,5,2017,1,108,308,170,0.802800556407671,-70.8,21.2648351648352,62,1137.379136655,-0.0514186935839241
25720,529218.95,5336320.041,157,74,83,119.499,12,2018,2,33,302,162,0.815357135947959,-135.7,21.9263736263736,129,1137.379136655,-0.0514186935839241
25720,529218.95,5336320.041,130,77,53,41.524,2,2019,2,107,339,161,0.775290487108912,-112.7,22.0065934065934,54,1137.379136655,-0.0514186935839241
25720,529218.95,5336320.041,0,0,0,47.708,0,2020,0,84,317,184,0.822218033574182,-111.3,20.3164835164835,100,1137.379136655,-0.0514186935839241
25721,529218.95,5336088.384,0,0,0,73.836,0,2001,1,84,319,170,0.870221007745053,-14.2,19.5065934065934,86,1068.93356577546,1.46012674893193
25721,529218.95,5336088.384,86,66,20,42.806,0,2002,1,106,319,241,0.847006354962118,3,19.4725274725275,135,1068.93356577546,1.46012674893193
25721,529218.95,5336088.384,144,94,50,46.751,6,2003,1,96,315,152,0.804465104907075,-209,24.2648351648352,56,1068.93356577546,1.46012674893193
25721,529218.95,5336088.384,146,97,49,49.052,0,2004,1,100,334,168,0.835590752605856,104,19.0769230769231,68,1068.93356577546,1.46012674893193
25721,529218.95,5336088.384,155,108,47,69.684,2,2005,1,86,310,153,0.848719473041678,-49.6,19.2098901098901,67,1068.93356577546,1.46012674893193
25721,529218.95,5336088.384,186,63,123,51.23,0,2006,2,102,346,161,0.830076363313532,25.1,20.1736263736264,59,1068.93356577546,1.46012674893193
25721,529218.95,5336088.384,0,0,0,75.602,0,2007,0,68,299,193,0.778193619970633,229.8,18.3494505494505,125,1068.93356577546,1.46012674893193
25721,529218.95,5336088.384,0,0,0,24.951,0,2008,0,122,314,217,0.833931914576136,8.90000000000001,18.8,95,1068.93356577546,1.46012674893193
25721,529218.95,5336088.384,154,69,85,43.681,0,2009,2,98,300,154,0.837767684064269,9.4,19.7494505494506,56,1068.93356577546,1.46012674893193
25721,529218.95,5336088.384,168,111,57,35.777,0,2010,1,109,312,169,0.804966054788115,64.4,19.4725274725275,60,1068.93356577546,1.46012674893193
25721,529218.95,5336088.384,0,0,0,48.044,0,2011,0,81,339,233,0.771636367361322,103.5,18.7505494505494,152,1068.93356577546,1.46012674893193
25721,529218.95,5336088.384,127,97,30,56.626,3,2012,1,94,308,168,0.839941630005941,3.2,20.1307692307692,74,1068.93356577546,1.46012674893193
25721,529218.95,5336088.384,0,0,0,47.834,0,2013,0,107,313,162,0.858734555581679,-190.8,20.5692307692308,55,1068.93356577546,1.46012674893193
25721,529218.95,5336088.384,0,0,0,74.714,0,2014,0,60,340,160,0.81833816137804,65.4,19.2153846153846,100,1068.93356577546,1.46012674893193
25721,529218.95,5336088.384,93,93,0,54.636,3,2015,1,95,337,153,0.80894144186433,-212.4,22.3164835164835,58,1068.93356577546,1.46012674893193
25721,529218.95,5336088.384,160,94,66,68.696,4,2016,1,88,303,161,0.828408809059033,-31.9,20.4131868131868,73,1068.93356577546,1.46012674893193
25721,529218.95,5336088.384,125,93,32,37.093,5,2017,1,107,309,169,0.774323663851797,-70.8,21.2648351648352,62,1068.93356577546,1.46012674893193
25721,529218.95,5336088.384,152,73,79,127.931,19,2018,2,26,306,169,0.823270057511949,-135.7,21.9263736263736,143,1068.93356577546,1.46012674893193
25721,529218.95,5336088.384,130,77,53,52.242,4,2019,2,96,341,161,0.804999363539694,-112.7,22.0065934065934,65,1068.93356577546,1.46012674893193
25721,529218.95,5336088.384,0,0,0,44.874,0,2020,0,87,319,177,0.815712530055023,-111.3,20.3164835164835,90,1068.93356577546,1.46012674893193
25722,529218.95,5335856.728,0,0,0,137.949,0,2001,1,31,328,162,0.867534838235744,-14.2,19.5065934065934,131,1004.50718530722,1.05762884263078
25722,529218.95,5335856.728,86,80,6,54.257,1,2002,1,93,343,169,0.842290233248616,3,19.4725274725275,76,1004.50718530722,1.05762884263078
25722,529218.95,5335856.728,148,93,55,55.649,9,2003,1,86,331,146,0.803466423897436,-209,24.2648351648352,60,1004.50718530722,1.05762884263078
25722,529218.95,5335856.728,127,93,34,61.327,1,2004,2,88,326,170,0.871207953634565,104,19.0769230769231,82,1004.50718530722,1.05762884263078
25722,529218.95,5335856.728,140,93,47,78.309,2,2005,2,78,313,154,0.861202711500212,-49.6,19.2098901098901,76,1004.50718530722,1.05762884263078
25722,529218.95,5335856.728,192,93,99,28.392,0,2006,1,124,345,168,0.849443857297894,25.1,20.1736263736264,44,1004.50718530722,1.05762884263078
25722,529218.95,5335856.728,0,0,0,84.831,0,2007,0,61,317,154,0.844989173776014,229.8,18.3494505494505,93,1004.50718530722,1.05762884263078
25722,529218.95,5335856.728,0,0,0,34.991,0,2008,0,113,311,232,0.88439631629509,8.90000000000001,18.8,119,1004.50718530722,1.05762884263078
25722,529218.95,5335856.728,150,62,88,41.748,0,2009,2,100,331,153,0.849939069441091,9.4,19.7494505494506,53,1004.50718530722,1.05762884263078
25722,529218.95,5335856.728,161,94,67,40.532,0,2010,1,104,310,168,0.854212893515061,64.4,19.4725274725275,64,1004.50718530722,1.05762884263078
25722,529218.95,5335856.728,84,66,18,68.956,11,2011,1,58,340,169,0.818511013952832,103.5,18.7505494505494,111,1004.50718530722,1.05762884263078
25722,529218.95,5335856.728,126,93,33,58.925,4,2012,1,91,318,161,0.860838999957003,3.2,20.1307692307692,70,1004.50718530722,1.05762884263078
25722,529218.95,5335856.728,170,93,77,44.677,0,2013,1,110,317,176,0.838397292641217,-190.8,20.5692307692308,66,1004.50718530722,1.05762884263078
25722,529218.95,5335856.728,0,0,0,81.388,0,2014,0,54,344,208,0.833483071955455,65.4,19.2153846153846,154,1004.50718530722,1.05762884263078
25722,529218.95,5335856.728,0,0,0,63.473,0,2015,0,87,345,153,0.837964488424492,-212.4,22.3164835164835,66,1004.50718530722,1.05762884263078
25722,529218.95,5335856.728,153,94,59,76.276,6,2016,1,80,334,170,0.817431108917458,-31.9,20.4131868131868,90,1004.50718530722,1.05762884263078
25722,529218.95,5335856.728,0,0,0,52.855,0,2017,0,88,316,170,0.838436621291547,-70.8,21.2648351648352,82,1004.50718530722,1.05762884263078
25722,529218.95,5335856.728,160,78,82,51.946,0,2018,3,94,340,169,0.887066935268648,-135.7,21.9263736263736,75,1004.50718530722,1.05762884263078
25722,529218.95,5335856.728,132,93,39,63.826,6,2019,1,84,340,161,0.838163898353615,-112.7,22.0065934065934,77,1004.50718530722,1.05762884263078
25722,529218.95,5335856.728,0,0,0,73.581,0,2020,0,62,319,170,0.849490726945114,-111.3,20.3164835164835,108,1004.50718530722,1.05762884263078
25727,529218.95,5334698.446,0,0,0,136.799,0,2001,1,32,315,177,0.857937804166822,-14.2,19.5065934065934,145,1219.57584602651,-1.31897447105752
25727,529218.95,5334698.446,118,77,41,41.929,0,2002,3,107,301,241,0.847552736592868,3,19.4725274725275,134,1219.57584602651,-1.31897447105752
25727,529218.95,5334698.446,157,93,64,35.448,1,2003,1,109,298,161,0.803196851465583,-209,24.2648351648352,52,1219.57584602651,-1.31897447105752
25727,529218.95,5334698.446,151,55,96,37.796,0,2004,3,111,332,250,0.850582843777469,104,19.0769230769231,139,1219.57584602651,-1.31897447105752
25727,529218.95,5334698.446,0,0,0,76.135,0,2005,0,80,316,170,0.854413141210276,-49.6,19.2098901098901,90,1219.57584602651,-1.31897447105752
25727,529218.95,5334698.446,184,66,118,42.98,0,2006,2,109,339,177,0.825897895953708,25.1,20.1736263736264,68,1219.57584602651,-1.31897447105752
25727,529218.95,5334698.446,0,0,0,57.065,0,2007,0,85,300,177,0.844476007627303,229.8,18.3494505494505,92,1219.57584602651,-1.31897447105752
25727,529218.95,5334698.446,86,86,0,33.811,0,2008,1,114,310,170,0.85359096014342,8.90000000000001,18.8,56,1219.57584602651,-1.31897447105752
25727,529218.95,5334698.446,161,64,97,31.227,0,2009,2,112,308,146,0.784590103250449,9.4,19.7494505494506,34,1219.57584602651,-1.31897447105752
25727,529218.95,5334698.446,161,100,61,32.305,0,2010,1,113,293,185,0.83179753159147,64.4,19.4725274725275,72,1219.57584602651,-1.31897447105752
25727,529218.95,5334698.446,121,60,61,46.325,0,2011,2,83,349,168,0.838585268566824,103.5,18.7505494505494,85,1219.57584602651,-1.31897447105752
25727,529218.95,5334698.446,145,93,52,48.963,1,2012,1,104,314,169,0.878741704385734,3.2,20.1307692307692,65,1219.57584602651,-1.31897447105752
25727,529218.95,5334698.446,171,64,107,41.66,0,2013,2,113,310,169,0.827690305339361,-190.8,20.5692307692308,56,1219.57584602651,-1.31897447105752
25727,529218.95,5334698.446,154,58,96,43.138,0,2014,3,95,317,192,0.842816367682746,65.4,19.2153846153846,97,1219.57584602651,-1.31897447105752
25727,529218.95,5334698.446,152,93,59,40.349,0,2015,1,109,323,145,0.780771589079545,-212.4,22.3164835164835,36,1219.57584602651,-1.31897447105752
25727,529218.95,5334698.446,155,86,69,66.735,4,2016,3,90,337,193,0.848499049627532,-31.9,20.4131868131868,103,1219.57584602651,-1.31897447105752
25727,529218.95,5334698.446,0,0,0,47.311,0,2017,0,94,306,177,0.844975832695938,-70.8,21.2648351648352,83,1219.57584602651,-1.31897447105752
25727,529218.95,5334698.446,165,66,99,46.395,0,2018,2,99,325,170,0.859478918320165,-135.7,21.9263736263736,71,1219.57584602651,-1.31897447105752
25727,529218.95,5334698.446,162,93,69,38.672,2,2019,1,110,339,169,0.820599975473459,-112.7,22.0065934065934,59,1219.57584602651,-1.31897447105752
25727,529218.95,5334698.446,0,0,0,40.37,0,2020,0,92,319,178,0.824095062054189,-111.3,20.3164835164835,86,1219.57584602651,-1.31897447105752
25729,529218.95,5334235.134,0,0,0,148.389,0,2001,0,22,325,186,0.809093735692786,-14.2,19.5065934065934,164,1168.8349480001,1.50263238386304
25729,529218.95,5334235.134,86,83,3,32.499,0,2002,1,118,309,241,0.776541017295155,3,19.4725274725275,123,1168.8349480001,1.50263238386304
25729,529218.95,5334235.134,155,97,58,42.204,2,2003,1,101,328,161,0.75043967359445,-209,24.2648351648352,60,1168.8349480001,1.50263238386304
25729,529218.95,5334235.134,148,76,72,40.691,0,2004,3,108,337,241,0.818372230584216,104,19.0769230769231,133,1168.8349480001,1.50263238386304
25729,529218.95,5334235.134,143,123,20,81.59,2,2005,2,75,311,224,0.807688729537789,-49.6,19.2098901098901,149,1168.8349480001,1.50263238386304
25729,529218.95,5334235.134,181,63,118,52.496,1,2006,2,101,347,177,0.766058939324516,25.1,20.1736263736264,76,1168.8349480001,1.50263238386304
25729,529218.95,5334235.134,0,0,0,100.103,0,2007,0,48,321,186,0.807192414220789,229.8,18.3494505494505,138,1168.8349480001,1.50263238386304
25729,529218.95,5334235.134,0,0,0,118.44,0,2008,0,38,315,224,0.838346346782415,8.90000000000001,18.8,186,1168.8349480001,1.50263238386304
25729,529218.95,5334235.134,165,72,93,39.011,0,2009,2,103,325,153,0.799520424260285,9.4,19.7494505494506,50,1168.8349480001,1.50263238386304
25729,529218.95,5334235.134,162,101,61,39.552,0,2010,2,105,296,232,0.787056323204493,64.4,19.4725274725275,127,1168.8349480001,1.50263238386304
25729,529218.95,5334235.134,86,59,27,95.583,23,2011,1,31,341,168,0.787869753546491,103.5,18.7505494505494,137,1168.8349480001,1.50263238386304
25729,529218.95,5334235.134,0,0,0,55.104,0,2012,0,96,316,169,0.838617289934278,3.2,20.1307692307692,73,1168.8349480001,1.50263238386304
25729,529218.95,5334235.134,170,70,100,19.186,0,2013,3,135,319,200,0.786970985529176,-190.8,20.5692307692308,65,1168.8349480001,1.50263238386304
25729,529218.95,5334235.134,0,0,0,47.032,0,2014,0,90,345,234,0.817381991256496,65.4,19.2153846153846,144,1168.8349480001,1.50263238386304
25729,529218.95,5334235.134,144,94,50,69.551,4,2015,1,80,347,169,0.778933340835975,-212.4,22.3164835164835,89,1168.8349480001,1.50263238386304
25729,529218.95,5334235.134,157,93,64,62.629,4,2016,2,94,342,202,0.802760852451858,-31.9,20.4131868131868,108,1168.8349480001,1.50263238386304
25729,529218.95,5334235.134,106,93,13,91.059,8,2017,2,55,315,201,0.791777840867091,-70.8,21.2648351648352,146,1168.8349480001,1.50263238386304
25729,529218.95,5334235.134,86,74,12,81.326,9,2018,1,68,328,193,0.772522431686273,-135.7,21.9263736263736,125,1168.8349480001,1.50263238386304
25729,529218.95,5334235.134,134,99,35,73.35,9,2019,2,76,332,298,0.777663800977411,-112.7,22.0065934065934,222,1168.8349480001,1.50263238386304
25729,529218.95,5334235.134,86,76,10,121.236,25,2020,1,22,324,193,0.750211806080472,-111.3,20.3164835164835,171,1168.8349480001,1.50263238386304
25730,529218.95,5334003.477,0,0,0,135.482,0,2001,1,31,330,177,0.842035988126922,10.6,17.710989010989,146,1105.1293313665,-0.031328004956688
25730,529218.95,5334003.477,94,93,1,29.976,0,2002,1,121,342,178,0.832226260227787,25.6,17.9494505494505,57,1105.1293313665,-0.031328004956688
25730,529218.95,5334003.477,147,101,46,44.047,1,2003,1,102,316,169,0.796671246975323,-201.3,22.6626373626374,67,1105.1293313665,-0.031328004956688
25730,529218.95,5334003.477,136,95,41,39.907,0,2004,2,110,334,185,0.822046568503963,132.4,17.5076923076923,75,1105.1293313665,-0.031328004956688
25730,529218.95,5334003.477,136,93,43,64.103,2,2005,3,92,312,184,0.81001805209944,-23.3,17.6,92,1105.1293313665,-0.031328004956688
25730,529218.95,5334003.477,175,82,93,39.623,2,2006,3,115,343,184,0.783160733894776,50,18.6131868131868,69,1105.1293313665,-0.031328004956688
25730,529218.95,5334003.477,0,0,0,89.392,0,2007,0,57,305,185,0.818492112274765,269.6,16.9021978021978,128,1105.1293313665,-0.031328004956688
25730,529218.95,5334003.477,0,0,0,25.916,0,2008,0,121,308,169,0.832470909758878,38,17.3098901098901,48,1105.1293313665,-0.031328004956688
25730,529218.95,5334003.477,156,60,96,51.112,0,2009,2,97,314,177,0.860719487561598,34.6,18.2571428571429,80,1105.1293313665,-0.031328004956688
25730,529218.95,5334003.477,155,97,58,39.01,0,2010,1,110,316,184,0.820353487233087,95.1,17.9945054945055,74,1105.1293313665,-0.031328004956688
25730,529218.95,5334003.477,0,0,0,108.689,0,2011,0,27,335,217,0.812274764550819,139.3,17.1164835164835,190,1105.1293313665,-0.031328004956688
25730,529218.95,5334003.477,93,93,0,52.714,3,2012,1,100,299,177,0.822810833385974,38.5,18.2296703296703,77,1105.1293313665,-0.031328004956688
25730,529218.95,5334003.477,174,59,115,40.805,1,2013,3,115,324,184,0.794365248726696,-164.8,18.7813186813187,69,1105.1293313665,-0.031328004956688
25730,529218.95,5334003.477,128,93,35,51.207,3,2014,2,88,343,145,0.750009370656677,101.8,17.4461538461538,57,1105.1293313665,-0.031328004956688
25730,529218.95,5334003.477,0,0,0,58.119,0,2015,0,92,333,161,0.793629982819485,-192.4,20.4978021978022,69,1105.1293313665,-0.031328004956688
25730,529218.95,5334003.477,150,95,55,63.906,5,2016,1,93,327,178,0.824557380169866,-4.8,18.6318681318681,85,1105.1293313665,-0.031328004956688
25730,529218.95,5334003.477,114,95,19,47.157,7,2017,2,96,316,208,0.795694777186335,-54.4,19.6516483516484,112,1105.1293313665,-0.031328004956688
25730,529218.95,5334003.477,0,0,0,58.59,0,2018,0,91,316,201,0.84571236078235,-121.8,20.367032967033,110,1105.1293313665,-0.031328004956688
25730,529218.95,5334003.477,141,98,43,42.533,3,2019,1,106,342,178,0.794535239987173,-107,20.478021978022,72,1105.1293313665,-0.031328004956688
25730,529218.95,5334003.477,0,0,0,43.711,0,2020,0,91,314,186,0.793152523201324,-91.9,18.7142857142857,95,1105.1293313665,-0.031328004956688
25752,529218.95,5328907.037,0,0,0,137.719,0,2001,1,29,331,193,0.874711853191471,10.6,17.710989010989,164,990.401732488814,1.13419265469049
25752,529218.95,5328907.037,86,76,10,87.241,11,2002,1,67,339,178,0.851782299967008,25.6,17.9494505494505,111,990.401732488814,1.13419265469049
25752,529218.95,5328907.037,0,0,0,51.198,0,2003,0,95,337,169,0.829742871643798,-201.3,22.6626373626374,74,990.401732488814,1.13419265469049
25752,529218.95,5328907.037,144,93,51,44.129,0,2004,2,106,335,225,0.850044681153559,132.4,17.5076923076923,119,990.401732488814,1.13419265469049
25752,529218.95,5328907.037,0,0,0,77.946,0,2005,0,80,306,210,0.873199934013274,-23.3,17.6,130,990.401732488814,1.13419265469049
25752,529218.95,5328907.037,172,68,104,56.282,3,2006,2,102,343,169,0.855221952250526,50,18.6131868131868,67,990.401732488814,1.13419265469049
25752,529218.95,5328907.037,0,0,0,87.057,0,2007,0,59,302,226,0.855063969273074,269.6,16.9021978021978,167,990.401732488814,1.13419265469049
25752,529218.95,5328907.037,86,72,14,55.954,5,2008,1,95,306,232,0.908835111196108,38,17.3098901098901,137,990.401732488814,1.13419265469049
25752,529218.95,5328907.037,135,93,42,42.89,0,2009,1,104,295,169,0.900007479398928,34.6,18.2571428571429,65,990.401732488814,1.13419265469049
25752,529218.95,5328907.037,141,93,48,42.316,0,2010,1,107,308,169,0.881344409084291,95.1,17.9945054945055,62,990.401732488814,1.13419265469049
25752,529218.95,5328907.037,83,69,14,97.701,21,2011,1,37,329,225,0.838688188259638,139.3,17.1164835164835,188,990.401732488814,1.13419265469049
25752,529218.95,5328907.037,86,79,7,55.239,4,2012,1,97,308,169,0.892413239890139,38.5,18.2296703296703,72,990.401732488814,1.13419265469049
25752,529218.95,5328907.037,165,67,98,43.051,1,2013,2,113,316,178,0.877610689080443,-164.8,18.7813186813187,65,990.401732488814,1.13419265469049
25752,529218.95,5328907.037,129,94,35,55.761,7,2014,2,83,319,194,0.858768238775496,101.8,17.4461538461538,111,990.401732488814,1.13419265469049
25752,529218.95,5328907.037,0,0,0,59.302,0,2015,0,91,344,184,0.829467806048089,-192.4,20.4978021978022,93,990.401732488814,1.13419265469049
25752,529218.95,5328907.037,0,0,0,66.149,0,2016,0,91,343,176,0.889547038325919,-4.8,18.6318681318681,85,990.401732488814,1.13419265469049
25752,529218.95,5328907.037,0,0,0,67.049,0,2017,0,77,327,170,0.849724926630949,-54.4,19.6516483516484,93,990.401732488814,1.13419265469049
25752,529218.95,5328907.037,0,0,0,142.984,0,2018,0,15,326,154,0.888043177241884,-121.8,20.367032967033,139,990.401732488814,1.13419265469049
25752,529218.95,5328907.037,0,0,0,55.299,0,2019,0,93,341,169,0.840284137957907,-107,20.478021978022,76,990.401732488814,1.13419265469049
25752,529218.95,5328907.037,0,0,0,95.954,0,2020,0,45,326,178,0.828970209130271,-91.9,18.7142857142857,133,990.401732488814,1.13419265469049
25753,529218.95,5328675.381,0,0,0,54.123,0,2001,1,100,301,201,0.882627145363975,10.6,17.710989010989,101,1064.03455802842,0.859049713712242
25753,529218.95,5328675.381,93,68,25,47.632,1,2002,2,102,304,177,0.856795744282698,25.6,17.9494505494505,75,1064.03455802842,0.859049713712242
25753,529218.95,5328675.381,0,0,0,33.887,0,2003,0,113,306,170,0.848475383012905,-201.3,22.6626373626374,57,1064.03455802842,0.859049713712242
25753,529218.95,5328675.381,150,93,57,30.971,0,2004,2,119,325,218,0.849674392863489,132.4,17.5076923076923,99,1064.03455802842,0.859049713712242
25753,529218.95,5328675.381,0,0,0,49.172,0,2005,0,105,300,169,0.883956958005317,-23.3,17.6,64,1064.03455802842,0.859049713712242
25753,529218.95,5328675.381,177,67,110,38.448,2,2006,2,116,336,170,0.873798960573666,50,18.6131868131868,54,1064.03455802842,0.859049713712242
25753,529218.95,5328675.381,0,0,0,47.966,0,2007,0,94,295,209,0.832285428506422,269.6,16.9021978021978,115,1064.03455802842,0.859049713712242
25753,529218.95,5328675.381,86,71,15,26.938,0,2008,1,120,296,224,0.901248373620562,38,17.3098901098901,104,1064.03455802842,0.859049713712242
25753,529218.95,5328675.381,143,93,50,41.78,0,2009,1,105,297,161,0.904487988344752,34.6,18.2571428571429,56,1064.03455802842,0.859049713712242
25753,529218.95,5328675.381,144,106,38,32.946,0,2010,1,116,305,184,0.882224595138311,95.1,17.9945054945055,68,1064.03455802842,0.859049713712242
25753,529218.95,5328675.381,106,68,38,40.024,0,2011,3,94,323,234,0.841415487123247,139.3,17.1164835164835,140,1064.03455802842,0.859049713712242
25753,529218.95,5328675.381,93,78,15,48.485,2,2012,2,105,300,169,0.889167810710912,38.5,18.2296703296703,64,1064.03455802842,0.859049713712242
25753,529218.95,5328675.381,176,68,108,29.446,1,2013,2,125,310,184,0.888110694673677,-164.8,18.7813186813187,59,1064.03455802842,0.859049713712242
25753,529218.95,5328675.381,141,98,43,45.374,3,2014,1,95,317,178,0.867561135808569,101.8,17.4461538461538,83,1064.03455802842,0.859049713712242
25753,529218.95,5328675.381,0,0,0,41.916,0,2015,0,107,335,168,0.88201378982258,-192.4,20.4978021978022,61,1064.03455802842,0.859049713712242
25753,529218.95,5328675.381,156,97,59,38.512,4,2016,1,116,331,186,0.897071601098781,-4.8,18.6318681318681,70,1064.03455802842,0.859049713712242
25753,529218.95,5328675.381,0,0,0,35.924,0,2017,0,110,306,217,0.884876101525178,-54.4,19.6516483516484,107,1064.03455802842,0.859049713712242
25753,529218.95,5328675.381,86,76,10,44.452,0,2018,1,103,300,160,0.891544229919665,-121.8,20.367032967033,57,1064.03455802842,0.859049713712242
25753,529218.95,5328675.381,83,75,8,34.361,3,2019,1,115,332,177,0.875404141423195,-107,20.478021978022,62,1064.03455802842,0.859049713712242
25753,529218.95,5328675.381,0,0,0,47.406,0,2020,0,87,299,177,0.842235976353957,-91.9,18.7142857142857,90,1064.03455802842,0.859049713712242
25754,529218.95,5328443.725,0,0,0,54.123,0,2001,1,100,302,193,0.887445511948097,10.6,17.710989010989,93,1124.46954265929,-0.373924054826732
25754,529218.95,5328443.725,136,86,50,34.584,0,2002,3,116,298,193,0.862070999402775,25.6,17.9494505494505,77,1124.46954265929,-0.373924054826732
25754,529218.95,5328443.725,154,93,61,30.321,0,2003,1,117,295,170,0.864031992167428,-201.3,22.6626373626374,53,1124.46954265929,-0.373924054826732
25754,529218.95,5328443.725,159,96,63,28.26,0,2004,1,122,297,185,0.86166098476133,132.4,17.5076923076923,63,1124.46954265929,-0.373924054826732
25754,529218.95,5328443.725,152,96,56,47.038,0,2005,1,107,302,176,0.888971943612998,-23.3,17.6,69,1124.46954265929,-0.373924054826732
25754,529218.95,5328443.725,194,67,127,30.589,1,2006,2,123,333,170,0.874365415897439,50,18.6131868131868,47,1124.46954265929,-0.373924054826732
25754,529218.95,5328443.725,93,93,0,66.818,10,2007,1,76,301,129,0.847623596119974,269.6,16.9021978021978,53,1124.46954265929,-0.373924054826732
25754,529218.95,5328443.725,86,74,12,23.924,0,2008,1,123,297,185,0.905093877671125,38,17.3098901098901,62,1124.46954265929,-0.373924054826732
25754,529218.95,5328443.725,167,66,101,29.679,0,2009,2,117,296,176,0.910804846657345,34.6,18.2571428571429,59,1124.46954265929,-0.373924054826732
25754,529218.95,5328443.725,150,94,56,31.094,0,2010,2,118,304,193,0.885460863177445,95.1,17.9945054945055,75,1124.46954265929,-0.373924054826732
25754,529218.95,5328443.725,0,0,0,34.545,0,2011,0,100,329,162,0.867356472465694,139.3,17.1164835164835,62,1124.46954265929,-0.373924054826732
25754,529218.95,5328443.725,138,95,43,37.773,0,2012,1,116,293,177,0.890539277574472,38.5,18.2296703296703,61,1124.46954265929,-0.373924054826732
25754,529218.95,5328443.725,176,58,118,38.668,1,2013,2,117,295,161,0.929742985940088,-164.8,18.7813186813187,44,1124.46954265929,-0.373924054826732
25754,529218.95,5328443.725,139,93,46,35.904,1,2014,4,108,331,200,0.889369786074816,101.8,17.4461538461538,92,1124.46954265929,-0.373924054826732
25754,529218.95,5328443.725,146,93,53,35.021,0,2015,1,115,330,169,0.880070470382791,-192.4,20.4978021978022,54,1124.46954265929,-0.373924054826732
25754,529218.95,5328443.725,167,94,73,36.388,2,2016,1,118,328,178,0.913468636478557,-4.8,18.6318681318681,60,1124.46954265929,-0.373924054826732
25754,529218.95,5328443.725,131,93,38,29.031,0,2017,1,119,312,177,0.888359567684221,-54.4,19.6516483516484,58,1124.46954265929,-0.373924054826732
25754,529218.95,5328443.725,167,73,94,41.01,0,2018,2,106,328,161,0.911947373641618,-121.8,20.367032967033,55,1124.46954265929,-0.373924054826732
25754,529218.95,5328443.725,129,93,36,28.036,3,2019,2,122,330,184,0.89071673990432,-107,20.478021978022,62,1124.46954265929,-0.373924054826732
25754,529218.95,5328443.725,0,0,0,34.434,0,2020,0,102,286,185,0.855975398589942,-91.9,18.7142857142857,83,1124.46954265929,-0.373924054826732
25762,529218.95,5326590.474,86,81,5,25.159,0,2001,2,126,299,185,0.863550246835764,10.6,17.710989010989,59,1394.34631708561,0.255677135770048
25762,529218.95,5326590.474,152,70,82,18.453,0,2002,3,132,325,218,0.82006278778447,25.6,17.9494505494505,86,1394.34631708561,0.255677135770048
25762,529218.95,5326590.474,165,111,54,20.777,0,2003,1,128,292,178,0.846385686272045,-201.3,22.6626373626374,50,1394.34631708561,0.255677135770048
25762,529218.95,5326590.474,170,115,55,12.815,0,2004,1,138,289,201,0.855434741498056,132.4,17.5076923076923,63,1394.34631708561,0.255677135770048
25762,529218.95,5326590.474,158,93,65,28.924,0,2005,2,124,296,193,0.865714996903919,-23.3,17.6,69,1394.34631708561,0.255677135770048
25762,529218.95,5326590.474,200,60,140,17.625,1,2006,2,136,312,184,0.811430258642785,50,18.6131868131868,48,1394.34631708561,0.255677135770048
25762,529218.95,5326590.474,93,93,0,39.59,0,2007,2,103,289,200,0.854313621840467,269.6,16.9021978021978,97,1394.34631708561,0.255677135770048
25762,529218.95,5326590.474,121,50,71,13.212,0,2008,3,136,291,193,0.875283269055092,38,17.3098901098901,57,1394.34631708561,0.255677135770048
25762,529218.95,5326590.474,179,63,116,29.679,0,2009,2,117,287,185,0.911625859533277,34.6,18.2571428571429,68,1394.34631708561,0.255677135770048
25762,529218.95,5326590.474,174,109,65,12.899,0,2010,1,138,284,177,0.804440057437979,95.1,17.9945054945055,39,1394.34631708561,0.255677135770048
25762,529218.95,5326590.474,99,68,31,26.642,0,2011,2,110,320,170,0.829854718883401,139.3,17.1164835164835,60,1394.34631708561,0.255677135770048
25762,529218.95,5326590.474,164,93,71,23.907,0,2012,2,129,308,185,0.883991622840664,38.5,18.2296703296703,56,1394.34631708561,0.255677135770048
25762,529218.95,5326590.474,193,73,120,3.313,0,2013,3,150,288,201,0.870286525529477,-164.8,18.7813186813187,51,1394.34631708561,0.255677135770048
25762,529218.95,5326590.474,155,41,114,14.761,0,2014,3,136,353,200,0.862392595540251,101.8,17.4461538461538,64,1394.34631708561,0.255677135770048
25762,529218.95,5326590.474,168,124,44,27.694,0,2015,1,123,334,177,0.869991094883215,-192.4,20.4978021978022,54,1394.34631708561,0.255677135770048
25762,529218.95,5326590.474,176,109,67,13.072,0,2016,1,141,312,193,0.864857684923438,-4.8,18.6318681318681,52,1394.34631708561,0.255677135770048
25762,529218.95,5326590.474,0,0,0,27.366,0,2017,0,121,293,178,0.835475340156615,-54.4,19.6516483516484,57,1394.34631708561,0.255677135770048
25762,529218.95,5326590.474,86,67,19,26.748,0,2018,1,121,339,185,0.855893943439781,-121.8,20.367032967033,64,1394.34631708561,0.255677135770048
25762,529218.95,5326590.474,168,118,50,12.859,0,2019,1,138,300,185,0.856887187060936,-107,20.478021978022,47,1394.34631708561,0.255677135770048
25762,529218.95,5326590.474,86,82,4,23.693,1,2020,1,119,300,208,0.821373770042616,-91.9,18.7142857142857,89,1394.34631708561,0.255677135770048
25763,529218.95,5326358.817,86,82,4,29.343,0,2001,2,122,295,192,0.849856821580093,10.6,17.710989010989,70,1404.78083916672,-0.410926552260866
25763,529218.95,5326358.817,151,70,81,23.586,0,2002,3,127,315,242,0.757882467921589,25.6,17.9494505494505,115,1404.78083916672,-0.410926552260866
25763,529218.95,5326358.817,164,97,67,24.993,0,2003,1,123,290,170,0.776469852096022,-201.3,22.6626373626374,47,1404.78083916672,-0.410926552260866
25763,529218.95,5326358.817,171,94,77,11.908,0,2004,2,139,305,201,0.837526359887941,132.4,17.5076923076923,62,1404.78083916672,-0.410926552260866
25763,529218.95,5326358.817,162,99,63,25.886,0,2005,2,127,301,201,0.845986903970334,-23.3,17.6,74,1404.78083916672,-0.410926552260866
25763,529218.95,5326358.817,198,58,140,20.54,1,2006,2,133,319,184,0.785958303072474,50,18.6131868131868,51,1404.78083916672,-0.410926552260866
25763,529218.95,5326358.817,0,0,0,32.779,0,2007,0,112,295,186,0.881632739473793,269.6,16.9021978021978,74,1404.78083916672,-0.410926552260866
25763,529218.95,5326358.817,126,54,72,13.913,0,2008,3,135,295,185,0.845450081588295,38,17.3098901098901,50,1404.78083916672,-0.410926552260866
25763,529218.95,5326358.817,181,66,115,20.298,0,2009,3,128,286,184,0.91735393538081,34.6,18.2571428571429,56,1404.78083916672,-0.410926552260866
25763,529218.95,5326358.817,172,101,71,16.848,0,2010,1,134,285,185,0.817852388464423,95.1,17.9945054945055,51,1404.78083916672,-0.410926552260866
25763,529218.95,5326358.817,101,70,31,26.642,0,2011,2,110,314,161,0.787572225533818,139.3,17.1164835164835,51,1404.78083916672,-0.410926552260866
25763,529218.95,5326358.817,160,93,67,29.154,0,2012,1,124,309,177,0.876479446029542,38.5,18.2296703296703,53,1404.78083916672,-0.410926552260866
25763,529218.95,5326358.817,194,74,120,9.745,1,2013,3,144,296,200,0.851703393133314,-164.8,18.7813186813187,56,1404.78083916672,-0.410926552260866
25763,529218.95,5326358.817,156,44,112,28.736,0,2014,3,119,334,194,0.849476509824717,101.8,17.4461538461538,75,1404.78083916672,-0.410926552260866
25763,529218.95,5326358.817,164,93,71,31.71,0,2015,1,119,323,178,0.852520203780823,-192.4,20.4978021978022,59,1404.78083916672,-0.410926552260866
25763,529218.95,5326358.817,174,93,81,13.072,0,2016,2,141,328,201,0.864366745889057,-4.8,18.6318681318681,60,1404.78083916672,-0.410926552260866
25763,529218.95,5326358.817,0,0,0,26.532,0,2017,0,122,292,185,0.822009206969246,-54.4,19.6516483516484,63,1404.78083916672,-0.410926552260866
25763,529218.95,5326358.817,84,65,19,28.46,0,2018,1,119,315,178,0.85570525044892,-121.8,20.367032967033,59,1404.78083916672,-0.410926552260866
25763,529218.95,5326358.817,164,93,71,12.859,0,2019,2,138,306,192,0.838658131456421,-107,20.478021978022,54,1404.78083916672,-0.410926552260866
25763,529218.95,5326358.817,0,0,0,22.567,0,2020,0,121,305,209,0.794560115378521,-91.9,18.7142857142857,88,1404.78083916672,-0.410926552260866
25764,529218.95,5326127.161,0,0,0,22.72,0,2001,0,128,287,185,0.853304130742848,-19.6,19.9175824175824,57,1356.96296642037,-0.962018938616917
25764,529218.95,5326127.161,93,76,17,25.358,0,2002,3,125,288,201,0.871121613865356,-1.5,19.8516483516484,76,1356.96296642037,-0.962018938616917
25764,529218.95,5326127.161,162,56,106,26.032,0,2003,2,120,300,177,0.877169640297834,-210.6,24.6406593406593,57,1356.96296642037,-0.962018938616917
25764,529218.95,5326127.161,143,95,48,14.321,0,2004,2,136,302,209,0.833993597388656,98,19.4571428571429,73,1356.96296642037,-0.962018938616917
25764,529218.95,5326127.161,0,0,0,30.785,0,2005,0,122,298,185,0.836105065762466,-53,19.5769230769231,63,1356.96296642037,-0.962018938616917
25764,529218.95,5326127.161,183,61,122,18.907,0,2006,3,134,320,185,0.834939597036499,20.9,20.5340659340659,51,1356.96296642037,-0.962018938616917
25764,529218.95,5326127.161,157,157,0,40.252,0,2007,1,101,293,185,0.848859629629361,221.4,18.6978021978022,84,1356.96296642037,-0.962018938616917
25764,529218.95,5326127.161,0,0,0,14.333,0,2008,0,134,294,192,0.864807712803567,3.5,19.1615384615385,58,1356.96296642037,-0.962018938616917
25764,529218.95,5326127.161,167,56,111,22.971,0,2009,2,122,302,178,0.916286907578511,3.8,20.121978021978,56,1356.96296642037,-0.962018938616917
25764,529218.95,5326127.161,166,93,73,16.661,0,2010,2,133,299,185,0.834158558692471,57.2,19.8230769230769,52,1356.96296642037,-0.962018938616917
25764,529218.95,5326127.161,105,69,36,28.495,0,2011,2,104,313,160,0.78522414526943,98,19.0516483516484,56,1356.96296642037,-0.962018938616917
25764,529218.95,5326127.161,0,0,0,35.144,0,2012,0,118,300,184,0.846821778822867,-1.5,20.4054945054945,66,1356.96296642037,-0.962018938616917
25764,529218.95,5326127.161,182,67,115,21.717,0,2013,3,132,292,193,0.854053817191896,-195.6,20.9230769230769,61,1356.96296642037,-0.962018938616917
25764,529218.95,5326127.161,138,84,54,29.282,0,2014,3,115,333,184,0.855867333937615,58.4,19.4978021978022,69,1356.96296642037,-0.962018938616917
25764,529218.95,5326127.161,145,94,51,32.401,0,2015,2,118,321,184,0.842767387129038,-215.3,22.6472527472527,66,1356.96296642037,-0.962018938616917
25764,529218.95,5326127.161,169,116,53,21.772,0,2016,1,132,326,192,0.893886224900238,-36.2,20.6758241758242,60,1356.96296642037,-0.962018938616917
25764,529218.95,5326127.161,0,0,0,26.734,0,2017,0,120,302,201,0.832515824463474,-75,21.6263736263736,81,1356.96296642037,-0.962018938616917
25764,529218.95,5326127.161,86,71,15,23.76,0,2018,1,123,320,186,0.866068128870032,-137.6,22.2901098901099,63,1356.96296642037,-0.962018938616917
25764,529218.95,5326127.161,154,96,58,23.956,1,2019,2,126,325,217,0.855512607481604,-115.5,22.3538461538462,91,1356.96296642037,-0.962018938616917
25764,529218.95,5326127.161,0,0,0,23.687,0,2020,0,115,306,208,0.778849668298117,-114.8,20.6901098901099,93,1356.96296642037,-0.962018938616917
25933,529450.607,5337709.979,0,0,0,141.543,0,2001,0,28,326,217,0.833559572907238,-14.2,19.5065934065934,189,811.419879302343,-0.50851868143099
25933,529450.607,5337709.979,0,0,0,108.914,0,2002,0,47,334,242,0.843843745582221,3,19.4725274725275,195,811.419879302343,-0.50851868143099
25933,529450.607,5337709.979,0,0,0,59.231,0,2003,0,82,337,138,0.826512875435634,-209,24.2648351648352,56,811.419879302343,-0.50851868143099
25933,529450.607,5337709.979,120,94,26,62.383,2,2004,2,87,337,249,0.851542062234277,104,19.0769230769231,162,811.419879302343,-0.50851868143099
25933,529450.607,5337709.979,93,93,0,78.309,2,2005,1,78,317,152,0.85516154507882,-49.6,19.2098901098901,74,811.419879302343,-0.50851868143099
25933,529450.607,5337709.979,175,95,80,51.23,0,2006,2,102,342,249,0.832351538695744,25.1,20.1736263736264,147,811.419879302343,-0.50851868143099
25933,529450.607,5337709.979,0,0,0,87.612,0,2007,0,59,339,136,0.856693938545707,229.8,18.3494505494505,77,811.419879302343,-0.50851868143099
25933,529450.607,5337709.979,0,0,0,75.199,0,2008,0,78,313,233,0.85733699862017,8.90000000000001,18.8,155,811.419879302343,-0.50851868143099
25933,529450.607,5337709.979,0,0,0,56.055,0,2009,0,87,324,185,0.860893891615228,9.4,19.7494505494506,98,811.419879302343,-0.50851868143099
25933,529450.607,5337709.979,153,93,60,50.225,0,2010,2,95,308,224,0.892564054378612,64.4,19.4725274725275,129,811.419879302343,-0.50851868143099
25933,529450.607,5337709.979,116,82,34,62.197,6,2011,3,65,330,257,0.847484088628633,103.5,18.7505494505494,192,811.419879302343,-0.50851868143099
25933,529450.607,5337709.979,0,0,0,68.523,0,2012,0,80,310,161,0.864127963577527,3.2,20.1307692307692,81,811.419879302343,-0.50851868143099
25933,529450.607,5337709.979,86,70,16,55.12,0,2013,1,101,312,153,0.848893283137689,-190.8,20.5692307692308,52,811.419879302343,-0.50851868143099
25933,529450.607,5337709.979,96,93,3,91.049,7,2014,2,46,333,232,0.891751425664357,65.4,19.2153846153846,186,811.419879302343,-0.50851868143099
25933,529450.607,5337709.979,128,94,34,71.367,4,2015,1,78,313,144,0.84584499459163,-212.4,22.3164835164835,66,811.419879302343,-0.50851868143099
25933,529450.607,5337709.979,0,0,0,82.462,0,2016,0,74,345,218,0.832790633249394,-31.9,20.4131868131868,144,811.419879302343,-0.50851868143099
25933,529450.607,5337709.979,108,93,15,75.177,5,2017,2,68,350,321,0.908849061883941,-70.8,21.2648351648352,253,811.419879302343,-0.50851868143099
25933,529450.607,5337709.979,101,96,5,62.904,1,2018,1,84,325,129,0.831161402769334,-135.7,21.9263736263736,45,811.419879302343,-0.50851868143099
25933,529450.607,5337709.979,86,85,1,64.893,6,2019,1,83,335,240,0.848430681668091,-112.7,22.0065934065934,157,811.419879302343,-0.50851868143099
25933,529450.607,5337709.979,0,0,0,108.611,0,2020,0,34,322,184,0.842042855348684,-111.3,20.3164835164835,150,811.419879302343,-0.50851868143099
25938,529450.607,5336551.697,0,0,0,148.389,0,2001,2,22,306,178,0.857509282984909,-14.2,19.5065934065934,156,1104.95980238666,-0.332876801544752
25938,529450.607,5336551.697,133,79,54,54.257,1,2002,2,93,314,178,0.838845225846829,3,19.4725274725275,85,1104.95980238666,-0.332876801544752
25938,529450.607,5336551.697,153,82,71,46.751,6,2003,2,96,325,161,0.805795527468791,-209,24.2648351648352,65,1104.95980238666,-0.332876801544752
25938,529450.607,5336551.697,150,93,57,50.19,0,2004,1,99,322,170,0.830581169769212,104,19.0769230769231,71,1104.95980238666,-0.332876801544752
25938,529450.607,5336551.697,141,93,48,80.498,2,2005,2,76,312,169,0.821428436716582,-49.6,19.2098901098901,93,1104.95980238666,-0.332876801544752
25938,529450.607,5336551.697,184,65,119,51.23,0,2006,2,102,339,169,0.818587117073117,25.1,20.1736263736264,67,1104.95980238666,-0.332876801544752
25938,529450.607,5336551.697,0,0,0,78.031,0,2007,0,66,306,185,0.806924189996554,229.8,18.3494505494505,119,1104.95980238666,-0.332876801544752
25938,529450.607,5336551.697,86,80,6,33.811,0,2008,1,114,310,185,0.844761262751992,8.90000000000001,18.8,71,1104.95980238666,-0.332876801544752
25938,529450.607,5336551.697,167,93,74,39.905,0,2009,1,102,316,161,0.843931265277804,9.4,19.7494505494506,59,1104.95980238666,-0.332876801544752
25938,529450.607,5336551.697,162,93,69,36.691,0,2010,2,108,312,210,0.805041124626688,64.4,19.4725274725275,102,1104.95980238666,-0.332876801544752
25938,529450.607,5336551.697,86,69,17,77.593,18,2011,1,49,339,217,0.780024658272818,103.5,18.7505494505494,168,1104.95980238666,-0.332876801544752
25938,529450.607,5336551.697,126,94,32,58.925,4,2012,1,91,331,162,0.827320337589224,3.2,20.1307692307692,71,1104.95980238666,-0.332876801544752
25938,529450.607,5336551.697,168,93,75,48.952,0,2013,1,106,303,176,0.839734950908935,-190.8,20.5692307692308,70,1104.95980238666,-0.332876801544752
25938,529450.607,5336551.697,93,60,33,54.701,3,2014,3,81,349,184,0.843308330603841,65.4,19.2153846153846,103,1104.95980238666,-0.332876801544752
25938,529450.607,5336551.697,151,105,46,52.267,1,2015,1,97,344,162,0.837886425934252,-212.4,22.3164835164835,65,1104.95980238666,-0.332876801544752
25938,529450.607,5336551.697,166,93,73,55.433,4,2016,2,101,349,184,0.779446428352838,-31.9,20.4131868131868,83,1104.95980238666,-0.332876801544752
25938,529450.607,5336551.697,0,0,0,69.008,0,2017,0,73,320,168,0.817690431071187,-70.8,21.2648351648352,95,1104.95980238666,-0.332876801544752
25938,529450.607,5336551.697,85,77,8,141.597,43,2018,1,16,319,170,0.816371489039482,-135.7,21.9263736263736,154,1104.95980238666,-0.332876801544752
25938,529450.607,5336551.697,141,79,62,53.217,5,2019,3,95,331,225,0.792437164799149,-112.7,22.0065934065934,130,1104.95980238666,-0.332876801544752
25938,529450.607,5336551.697,0,0,0,119.321,0,2020,0,24,318,185,0.813606119583614,-111.3,20.3164835164835,161,1104.95980238666,-0.332876801544752
25939,529450.607,5336320.041,0,0,0,71.197,0,2001,1,86,296,176,0.851636392483897,-14.2,19.5065934065934,90,1156.24664540379,1.41825813281349
25939,529450.607,5336320.041,86,62,24,37.568,0,2002,1,112,325,169,0.808093631584205,3,19.4725274725275,57,1156.24664540379,1.41825813281349
25939,529450.607,5336320.041,146,93,53,39.544,1,2003,1,104,276,161,0.837242470153839,-209,24.2648351648352,57,1156.24664540379,1.41825813281349
25939,529450.607,5336320.041,143,93,50,40.691,0,2004,1,108,328,177,0.832359307119347,104,19.0769230769231,69,1156.24664540379,1.41825813281349
25939,529450.607,5336320.041,155,93,62,65.397,2,2005,2,90,305,161,0.823526551635722,-49.6,19.2098901098901,71,1156.24664540379,1.41825813281349
25939,529450.607,5336320.041,187,62,125,48.767,0,2006,2,104,338,161,0.822808484419395,25.1,20.1736263736264,57,1156.24664540379,1.41825813281349
25939,529450.607,5336320.041,0,0,0,78.031,0,2007,0,66,295,193,0.758581392358198,229.8,18.3494505494505,127,1156.24664540379,1.41825813281349
25939,529450.607,5336320.041,94,93,1,23.944,0,2008,2,123,307,193,0.832007202290145,8.90000000000001,18.8,70,1156.24664540379,1.41825813281349
25939,529450.607,5336320.041,157,67,90,32.947,0,2009,2,110,305,162,0.828739655351122,9.4,19.7494505494506,52,1156.24664540379,1.41825813281349
25939,529450.607,5336320.041,165,93,72,28.367,0,2010,2,118,305,209,0.804963500675756,64.4,19.4725274725275,91,1156.24664540379,1.41825813281349
25939,529450.607,5336320.041,85,81,4,42.125,0,2011,1,88,335,224,0.770358699883392,103.5,18.7505494505494,136,1156.24664540379,1.41825813281349
25939,529450.607,5336320.041,126,93,33,53.563,3,2012,1,98,307,169,0.832982926713155,3.2,20.1307692307692,71,1156.24664540379,1.41825813281349
25939,529450.607,5336320.041,0,0,0,42.653,0,2013,0,112,303,169,0.84396524815885,-190.8,20.5692307692308,57,1156.24664540379,1.41825813281349
25939,529450.607,5336320.041,0,0,0,51.245,0,2014,0,85,333,170,0.828040165679139,65.4,19.2153846153846,85,1156.24664540379,1.41825813281349
25939,529450.607,5336320.041,93,93,0,47.919,0,2015,1,101,341,161,0.819107930581432,-212.4,22.3164835164835,60,1156.24664540379,1.41825813281349
25939,529450.607,5336320.041,165,117,48,56.453,4,2016,1,100,331,185,0.835014116817041,-31.9,20.4131868131868,85,1156.24664540379,1.41825813281349
25939,529450.607,5336320.041,124,93,31,37.093,5,2017,1,107,307,169,0.792591275938604,-70.8,21.2648351648352,62,1156.24664540379,1.41825813281349
25939,529450.607,5336320.041,154,73,81,118.275,12,2018,2,34,303,177,0.795660234092413,-135.7,21.9263736263736,143,1156.24664540379,1.41825813281349
25939,529450.607,5336320.041,132,77,55,40.554,2,2019,2,108,337,186,0.784118598054709,-112.7,22.0065934065934,78,1156.24664540379,1.41825813281349
25939,529450.607,5336320.041,0,0,0,36.94,0,2020,0,96,319,185,0.81140728851305,-111.3,20.3164835164835,89,1156.24664540379,1.41825813281349
25940,529450.607,5336088.384,0,0,0,68.678,0,2001,2,88,304,168,0.850222567921281,-14.2,19.5065934065934,80,1099.61769220645,1.0858130608459
25940,529450.607,5336088.384,86,63,23,45.428,0,2002,1,103,328,169,0.820094801562373,3,19.4725274725275,66,1099.61769220645,1.0858130608459
25940,529450.607,5336088.384,146,93,53,41.311,1,2003,1,102,321,161,0.821308191276864,-209,24.2648351648352,59,1099.61769220645,1.0858130608459
25940,529450.607,5336088.384,142,93,49,51.331,0,2004,1,98,330,162,0.841850988014495,104,19.0769230769231,64,1099.61769220645,1.0858130608459
25940,529450.607,5336088.384,155,107,48,67.531,2,2005,1,88,317,153,0.838146724038173,-49.6,19.2098901098901,65,1099.61769220645,1.0858130608459
25940,529450.607,5336088.384,187,67,120,48.767,0,2006,2,104,340,161,0.819989730165553,25.1,20.1736263736264,57,1099.61769220645,1.0858130608459
25940,529450.607,5336088.384,0,0,0,76.797,0,2007,0,67,300,138,0.770407462671298,229.8,18.3494505494505,71,1099.61769220645,1.0858130608459
25940,529450.607,5336088.384,93,93,0,28.073,0,2008,1,119,310,178,0.83622460859708,8.90000000000001,18.8,59,1099.61769220645,1.0858130608459
25940,529450.607,5336088.384,157,68,89,37.275,0,2009,2,105,303,162,0.845235073849033,9.4,19.7494505494506,57,1099.61769220645,1.0858130608459
25940,529450.607,5336088.384,165,93,72,31.478,0,2010,2,114,308,241,0.773839613398054,64.4,19.4725274725275,127,1099.61769220645,1.0858130608459
25940,529450.607,5336088.384,85,83,2,47.177,0,2011,1,82,339,234,0.781735288668654,103.5,18.7505494505494,152,1099.61769220645,1.0858130608459
25940,529450.607,5336088.384,126,95,31,54.33,3,2012,1,97,309,162,0.839774981958265,3.2,20.1307692307692,65,1099.61769220645,1.0858130608459
25940,529450.607,5336088.384,0,0,0,43.661,0,2013,0,111,300,162,0.857068112817938,-190.8,20.5692307692308,51,1099.61769220645,1.0858130608459
25940,529450.607,5336088.384,0,0,0,76.948,0,2014,0,58,338,162,0.823101671201242,65.4,19.2153846153846,104,1099.61769220645,1.0858130608459
25940,529450.607,5336088.384,0,0,0,51.131,0,2015,0,98,338,160,0.775634875670141,-212.4,22.3164835164835,62,1099.61769220645,1.0858130608459
25940,529450.607,5336088.384,164,110,54,60.635,4,2016,1,96,320,184,0.814518297179761,-31.9,20.4131868131868,88,1099.61769220645,1.0858130608459
25940,529450.607,5336088.384,126,93,33,42.293,5,2017,1,100,308,169,0.780271119948309,-70.8,21.2648351648352,69,1099.61769220645,1.0858130608459
25940,529450.607,5336088.384,152,73,79,127.931,19,2018,2,26,306,169,0.798073863950449,-135.7,21.9263736263736,143,1099.61769220645,1.0858130608459
25940,529450.607,5336088.384,132,77,55,51.278,4,2019,2,97,341,154,0.793849270971192,-112.7,22.0065934065934,57,1099.61769220645,1.0858130608459
25940,529450.607,5336088.384,0,0,0,43.058,0,2020,0,89,318,177,0.810292377505663,-111.3,20.3164835164835,88,1099.61769220645,1.0858130608459
25941,529450.607,5335856.728,0,0,0,76.591,0,2001,0,82,319,162,0.86363218188265,-14.2,19.5065934065934,80,1069.01312854598,1.15092418952234
25941,529450.607,5335856.728,86,77,9,42.806,0,2002,1,106,335,170,0.839321189835166,3,19.4725274725275,64,1069.01312854598,1.15092418952234
25941,529450.607,5335856.728,153,107,46,45.822,6,2003,1,97,326,161,0.836836594288972,-209,24.2648351648352,64,1069.01312854598,1.15092418952234
25941,529450.607,5335856.728,129,104,25,60.289,0,2004,1,89,320,161,0.846789702121329,104,19.0769230769231,72,1069.01312854598,1.15092418952234
25941,529450.607,5335856.728,143,113,30,66.47,2,2005,1,89,316,160,0.867577620831547,-49.6,19.2098901098901,71,1069.01312854598,1.15092418952234
25941,529450.607,5335856.728,191,93,98,32.024,0,2006,1,120,346,161,0.844733444822996,25.1,20.1736263736264,41,1069.01312854598,1.15092418952234
25941,529450.607,5335856.728,93,93,0,84.831,9,2007,1,61,316,146,0.848327922241253,229.8,18.3494505494505,85,1069.01312854598,1.15092418952234
25941,529450.607,5335856.728,0,0,0,36.119,0,2008,0,112,309,218,0.860166157175923,8.90000000000001,18.8,106,1069.01312854598,1.15092418952234
25941,529450.607,5335856.728,152,60,92,41.748,0,2009,2,100,321,161,0.851722642342812,9.4,19.7494505494506,61,1069.01312854598,1.15092418952234
25941,529450.607,5335856.728,163,93,70,35.777,0,2010,1,109,313,170,0.854155196945214,64.4,19.4725274725275,61,1069.01312854598,1.15092418952234
25941,529450.607,5335856.728,86,69,17,44.664,0,2011,1,85,339,241,0.81653717946745,103.5,18.7505494505494,156,1069.01312854598,1.15092418952234
25941,529450.607,5335856.728,128,94,34,56.626,3,2012,1,94,319,161,0.847653696435545,3.2,20.1307692307692,67,1069.01312854598,1.15092418952234
25941,529450.607,5335856.728,162,98,64,64.259,7,2013,1,92,318,169,0.829704891350288,-190.8,20.5692307692308,77,1069.01312854598,1.15092418952234
25941,529450.607,5335856.728,86,86,0,71.412,5,2014,1,63,328,154,0.828045694647827,65.4,19.2153846153846,91,1069.01312854598,1.15092418952234
25941,529450.607,5335856.728,0,0,0,67.781,0,2015,0,82,346,153,0.833125285751701,-212.4,22.3164835164835,71,1069.01312854598,1.15092418952234
25941,529450.607,5335856.728,153,94,59,78.27,6,2016,2,78,333,192,0.824505043627285,-31.9,20.4131868131868,114,1069.01312854598,1.15092418952234
25941,529450.607,5335856.728,93,93,0,50.938,5,2017,1,90,319,162,0.812485475025271,-70.8,21.2648351648352,72,1069.01312854598,1.15092418952234
25941,529450.607,5335856.728,161,79,82,50.86,0,2018,3,95,341,202,0.753774788240566,-135.7,21.9263736263736,107,1069.01312854598,1.15092418952234
25941,529450.607,5335856.728,132,93,39,54.192,6,2019,1,94,341,160,0.81736805752577,-112.7,22.0065934065934,66,1069.01312854598,1.15092418952234
25941,529450.607,5335856.728,0,0,0,58.258,0,2020,0,74,314,169,0.836605581841307,-111.3,20.3164835164835,95,1069.01312854598,1.15092418952234
25946,529450.607,5334698.446,0,0,0,146.262,0,2001,1,24,316,185,0.838732617992669,-14.2,19.5065934065934,161,1231.87287652846,-0.552216267180851
25946,529450.607,5334698.446,116,77,39,48.781,0,2002,3,99,300,241,0.834407917422289,3,19.4725274725275,142,1231.87287652846,-0.552216267180851
25946,529450.607,5334698.446,154,94,60,44.903,5,2003,1,98,302,176,0.788978980429625,-209,24.2648351648352,78,1231.87287652846,-0.552216267180851
25946,529450.607,5334698.446,152,55,97,46.838,0,2004,3,102,337,265,0.784034504267057,104,19.0769230769231,163,1231.87287652846,-0.552216267180851
25946,529450.607,5334698.446,145,93,52,80.498,2,2005,2,76,316,176,0.819352580427081,-49.6,19.2098901098901,100,1231.87287652846,-0.552216267180851
25946,529450.607,5334698.446,187,66,121,31.09,0,2006,3,121,340,192,0.8047407543974,25.1,20.1736263736264,71,1231.87287652846,-0.552216267180851
25946,529450.607,5334698.446,141,93,48,52.681,1,2007,3,89,303,192,0.831058790996727,229.8,18.3494505494505,103,1231.87287652846,-0.552216267180851
25946,529450.607,5334698.446,86,84,2,34.991,0,2008,1,113,315,169,0.834066785569621,8.90000000000001,18.8,56,1231.87287652846,-0.552216267180851
25946,529450.607,5334698.446,157,68,89,35.592,0,2009,3,107,309,248,0.814431313312515,9.4,19.7494505494506,141,1231.87287652846,-0.552216267180851
25946,529450.607,5334698.446,150,94,56,54.926,1,2010,2,91,298,200,0.811406133621542,64.4,19.4725274725275,109,1231.87287652846,-0.552216267180851
25946,529450.607,5334698.446,86,60,26,57.674,3,2011,1,70,339,185,0.824116976054345,103.5,18.7505494505494,115,1231.87287652846,-0.552216267180851
25946,529450.607,5334698.446,144,94,50,52.046,2,2012,1,100,309,176,0.846831295028966,3.2,20.1307692307692,76,1231.87287652846,-0.552216267180851
25946,529450.607,5334698.446,168,61,107,38.828,0,2013,2,116,315,176,0.827883548194628,-190.8,20.5692307692308,60,1231.87287652846,-0.552216267180851
25946,529450.607,5334698.446,154,63,91,44.666,0,2014,2,93,316,186,0.828462290343557,65.4,19.2153846153846,93,1231.87287652846,-0.552216267180851
25946,529450.607,5334698.446,148,93,55,42.17,0,2015,1,107,331,169,0.793999739967093,-212.4,22.3164835164835,62,1231.87287652846,-0.552216267180851
25946,529450.607,5334698.446,156,93,63,60.635,4,2016,2,96,345,193,0.843549505678043,-31.9,20.4131868131868,97,1231.87287652846,-0.552216267180851
25946,529450.607,5334698.446,0,0,0,98.645,0,2017,0,48,315,185,0.822463284466906,-70.8,21.2648351648352,137,1231.87287652846,-0.552216267180851
25946,529450.607,5334698.446,165,68,97,46.395,0,2018,2,99,325,177,0.840911856185897,-135.7,21.9263736263736,78,1231.87287652846,-0.552216267180851
25946,529450.607,5334698.446,156,93,63,60.743,6,2019,1,87,344,170,0.803480032310072,-112.7,22.0065934065934,83,1231.87287652846,-0.552216267180851
25946,529450.607,5334698.446,0,0,0,48.685,0,2020,0,83,324,193,0.79645889607989,-111.3,20.3164835164835,110,1231.87287652846,-0.552216267180851
25949,529450.607,5334003.477,0,0,0,148.474,0,2001,1,19,324,177,0.844631539177763,10.6,17.710989010989,158,1079.757603582,1.22029701775657
25949,529450.607,5334003.477,93,93,0,30.897,0,2002,2,120,344,184,0.82537191884379,25.6,17.9494505494505,64,1079.757603582,1.22029701775657
25949,529450.607,5334003.477,147,97,50,50.134,7,2003,1,96,298,161,0.800576317283478,-201.3,22.6626373626374,65,1079.757603582,1.22029701775657
25949,529450.607,5334003.477,136,100,36,53.271,4,2004,2,98,339,201,0.798250135225948,132.4,17.5076923076923,103,1079.757603582,1.22029701775657
25949,529450.607,5334003.477,0,0,0,141.992,0,2005,0,21,319,168,0.822560498576676,-23.3,17.6,147,1079.757603582,1.22029701775657
25949,529450.607,5334003.477,175,83,92,47.033,2,2006,2,109,347,168,0.810347990453372,50,18.6131868131868,59,1079.757603582,1.22029701775657
25949,529450.607,5334003.477,0,0,0,103.124,0,2007,0,45,306,185,0.828317056279873,269.6,16.9021978021978,140,1079.757603582,1.22029701775657
25949,529450.607,5334003.477,0,0,0,31.275,0,2008,0,116,312,177,0.837694950979492,38,17.3098901098901,61,1079.757603582,1.22029701775657
25949,529450.607,5334003.477,158,62,96,51.112,0,2009,2,97,316,177,0.858441902514767,34.6,18.2571428571429,80,1079.757603582,1.22029701775657
25949,529450.607,5334003.477,156,93,63,45.799,0,2010,1,104,321,169,0.798613817360936,95.1,17.9945054945055,65,1079.757603582,1.22029701775657
25949,529450.607,5334003.477,0,0,0,112.099,0,2011,0,24,337,186,0.799543788910556,139.3,17.1164835164835,162,1079.757603582,1.22029701775657
25949,529450.607,5334003.477,0,0,0,57.804,0,2012,0,94,306,177,0.82976839761514,38.5,18.2296703296703,83,1079.757603582,1.22029701775657
25949,529450.607,5334003.477,173,61,112,51.461,1,2013,3,106,328,184,0.835974967287088,-164.8,18.7813186813187,78,1079.757603582,1.22029701775657
25949,529450.607,5334003.477,0,0,0,115.671,0,2014,0,25,353,329,0.803663233102288,101.8,17.4461538461538,304,1079.757603582,1.22029701775657
25949,529450.607,5334003.477,0,0,0,63.682,0,2015,0,87,342,146,0.794700964027275,-192.4,20.4978021978022,59,1079.757603582,1.22029701775657
25949,529450.607,5334003.477,154,93,61,60.632,5,2016,2,96,326,186,0.814948075271603,-4.8,18.6318681318681,90,1079.757603582,1.22029701775657
25949,529450.607,5334003.477,112,95,17,59.067,7,2017,2,84,320,192,0.793031144676988,-54.4,19.6516483516484,108,1079.757603582,1.22029701775657
25949,529450.607,5334003.477,0,0,0,73.294,0,2018,0,78,321,177,0.817844847640619,-121.8,20.367032967033,99,1079.757603582,1.22029701775657
25949,529450.607,5334003.477,142,97,45,56.232,9,2019,1,92,343,169,0.798036425874193,-107,20.478021978022,77,1079.757603582,1.22029701775657
25949,529450.607,5334003.477,0,0,0,119.186,0,2020,0,25,315,185,0.791481123692983,-91.9,18.7142857142857,160,1079.757603582,1.22029701775657
25950,529450.607,5333771.821,0,0,0,136.593,0,2001,1,30,307,169,0.88029738462766,10.6,17.710989010989,139,1049.30166397232,1.37110180890152
25950,529450.607,5333771.821,94,93,1,36.376,0,2002,1,114,339,177,0.849334905151947,25.6,17.9494505494505,63,1049.30166397232,1.37110180890152
25950,529450.607,5333771.821,143,93,50,51.198,8,2003,1,95,324,146,0.80618726029561,-201.3,22.6626373626374,51,1049.30166397232,1.37110180890152
25950,529450.607,5333771.821,132,93,39,46.314,0,2004,1,104,331,162,0.833174501340291,132.4,17.5076923076923,58,1049.30166397232,1.37110180890152
25950,529450.607,5333771.821,142,93,49,68.785,2,2005,2,88,315,154,0.849887921030949,-23.3,17.6,66,1049.30166397232,1.37110180890152
25950,529450.607,5333771.821,176,83,93,39.623,2,2006,2,115,343,161,0.824408812491836,50,18.6131868131868,46,1049.30166397232,1.37110180890152
25950,529450.607,5333771.821,0,0,0,90.502,0,2007,0,56,302,177,0.842411151761779,269.6,16.9021978021978,121,1049.30166397232,1.37110180890152
25950,529450.607,5333771.821,0,0,0,34.834,0,2008,0,113,309,170,0.85172768516451,38,17.3098901098901,57,1049.30166397232,1.37110180890152
25950,529450.607,5333771.821,154,61,93,51.112,0,2009,2,97,317,154,0.841014459636515,34.6,18.2571428571429,57,1049.30166397232,1.37110180890152
25950,529450.607,5333771.821,157,93,64,44.625,0,2010,1,105,314,162,0.830638833536853,95.1,17.9945054945055,57,1049.30166397232,1.37110180890152
25950,529450.607,5333771.821,0,0,0,103.123,0,2011,0,32,333,161,0.831619679430829,139.3,17.1164835164835,129,1049.30166397232,1.37110180890152
25950,529450.607,5333771.821,93,93,0,60.415,5,2012,2,91,307,185,0.84266046131168,38.5,18.2296703296703,94,1049.30166397232,1.37110180890152
25950,529450.607,5333771.821,173,61,112,46.54,1,2013,2,110,327,177,0.838700069416288,-164.8,18.7813186813187,67,1049.30166397232,1.37110180890152
25950,529450.607,5333771.821,0,0,0,62.067,0,2014,0,76,340,145,0.839644372270785,101.8,17.4461538461538,69,1049.30166397232,1.37110180890152
25950,529450.607,5333771.821,98,95,3,65.606,5,2015,1,85,340,152,0.862020570793471,-192.4,20.4978021978022,67,1049.30166397232,1.37110180890152
25950,529450.607,5333771.821,154,100,54,60.632,5,2016,2,96,336,192,0.856480010145331,-4.8,18.6318681318681,96,1049.30166397232,1.37110180890152
25950,529450.607,5333771.821,112,93,19,67.049,8,2017,1,77,317,176,0.826701216118412,-54.4,19.6516483516484,99,1049.30166397232,1.37110180890152
25950,529450.607,5333771.821,0,0,0,60.936,0,2018,0,89,318,170,0.833427389958184,-121.8,20.367032967033,81,1049.30166397232,1.37110180890152
25950,529450.607,5333771.821,142,93,49,52.399,7,2019,1,96,340,162,0.833043447552359,-107,20.478021978022,66,1049.30166397232,1.37110180890152
25950,529450.607,5333771.821,0,0,0,53.301,0,2020,0,81,313,176,0.835978546717138,-91.9,18.7142857142857,95,1049.30166397232,1.37110180890152
25988,529450.607,5324968.879,0,0,0,134.123,0,2001,1,32,336,170,0.837965902378097,-19.6,19.9175824175824,138,953.998403845069,0.461420255616269
25988,529450.607,5324968.879,0,0,0,53.475,0,2002,0,93,340,176,0.833685621608063,-1.5,19.8516483516484,83,953.998403845069,0.461420255616269
25988,529450.607,5324968.879,0,0,0,51.893,0,2003,0,89,329,152,0.814755682770453,-210.6,24.6406593406593,63,953.998403845069,0.461420255616269
25988,529450.607,5324968.879,119,93,26,43.972,0,2004,1,104,337,169,0.807236980128981,98,19.4571428571429,65,953.998403845069,0.461420255616269
25988,529450.607,5324968.879,138,102,36,66.336,2,2005,1,88,315,168,0.849066692812231,-53,19.5769230769231,80,953.998403845069,0.461420255616269
25988,529450.607,5324968.879,170,71,99,36.023,0,2006,3,115,346,248,0.794239957732873,20.9,20.5340659340659,133,953.998403845069,0.461420255616269
25988,529450.607,5324968.879,0,0,0,99.866,0,2007,0,47,321,193,0.844791838707899,221.4,18.6978021978022,146,953.998403845069,0.461420255616269
25988,529450.607,5324968.879,0,0,0,43.588,0,2008,0,105,310,169,0.869288835850613,3.5,19.1615384615385,64,953.998403845069,0.461420255616269
25988,529450.607,5324968.879,106,62,44,52.542,0,2009,3,89,326,184,0.881279116003634,3.8,20.121978021978,95,953.998403845069,0.461420255616269
25988,529450.607,5324968.879,151,93,58,47.007,0,2010,1,97,313,178,0.834177153662191,57.2,19.8230769230769,81,953.998403845069,0.461420255616269
25988,529450.607,5324968.879,86,74,12,77.624,17,2011,1,48,345,233,0.795093369744242,98,19.0516483516484,185,953.998403845069,0.461420255616269
25988,529450.607,5324968.879,93,93,0,62.733,3,2012,1,85,309,169,0.863851379337415,-1.5,20.4054945054945,84,953.998403845069,0.461420255616269
25988,529450.607,5324968.879,167,64,103,35.068,0,2013,2,119,325,178,0.853019618112137,-195.6,20.9230769230769,59,953.998403845069,0.461420255616269
25988,529450.607,5324968.879,0,0,0,112.325,0,2014,0,25,347,177,0.836993552817878,58.4,19.4978021978022,152,953.998403845069,0.461420255616269
25988,529450.607,5324968.879,0,0,0,70.124,0,2015,0,78,346,161,0.794670975713704,-215.3,22.6472527472527,83,953.998403845069,0.461420255616269
25988,529450.607,5324968.879,139,98,41,68.408,3,2016,2,87,337,194,0.845085070516874,-36.2,20.6758241758242,107,953.998403845069,0.461420255616269
25988,529450.607,5324968.879,105,93,12,67.943,4,2017,1,73,313,162,0.818547122953847,-75,21.6263736263736,89,953.998403845069,0.461420255616269
25988,529450.607,5324968.879,86,78,8,131.173,40,2018,1,22,343,170,0.844694888992067,-137.6,22.2901098901099,148,953.998403845069,0.461420255616269
25988,529450.607,5324968.879,112,93,19,85.329,9,2019,1,65,339,176,0.824800309864168,-115.5,22.3538461538462,111,953.998403845069,0.461420255616269
25988,529450.607,5324968.879,0,0,0,123.979,0,2020,0,17,323,184,0.845124100520876,-114.8,20.6901098901099,167,953.998403845069,0.461420255616269
25989,529450.607,5324737.223,0,0,0,119.923,0,2001,0,44,338,168,0.848191063607035,-19.6,19.9175824175824,124,899.323881510567,0.0248605692021474
25989,529450.607,5324737.223,0,0,0,59.645,0,2002,0,87,340,168,0.809958850324969,-1.5,19.8516483516484,81,899.323881510567,0.0248605692021474
25989,529450.607,5324737.223,0,0,0,60.624,0,2003,0,79,326,146,0.804375618277829,-210.6,24.6406593406593,67,899.323881510567,0.0248605692021474
25989,529450.607,5324737.223,0,0,0,49.356,0,2004,0,99,336,161,0.80506793774191,98,19.4571428571429,62,899.323881510567,0.0248605692021474
25989,529450.607,5324737.223,0,0,0,71.658,0,2005,0,83,315,153,0.834702751198873,-53,19.5769230769231,70,899.323881510567,0.0248605692021474
25989,529450.607,5324737.223,188,72,116,30.4,0,2006,5,121,344,265,0.850792254844052,20.9,20.5340659340659,144,899.323881510567,0.0248605692021474
25989,529450.607,5324737.223,0,0,0,90.856,0,2007,0,55,308,202,0.840292018512939,221.4,18.6978021978022,147,899.323881510567,0.0248605692021474
25989,529450.607,5324737.223,0,0,0,50.574,0,2008,0,99,310,177,0.840957501685263,3.5,19.1615384615385,78,899.323881510567,0.0248605692021474
25989,529450.607,5324737.223,86,69,17,46.94,0,2009,1,94,325,186,0.856001224902697,3.8,20.121978021978,92,899.323881510567,0.0248605692021474
25989,529450.607,5324737.223,0,0,0,43.798,0,2010,0,100,310,225,0.831188130523732,57.2,19.8230769230769,125,899.323881510567,0.0248605692021474
25989,529450.607,5324737.223,107,93,14,57.049,3,2011,2,70,333,241,0.808913384244794,98,19.0516483516484,171,899.323881510567,0.0248605692021474
25989,529450.607,5324737.223,0,0,0,66.305,0,2012,0,81,312,170,0.859596550989759,-1.5,20.4054945054945,89,899.323881510567,0.0248605692021474
25989,529450.607,5324737.223,149,93,56,44.83,0,2013,1,109,332,170,0.82749951574125,-195.6,20.9230769230769,61,899.323881510567,0.0248605692021474
25989,529450.607,5324737.223,0,0,0,81.373,0,2014,0,53,346,209,0.827347306570636,58.4,19.4978021978022,156,899.323881510567,0.0248605692021474
25989,529450.607,5324737.223,0,0,0,66.603,0,2015,0,82,345,162,0.874175745413042,-215.3,22.6472527472527,80,899.323881510567,0.0248605692021474
25989,529450.607,5324737.223,149,95,54,64.528,3,2016,2,91,339,194,0.856023089538513,-36.2,20.6758241758242,103,899.323881510567,0.0248605692021474
25989,529450.607,5324737.223,109,93,16,79.054,5,2017,1,64,324,170,0.838695811994894,-75,21.6263736263736,106,899.323881510567,0.0248605692021474
25989,529450.607,5324737.223,0,0,0,55.375,0,2018,0,90,344,177,0.843757542365145,-137.6,22.2901098901099,87,899.323881510567,0.0248605692021474
25989,529450.607,5324737.223,109,93,16,78.466,9,2019,1,71,340,169,0.820980453841965,-115.5,22.3538461538462,98,899.323881510567,0.0248605692021474
25989,529450.607,5324737.223,0,0,0,123.004,0,2020,0,18,322,185,0.845973853302464,-114.8,20.6901098901099,167,899.323881510567,0.0248605692021474
26158,529682.263,5336320.041,0,0,0,129.548,0,2001,2,38,291,169,0.838615705436058,-14.2,19.5065934065934,131,1118.91659844787,0.673762297311442
26158,529682.263,5336320.041,86,68,18,40.18,0,2002,1,109,334,249,0.812526654308617,3,19.4725274725275,140,1118.91659844787,0.673762297311442
26158,529682.263,5336320.041,148,101,47,39.544,1,2003,1,104,317,162,0.787995184568877,-209,24.2648351648352,58,1118.91659844787,0.673762297311442
26158,529682.263,5336320.041,143,93,50,41.665,0,2004,1,107,336,176,0.830365486200385,104,19.0769230769231,69,1118.91659844787,0.673762297311442
26158,529682.263,5336320.041,155,93,62,65.397,2,2005,2,90,313,161,0.827894928054525,-49.6,19.2098901098901,71,1118.91659844787,0.673762297311442
26158,529682.263,5336320.041,188,99,89,48.767,0,2006,1,104,340,168,0.818845020475748,25.1,20.1736263736264,64,1118.91659844787,0.673762297311442
26158,529682.263,5336320.041,0,0,0,118.741,0,2007,0,32,307,232,0.799409978860973,229.8,18.3494505494505,200,1118.91659844787,0.673762297311442
26158,529682.263,5336320.041,0,0,0,25.972,0,2008,0,121,310,192,0.842379639885916,8.90000000000001,18.8,71,1118.91659844787,0.673762297311442
26158,529682.263,5336320.041,160,93,67,40.816,0,2009,1,101,294,162,0.847905329109491,9.4,19.7494505494506,61,1118.91659844787,0.673762297311442
26158,529682.263,5336320.041,167,93,74,29.89,0,2010,2,116,309,192,0.820452165719526,64.4,19.4725274725275,76,1118.91659844787,0.673762297311442
26158,529682.263,5336320.041,85,62,23,43.851,0,2011,1,86,335,154,0.792067120400242,103.5,18.7505494505494,68,1118.91659844787,0.673762297311442
26158,529682.263,5336320.041,132,94,38,52.046,2,2012,1,100,319,169,0.836601519638287,3.2,20.1307692307692,69,1118.91659844787,0.673762297311442
26158,529682.263,5336320.041,166,133,33,72.95,15,2013,1,84,295,161,0.804458602667062,-190.8,20.5692307692308,77,1118.91659844787,0.673762297311442
26158,529682.263,5336320.041,133,53,80,51.245,1,2014,2,85,344,170,0.836153740416147,65.4,19.2153846153846,85,1118.91659844787,0.673762297311442
26158,529682.263,5336320.041,93,93,0,48.956,0,2015,1,100,343,160,0.836930302525793,-212.4,22.3164835164835,60,1118.91659844787,0.673762297311442
26158,529682.263,5336320.041,157,94,63,65.695,4,2016,2,91,338,186,0.845824466586475,-31.9,20.4131868131868,95,1118.91659844787,0.673762297311442
26158,529682.263,5336320.041,0,0,0,59.13,0,2017,0,82,321,200,0.828989477189653,-70.8,21.2648351648352,118,1118.91659844787,0.673762297311442
26158,529682.263,5336320.041,86,78,8,66.188,4,2018,1,81,311,168,0.816909316874266,-135.7,21.9263736263736,87,1118.91659844787,0.673762297311442
26158,529682.263,5336320.041,148,99,49,45.377,4,2019,1,103,337,169,0.826933995423293,-112.7,22.0065934065934,66,1118.91659844787,0.673762297311442
26158,529682.263,5336320.041,0,0,0,46.748,0,2020,0,85,310,178,0.805795656105527,-111.3,20.3164835164835,93,1118.91659844787,0.673762297311442
26159,529682.263,5336088.384,0,0,0,118.914,0,2001,1,47,306,161,0.825826463274873,-14.2,19.5065934065934,114,1147.09850775709,1.46541279977823
26159,529682.263,5336088.384,86,67,19,43.685,0,2002,1,105,332,169,0.817887652946295,3,19.4725274725275,64,1147.09850775709,1.46541279977823
26159,529682.263,5336088.384,147,93,54,39.544,1,2003,1,104,314,152,0.779403585597226,-209,24.2648351648352,48,1147.09850775709,1.46541279977823
26159,529682.263,5336088.384,143,93,50,47.934,0,2004,1,101,331,168,0.842859831585642,104,19.0769230769231,67,1147.09850775709,1.46541279977823
26159,529682.263,5336088.384,156,107,49,66.47,2,2005,1,89,315,153,0.835445666197549,-49.6,19.2098901098901,64,1147.09850775709,1.46541279977823
26159,529682.263,5336088.384,189,104,85,51.23,0,2006,1,102,339,161,0.809047401764531,25.1,20.1736263736264,59,1147.09850775709,1.46541279977823
26159,529682.263,5336088.384,0,0,0,63.741,0,2007,0,79,293,154,0.81899129935778,229.8,18.3494505494505,75,1147.09850775709,1.46541279977823
26159,529682.263,5336088.384,0,0,0,28.073,0,2008,0,119,310,170,0.829700308726488,8.90000000000001,18.8,51,1147.09850775709,1.46541279977823
26159,529682.263,5336088.384,161,96,65,43.681,0,2009,1,98,293,168,0.846718425147707,9.4,19.7494505494506,70,1147.09850775709,1.46541279977823
26159,529682.263,5336088.384,167,93,74,32.305,0,2010,2,113,311,240,0.789170949994686,64.4,19.4725274725275,127,1147.09850775709,1.46541279977823
26159,529682.263,5336088.384,84,62,22,43.851,0,2011,1,86,335,241,0.793966569406282,103.5,18.7505494505494,155,1147.09850775709,1.46541279977823
26159,529682.263,5336088.384,130,93,37,50.533,1,2012,1,102,322,168,0.849186685656533,3.2,20.1307692307692,66,1147.09850775709,1.46541279977823
26159,529682.263,5336088.384,169,133,36,55.12,0,2013,1,101,296,162,0.823170675873452,-190.8,20.5692307692308,61,1147.09850775709,1.46541279977823
26159,529682.263,5336088.384,133,53,80,53.851,3,2014,2,82,347,160,0.826324776121015,65.4,19.2153846153846,78,1147.09850775709,1.46541279977823
26159,529682.263,5336088.384,93,93,0,54.636,3,2015,1,95,337,153,0.809465048903524,-212.4,22.3164835164835,58,1147.09850775709,1.46541279977823
26159,529682.263,5336088.384,158,97,61,67.739,4,2016,1,89,325,184,0.823120356529622,-31.9,20.4131868131868,95,1147.09850775709,1.46541279977823
26159,529682.263,5336088.384,96,95,1,37.093,5,2017,1,107,317,170,0.779988640405513,-70.8,21.2648351648352,63,1147.09850775709,1.46541279977823
26159,529682.263,5336088.384,86,77,9,91.868,14,2018,1,58,304,186,0.742524230673986,-135.7,21.9263736263736,128,1147.09850775709,1.46541279977823
26159,529682.263,5336088.384,147,104,43,45.377,4,2019,1,103,341,160,0.795822163735005,-112.7,22.0065934065934,57,1147.09850775709,1.46541279977823
26159,529682.263,5336088.384,0,0,0,48.685,0,2020,0,83,311,177,0.810330109793885,-111.3,20.3164835164835,94,1147.09850775709,1.46541279977823
26160,529682.263,5335856.728,0,0,0,58.246,0,2001,3,97,295,162,0.845740959178907,-14.2,19.5065934065934,65,1136.65708888369,-1.17067295899207
26160,529682.263,5335856.728,146,62,84,40.18,0,2002,2,109,321,169,0.830237834066116,3,19.4725274725275,60,1136.65708888369,-1.17067295899207
26160,529682.263,5335856.728,156,101,55,39.544,1,2003,1,104,315,153,0.815032255392201,-209,24.2648351648352,49,1136.65708888369,-1.17067295899207
26160,529682.263,5335856.728,150,98,52,57.298,0,2004,1,92,334,161,0.847053844689066,104,19.0769230769231,69,1136.65708888369,-1.17067295899207
26160,529682.263,5335856.728,134,126,8,65.397,2,2005,1,90,317,154,0.83252594463736,-49.6,19.2098901098901,64,1136.65708888369,-1.17067295899207
26160,529682.263,5335856.728,186,62,124,59.998,5,2006,2,95,346,154,0.829784725553678,25.1,20.1736263736264,59,1136.65708888369,-1.17067295899207
26160,529682.263,5335856.728,0,0,0,83.351,0,2007,0,62,320,138,0.821305378952224,229.8,18.3494505494505,76,1136.65708888369,-1.17067295899207
26160,529682.263,5335856.728,0,0,0,27.013,0,2008,0,120,313,218,0.850330049410699,8.90000000000001,18.8,98,1136.65708888369,-1.17067295899207
26160,529682.263,5335856.728,164,70,94,38.135,0,2009,2,104,317,161,0.852912798381913,9.4,19.7494505494506,57,1136.65708888369,-1.17067295899207
26160,529682.263,5335856.728,163,93,70,35.777,0,2010,1,109,308,177,0.809115193232714,64.4,19.4725274725275,68,1136.65708888369,-1.17067295899207
26160,529682.263,5335856.728,93,70,23,43.851,0,2011,3,86,337,241,0.815752899808904,103.5,18.7505494505494,155,1136.65708888369,-1.17067295899207
26160,529682.263,5335856.728,135,94,41,51.29,1,2012,1,101,318,169,0.849739475517929,3.2,20.1307692307692,68,1136.65708888369,-1.17067295899207
26160,529682.263,5335856.728,170,93,77,48.952,0,2013,1,106,319,168,0.826561053500841,-190.8,20.5692307692308,62,1136.65708888369,-1.17067295899207
26160,529682.263,5335856.728,83,62,21,62.436,3,2014,1,72,347,153,0.832854447784195,65.4,19.2153846153846,81,1136.65708888369,-1.17067295899207
26160,529682.263,5335856.728,0,0,0,60.546,0,2015,0,90,345,145,0.821496925752294,-212.4,22.3164835164835,55,1136.65708888369,-1.17067295899207
26160,529682.263,5335856.728,159,96,63,66.735,4,2016,1,90,328,185,0.837173147623839,-31.9,20.4131868131868,95,1136.65708888369,-1.17067295899207
26160,529682.263,5335856.728,0,0,0,54.858,0,2017,0,86,324,161,0.807430066915871,-70.8,21.2648351648352,75,1136.65708888369,-1.17067295899207
26160,529682.263,5335856.728,149,132,17,66.188,4,2018,1,81,310,154,0.867968913285366,-135.7,21.9263736263736,73,1136.65708888369,-1.17067295899207
26160,529682.263,5335856.728,135,101,34,51.278,4,2019,1,97,342,154,0.803222589077106,-112.7,22.0065934065934,57,1136.65708888369,-1.17067295899207
26160,529682.263,5335856.728,0,0,0,48.685,0,2020,0,83,310,169,0.819778834147344,-111.3,20.3164835164835,86,1136.65708888369,-1.17067295899207
26161,529682.263,5335625.072,0,0,0,79.376,0,2001,3,80,313,162,0.85515607729703,-14.2,19.5065934065934,82,1092.74754683458,-1.51932663307015
26161,529682.263,5335625.072,145,68,77,49.65,0,2002,3,98,308,241,0.852265448093877,3,19.4725274725275,143,1092.74754683458,-1.51932663307015
26161,529682.263,5335625.072,153,93,60,48.644,8,2003,1,94,331,152,0.817807220792798,-209,24.2648351648352,58,1092.74754683458,-1.51932663307015
26161,529682.263,5335625.072,153,110,43,57.298,0,2004,1,92,336,153,0.842340808497675,104,19.0769230769231,61,1092.74754683458,-1.51932663307015
26161,529682.263,5335625.072,93,93,0,73.991,2,2005,1,82,317,146,0.816434585837158,-49.6,19.2098901098901,64,1092.74754683458,-1.51932663307015
26161,529682.263,5335625.072,193,62,131,36.829,0,2006,3,115,344,273,0.838118144522334,25.1,20.1736263736264,158,1092.74754683458,-1.51932663307015
26161,529682.263,5335625.072,0,0,0,116.509,0,2007,0,34,315,130,0.820410713242247,229.8,18.3494505494505,96,1092.74754683458,-1.51932663307015
26161,529682.263,5335625.072,0,0,0,38.377,0,2008,0,110,313,202,0.816040064585233,8.90000000000001,18.8,92,1092.74754683458,-1.51932663307015
26161,529682.263,5335625.072,164,66,98,39.011,0,2009,2,103,315,154,0.845308297582957,9.4,19.7494505494506,51,1092.74754683458,-1.51932663307015
26161,529682.263,5335625.072,162,100,62,45.662,0,2010,1,99,310,185,0.846661057081734,64.4,19.4725274725275,86,1092.74754683458,-1.51932663307015
26161,529682.263,5335625.072,86,72,14,47.177,0,2011,1,82,338,241,0.823979258018448,103.5,18.7505494505494,159,1092.74754683458,-1.51932663307015
26161,529682.263,5335625.072,130,93,37,52.803,3,2012,1,99,322,169,0.848388378427435,3.2,20.1307692307692,70,1092.74754683458,-1.51932663307015
26161,529682.263,5335625.072,167,94,73,66.377,9,2013,1,90,312,177,0.800992108443697,-190.8,20.5692307692308,87,1092.74754683458,-1.51932663307015
26161,529682.263,5335625.072,84,60,24,75.836,7,2014,1,59,346,146,0.830954253288057,65.4,19.2153846153846,87,1092.74754683458,-1.51932663307015
26161,529682.263,5335625.072,93,93,0,65.196,4,2015,1,85,346,152,0.823670417818296,-212.4,22.3164835164835,67,1092.74754683458,-1.51932663307015
26161,529682.263,5335625.072,156,94,62,76.276,6,2016,2,80,332,192,0.832134241489441,-31.9,20.4131868131868,112,1092.74754683458,-1.51932663307015
26161,529682.263,5335625.072,0,0,0,46.438,0,2017,0,95,323,161,0.825457391582229,-70.8,21.2648351648352,66,1092.74754683458,-1.51932663307015
26161,529682.263,5335625.072,0,0,0,109.231,0,2018,0,42,321,154,0.87899039637615,-135.7,21.9263736263736,112,1092.74754683458,-1.51932663307015
26161,529682.263,5335625.072,131,93,38,53.217,5,2019,1,95,342,160,0.811788287634284,-112.7,22.0065934065934,65,1092.74754683458,-1.51932663307015
26161,529682.263,5335625.072,0,0,0,101.92,0,2020,0,39,314,177,0.815945723418823,-111.3,20.3164835164835,138,1092.74754683458,-1.51932663307015
26162,529682.263,5335393.415,0,0,0,127.052,0,2001,1,40,331,161,0.862317912622576,-14.2,19.5065934065934,121,1077.34805550941,-1.41736831592709
26162,529682.263,5335393.415,128,79,49,47.086,0,2002,2,101,308,176,0.844736248339476,3,19.4725274725275,75,1077.34805550941,-1.41736831592709
26162,529682.263,5335393.415,152,93,59,45.822,6,2003,1,97,335,153,0.789981023995778,-209,24.2648351648352,56,1077.34805550941,-1.41736831592709
26162,529682.263,5335393.415,151,93,58,61.327,1,2004,1,88,341,161,0.85710030589497,104,19.0769230769231,73,1077.34805550941,-1.41736831592709
26162,529682.263,5335393.415,0,0,0,128.152,0,2005,0,33,320,145,0.831745701634882,-49.6,19.2098901098901,112,1077.34805550941,-1.41736831592709
26162,529682.263,5335393.415,186,71,115,40.819,0,2006,3,111,341,288,0.84056201142895,25.1,20.1736263736264,177,1077.34805550941,-1.41736831592709
26162,529682.263,5335393.415,0,0,0,87.612,0,2007,0,59,326,144,0.826350632257545,229.8,18.3494505494505,85,1077.34805550941,-1.41736831592709
26162,529682.263,5335393.415,0,0,0,48.031,0,2008,0,102,317,168,0.859571923950962,8.90000000000001,18.8,66,1077.34805550941,-1.41736831592709
26162,529682.263,5335393.415,155,67,88,45.692,0,2009,2,96,325,153,0.842421419029433,9.4,19.7494505494506,57,1077.34805550941,-1.41736831592709
26162,529682.263,5335393.415,161,93,68,40.532,0,2010,1,104,320,176,0.853535767462177,64.4,19.4725274725275,72,1077.34805550941,-1.41736831592709
26162,529682.263,5335393.415,119,93,26,45.487,0,2011,2,84,342,241,0.814687350477621,103.5,18.7505494505494,157,1077.34805550941,-1.41736831592709
26162,529682.263,5335393.415,145,94,51,58.925,4,2012,1,91,314,161,0.847418588361349,3.2,20.1307692307692,70,1077.34805550941,-1.41736831592709
26162,529682.263,5335393.415,86,77,9,119.771,46,2013,1,42,319,146,0.809054768191339,-190.8,20.5692307692308,104,1077.34805550941,-1.41736831592709
26162,529682.263,5335393.415,93,93,0,58.877,3,2014,1,76,319,145,0.829705959619464,65.4,19.2153846153846,69,1077.34805550941,-1.41736831592709
26162,529682.263,5335393.415,143,93,50,59.403,4,2015,1,91,352,146,0.830730857823403,-212.4,22.3164835164835,55,1077.34805550941,-1.41736831592709
26162,529682.263,5335393.415,166,102,64,60.635,4,2016,2,96,342,200,0.828057490595262,-31.9,20.4131868131868,104,1077.34805550941,-1.41736831592709
26162,529682.263,5335393.415,121,93,28,61.347,5,2017,2,80,326,209,0.812778033848252,-70.8,21.2648351648352,129,1077.34805550941,-1.41736831592709
26162,529682.263,5335393.415,0,0,0,133.303,0,2018,0,22,322,177,0.780275275443154,-135.7,21.9263736263736,155,1077.34805550941,-1.41736831592709
26162,529682.263,5335393.415,132,94,38,53.217,5,2019,1,95,333,161,0.816459760016904,-112.7,22.0065934065934,66,1077.34805550941,-1.41736831592709
26162,529682.263,5335393.415,0,0,0,120.274,0,2020,0,23,314,168,0.829710632773078,-111.3,20.3164835164835,145,1077.34805550941,-1.41736831592709
26193,529682.263,5328212.068,0,0,0,54.123,0,2001,2,100,295,177,0.884549529656567,10.6,17.710989010989,77,1135.80608939665,-0.78777547600201
26193,529682.263,5328212.068,109,78,31,44.84,1,2002,3,105,304,184,0.872958333478957,25.6,17.9494505494505,79,1135.80608939665,-0.78777547600201
26193,529682.263,5328212.068,111,81,30,44.047,1,2003,2,102,307,176,0.859603566272187,-201.3,22.6626373626374,74,1135.80608939665,-0.78777547600201
26193,529682.263,5328212.068,152,103,49,39.907,0,2004,1,110,302,185,0.87253612045994,132.4,17.5076923076923,75,1135.80608939665,-0.78777547600201
26193,529682.263,5328212.068,125,57,68,50.27,0,2005,2,104,313,176,0.8888196745925,-23.3,17.6,72,1135.80608939665,-0.78777547600201
26193,529682.263,5328212.068,190,72,118,29.55,1,2006,2,124,333,177,0.880177112728463,50,18.6131868131868,53,1135.80608939665,-0.78777547600201
26193,529682.263,5328212.068,159,93,66,51.097,2,2007,2,91,294,185,0.891939212499917,269.6,16.9021978021978,94,1135.80608939665,-0.78777547600201
26193,529682.263,5328212.068,86,63,23,24.913,0,2008,1,122,306,176,0.890883808510095,38,17.3098901098901,54,1135.80608939665,-0.78777547600201
26193,529682.263,5328212.068,168,76,92,27.077,0,2009,2,120,299,168,0.900353479421818,34.6,18.2571428571429,48,1135.80608939665,-0.78777547600201
26193,529682.263,5328212.068,167,93,74,31.094,0,2010,1,118,300,177,0.869784441142862,95.1,17.9945054945055,59,1135.80608939665,-0.78777547600201
26193,529682.263,5328212.068,110,84,26,41.932,0,2011,2,92,322,161,0.85621845385559,139.3,17.1164835164835,69,1135.80608939665,-0.78777547600201
26193,529682.263,5328212.068,147,82,65,52.714,3,2012,2,100,303,169,0.884060593004508,38.5,18.2296703296703,69,1135.80608939665,-0.78777547600201
26193,529682.263,5328212.068,169,57,112,40.805,1,2013,3,115,304,193,0.86340995222455,-164.8,18.7813186813187,78,1135.80608939665,-0.78777547600201
26193,529682.263,5328212.068,142,65,77,38.624,3,2014,2,104,317,177,0.861320794785326,101.8,17.4461538461538,73,1135.80608939665,-0.78777547600201
26193,529682.263,5328212.068,154,93,61,40.081,0,2015,1,109,309,154,0.889650209884505,-192.4,20.4978021978022,45,1135.80608939665,-0.78777547600201
26193,529682.263,5328212.068,146,94,52,50.938,5,2016,2,105,335,193,0.884830433144028,-4.8,18.6318681318681,88,1135.80608939665,-0.78777547600201
26193,529682.263,5328212.068,0,0,0,32.877,0,2017,0,114,295,170,0.868949213719824,-54.4,19.6516483516484,56,1135.80608939665,-0.78777547600201
26193,529682.263,5328212.068,164,96,68,39.897,0,2018,1,107,338,161,0.897678503761203,-121.8,20.367032967033,54,1135.80608939665,-0.78777547600201
26193,529682.263,5328212.068,137,93,44,36.079,3,2019,1,113,331,178,0.854017694780393,-107,20.478021978022,65,1135.80608939665,-0.78777547600201
26193,529682.263,5328212.068,0,0,0,39.255,0,2020,0,96,299,169,0.841399623596772,-91.9,18.7142857142857,73,1135.80608939665,-0.78777547600201
26194,529682.263,5327980.412,0,0,0,44.853,0,2001,2,108,299,177,0.879000136290555,10.6,17.710989010989,69,1175.21708015196,-1.50081958777082
26194,529682.263,5327980.412,148,75,73,35.472,0,2002,2,115,291,185,0.87000922151761,25.6,17.9494505494505,70,1175.21708015196,-1.50081958777082
26194,529682.263,5327980.412,154,74,80,35.696,0,2003,2,111,291,169,0.859513999686888,-201.3,22.6626373626374,58,1175.21708015196,-1.50081958777082
26194,529682.263,5327980.412,172,93,79,30.971,0,2004,2,119,307,193,0.867423180293199,132.4,17.5076923076923,74,1175.21708015196,-1.50081958777082
26194,529682.263,5327980.412,149,93,56,47.038,0,2005,1,107,310,169,0.874579124323998,-23.3,17.6,62,1175.21708015196,-1.50081958777082
26194,529682.263,5327980.412,188,60,128,32.717,1,2006,3,121,329,169,0.864221832071242,50,18.6131868131868,48,1175.21708015196,-1.50081958777082
26194,529682.263,5327980.412,166,93,73,42.208,0,2007,2,100,298,185,0.883216286130659,269.6,16.9021978021978,85,1175.21708015196,-1.50081958777082
26194,529682.263,5327980.412,0,0,0,22.957,0,2008,0,124,302,185,0.882432545702323,38,17.3098901098901,61,1175.21708015196,-1.50081958777082
26194,529682.263,5327980.412,174,61,113,40.703,0,2009,2,106,306,161,0.894605183165136,34.6,18.2571428571429,55,1175.21708015196,-1.50081958777082
26194,529682.263,5327980.412,169,93,76,29.343,0,2010,2,120,289,185,0.874633953269511,95.1,17.9945054945055,65,1175.21708015196,-1.50081958777082
26194,529682.263,5327980.412,84,58,26,34.545,0,2011,1,100,310,178,0.82926330441668,139.3,17.1164835164835,78,1175.21708015196,-1.50081958777082
26194,529682.263,5327980.412,157,95,62,44.886,0,2012,2,109,306,185,0.877683163702104,38.5,18.2296703296703,76,1175.21708015196,-1.50081958777082
26194,529682.263,5327980.412,181,77,104,35.135,1,2013,3,120,294,200,0.859706375986744,-164.8,18.7813186813187,80,1175.21708015196,-1.50081958777082
26194,529682.263,5327980.412,156,50,106,37.93,3,2014,2,105,329,168,0.870148317330855,101.8,17.4461538461538,63,1175.21708015196,-1.50081958777082
26194,529682.263,5327980.412,146,93,53,41.916,0,2015,1,107,316,161,0.888361459622445,-192.4,20.4978021978022,54,1175.21708015196,-1.50081958777082
26194,529682.263,5327980.412,158,94,64,37.457,3,2016,2,117,324,186,0.892601377615655,-4.8,18.6318681318681,69,1175.21708015196,-1.50081958777082
26194,529682.263,5327980.412,0,0,0,34.38,0,2017,0,112,314,169,0.857430386914349,-54.4,19.6516483516484,57,1175.21708015196,-1.50081958777082
26194,529682.263,5327980.412,167,76,91,37.754,0,2018,2,109,309,178,0.821771298465507,-121.8,20.367032967033,69,1175.21708015196,-1.50081958777082
26194,529682.263,5327980.412,164,93,71,30.758,3,2019,1,119,329,168,0.844064090843428,-107,20.478021978022,49,1175.21708015196,-1.50081958777082
26194,529682.263,5327980.412,0,0,0,35.964,0,2020,0,100,294,177,0.827630823203913,-91.9,18.7142857142857,77,1175.21708015196,-1.50081958777082
26208,529682.263,5324737.223,0,0,0,133.018,0,2001,1,33,340,162,0.844210857483736,-19.6,19.9175824175824,129,992.842179013949,1.34116476361441
26208,529682.263,5324737.223,0,0,0,63.085,0,2002,0,84,341,162,0.799224231914239,-1.5,19.8516483516484,78,992.842179013949,1.34116476361441
26208,529682.263,5324737.223,0,0,0,53.552,0,2003,0,87,321,153,0.821898240307986,-210.6,24.6406593406593,66,992.842179013949,1.34116476361441
26208,529682.263,5324737.223,0,0,0,51.577,0,2004,0,97,337,162,0.80620194107121,98,19.4571428571429,65,992.842179013949,1.34116476361441
26208,529682.263,5324737.223,134,93,41,68.459,2,2005,2,86,314,160,0.826474420368792,-53,19.5769230769231,74,992.842179013949,1.34116476361441
26208,529682.263,5324737.223,174,71,103,38.913,0,2006,2,112,344,160,0.813003737306816,20.9,20.5340659340659,48,992.842179013949,1.34116476361441
26208,529682.263,5324737.223,0,0,0,85.028,0,2007,0,60,308,217,0.795429815705375,221.4,18.6978021978022,157,992.842179013949,1.34116476361441
26208,529682.263,5324737.223,0,0,0,40.06,0,2008,0,108,309,193,0.823812032792954,3.5,19.1615384615385,85,992.842179013949,1.34116476361441
26208,529682.263,5324737.223,0,0,0,46.94,0,2009,0,94,321,162,0.837065044438224,3.8,20.121978021978,68,992.842179013949,1.34116476361441
26208,529682.263,5324737.223,0,0,0,41.776,0,2010,0,102,311,233,0.780058570042934,57.2,19.8230769230769,131,992.842179013949,1.34116476361441
26208,529682.263,5324737.223,109,69,40,52.764,3,2011,3,75,321,242,0.790198500310178,98,19.0516483516484,167,992.842179013949,1.34116476361441
26208,529682.263,5324737.223,0,0,0,66.305,0,2012,0,81,310,162,0.841422348573621,-1.5,20.4054945054945,81,992.842179013949,1.34116476361441
26208,529682.263,5324737.223,86,64,22,40.853,0,2013,1,113,302,170,0.851410844929542,-195.6,20.9230769230769,57,992.842179013949,1.34116476361441
26208,529682.263,5324737.223,85,83,2,106.924,10,2014,1,30,347,225,0.844163177656111,58.4,19.4978021978022,195,992.842179013949,1.34116476361441
26208,529682.263,5324737.223,0,0,0,66.603,0,2015,0,82,333,162,0.905371385992598,-215.3,22.6472527472527,80,992.842179013949,1.34116476361441
26208,529682.263,5324737.223,146,105,41,61.512,3,2016,1,94,338,185,0.86024750966126,-36.2,20.6758241758242,91,992.842179013949,1.34116476361441
26208,529682.263,5324737.223,107,93,14,74.007,4,2017,1,68,319,177,0.825502178647891,-75,21.6263736263736,109,992.842179013949,1.34116476361441
26208,529682.263,5324737.223,86,77,9,128.412,39,2018,1,24,324,176,0.829166706884571,-137.6,22.2901098901099,152,992.842179013949,1.34116476361441
26208,529682.263,5324737.223,125,93,32,73.476,8,2019,1,75,341,169,0.816459104629386,-115.5,22.3538461538462,94,992.842179013949,1.34116476361441
26208,529682.263,5324737.223,0,0,0,122.021,0,2020,0,19,325,184,0.835765552029648,-114.8,20.6901098901099,165,992.842179013949,1.34116476361441
26209,529682.263,5324505.567,0,0,0,133.018,0,2001,2,33,342,160,0.822252640991838,-19.6,19.9175824175824,127,946.796980073738,-0.976015778270554
26209,529682.263,5324505.567,0,0,0,75.761,0,2002,0,73,342,153,0.787483683940782,-1.5,19.8516483516484,80,946.796980073738,-0.976015778270554
26209,529682.263,5324505.567,0,0,0,54.39,0,2003,0,86,328,152,0.815753416813482,-210.6,24.6406593406593,66,946.796980073738,-0.976015778270554
26209,529682.263,5324505.567,0,0,0,58.292,0,2004,0,90,339,162,0.811311599703435,98,19.4571428571429,72,946.796980073738,-0.976015778270554
26209,529682.263,5324505.567,133,93,40,75.955,2,2005,2,79,318,146,0.811927446890255,-53,19.5769230769231,67,946.796980073738,-0.976015778270554
26209,529682.263,5324505.567,166,72,94,51.215,1,2006,2,101,346,161,0.785477434427156,20.9,20.5340659340659,60,946.796980073738,-0.976015778270554
26209,529682.263,5324505.567,0,0,0,90.856,0,2007,0,55,311,217,0.800851547826626,221.4,18.6978021978022,162,946.796980073738,-0.976015778270554
26209,529682.263,5324505.567,0,0,0,50.574,0,2008,0,99,313,170,0.848087292542084,3.5,19.1615384615385,71,946.796980073738,-0.976015778270554
26209,529682.263,5324505.567,0,0,0,53.762,0,2009,0,88,325,176,0.845046626886997,3.8,20.121978021978,88,946.796980073738,-0.976015778270554
26209,529682.263,5324505.567,0,0,0,54.977,0,2010,0,90,308,234,0.797111274648306,57.2,19.8230769230769,144,946.796980073738,-0.976015778270554
26209,529682.263,5324505.567,108,67,41,68.157,11,2011,3,58,323,233,0.802079627805168,98,19.0516483516484,175,946.796980073738,-0.976015778270554
26209,529682.263,5324505.567,0,0,0,74.719,0,2012,0,72,314,161,0.847096017750433,-1.5,20.4054945054945,89,946.796980073738,-0.976015778270554
26209,529682.263,5324505.567,86,65,21,46.923,0,2013,1,107,305,161,0.840689268344961,-195.6,20.9230769230769,54,946.796980073738,-0.976015778270554
26209,529682.263,5324505.567,85,83,2,112.325,14,2014,1,25,345,224,0.84126380440999,58.4,19.4978021978022,199,946.796980073738,-0.976015778270554
26209,529682.263,5324505.567,0,0,0,71.96,0,2015,0,76,333,153,0.752846208259725,-215.3,22.6472527472527,77,946.796980073738,-0.976015778270554
26209,529682.263,5324505.567,145,94,51,66.537,3,2016,2,89,346,185,0.845284436453548,-36.2,20.6758241758242,96,946.796980073738,-0.976015778270554
26209,529682.263,5324505.567,106,93,13,85.407,5,2017,1,59,324,161,0.809757509879952,-75,21.6263736263736,102,946.796980073738,-0.976015778270554
26209,529682.263,5324505.567,86,78,8,54.278,0,2018,1,91,326,168,0.829043871050489,-137.6,22.2901098901099,77,946.796980073738,-0.976015778270554
26209,529682.263,5324505.567,124,96,28,89.467,9,2019,1,61,343,169,0.821377973617207,-115.5,22.3538461538462,108,946.796980073738,-0.976015778270554
26209,529682.263,5324505.567,0,0,0,124.951,0,2020,0,16,328,177,0.823669192948284,-114.8,20.6901098901099,161,946.796980073738,-0.976015778270554
26377,529913.92,5336320.041,0,0,0,134.559,0,2001,2,34,307,169,0.840026554144136,-14.2,19.5065934065934,135,1116.32627170859,0.42107198140923
26377,529913.92,5336320.041,86,69,17,42.806,0,2002,1,106,334,250,0.803678264432002,3,19.4725274725275,144,1116.32627170859,0.42107198140923
26377,529913.92,5336320.041,144,94,50,45.822,6,2003,1,97,314,160,0.783547699588961,-209,24.2648351648352,63,1116.32627170859,0.42107198140923
26377,529913.92,5336320.041,145,105,40,50.19,0,2004,1,99,334,169,0.813671670212397,104,19.0769230769231,70,1116.32627170859,0.42107198140923
26377,529913.92,5336320.041,155,93,62,65.397,2,2005,2,90,312,161,0.832685252732139,-49.6,19.2098901098901,71,1116.32627170859,0.42107198140923
26377,529913.92,5336320.041,189,84,105,48.767,0,2006,2,104,341,162,0.808562296154655,25.1,20.1736263736264,58,1116.32627170859,0.42107198140923
26377,529913.92,5336320.041,0,0,0,74.433,0,2007,0,69,310,185,0.789668815782645,229.8,18.3494505494505,116,1116.32627170859,0.42107198140923
26377,529913.92,5336320.041,0,0,0,36.119,0,2008,0,112,312,170,0.848299068143608,8.90000000000001,18.8,58,1116.32627170859,0.42107198140923
26377,529913.92,5336320.041,164,102,62,36.436,0,2009,1,106,299,162,0.855814035046733,9.4,19.7494505494506,56,1116.32627170859,0.42107198140923
26377,529913.92,5336320.041,167,93,74,37.626,0,2010,1,107,310,170,0.806315619772043,64.4,19.4725274725275,63,1116.32627170859,0.42107198140923
26377,529913.92,5336320.041,85,62,23,46.325,0,2011,1,83,339,153,0.798777936719019,103.5,18.7505494505494,70,1116.32627170859,0.42107198140923
26377,529913.92,5336320.041,132,94,38,53.563,3,2012,1,98,322,169,0.829789754053579,3.2,20.1307692307692,71,1116.32627170859,0.42107198140923
26377,529913.92,5336320.041,167,132,35,71.818,14,2013,1,85,303,153,0.793712914511557,-190.8,20.5692307692308,68,1116.32627170859,0.42107198140923
26377,529913.92,5336320.041,133,57,76,55.514,3,2014,2,80,354,170,0.822396025021194,65.4,19.2153846153846,90,1116.32627170859,0.42107198140923
26377,529913.92,5336320.041,93,93,0,51.131,0,2015,1,98,343,160,0.825859577086846,-212.4,22.3164835164835,62,1116.32627170859,0.42107198140923
26377,529913.92,5336320.041,155,102,53,80.335,8,2016,1,76,333,185,0.824303478598106,-31.9,20.4131868131868,109,1116.32627170859,0.42107198140923
26377,529913.92,5336320.041,0,0,0,43.089,0,2017,0,99,321,170,0.809222274552439,-70.8,21.2648351648352,71,1116.32627170859,0.42107198140923
26377,529913.92,5336320.041,86,77,9,142.726,44,2018,1,15,316,168,0.810013042628402,-135.7,21.9263736263736,153,1116.32627170859,0.42107198140923
26377,529913.92,5336320.041,142,94,48,51.278,4,2019,1,97,338,161,0.810295242071965,-112.7,22.0065934065934,64,1116.32627170859,0.42107198140923
26377,529913.92,5336320.041,0,0,0,64.523,0,2020,0,69,312,178,0.803585574064385,-111.3,20.3164835164835,109,1116.32627170859,0.42107198140923
26378,529913.92,5336088.384,0,0,0,121.129,0,2001,2,45,304,160,0.834830278484528,-14.2,19.5065934065934,115,1134.420654995,1.05683696853606
26378,529913.92,5336088.384,86,66,20,39.312,0,2002,1,110,324,170,0.814754686320402,3,19.4725274725275,60,1134.420654995,1.05683696853606
26378,529913.92,5336088.384,152,123,29,36.225,1,2003,1,108,307,152,0.786282166476088,-209,24.2648351648352,44,1134.420654995,1.05683696853606
26378,529913.92,5336088.384,144,93,51,43.67,0,2004,1,105,329,169,0.826619517299121,104,19.0769230769231,64,1134.420654995,1.05683696853606
26378,529913.92,5336088.384,157,107,50,59.382,2,2005,1,96,312,154,0.837948734540741,-49.6,19.2098901098901,58,1134.420654995,1.05683696853606
26378,529913.92,5336088.384,188,84,104,52.496,1,2006,2,101,339,161,0.815404022152186,25.1,20.1736263736264,60,1134.420654995,1.05683696853606
26378,529913.92,5336088.384,0,0,0,60.449,0,2007,0,82,310,146,0.805501573778721,229.8,18.3494505494505,64,1134.420654995,1.05683696853606
26378,529913.92,5336088.384,0,0,0,30.268,0,2008,0,117,312,170,0.807759157661211,8.90000000000001,18.8,53,1134.420654995,1.05683696853606
26378,529913.92,5336088.384,160,102,58,47.794,0,2009,1,94,295,162,0.850752067785598,9.4,19.7494505494506,68,1134.420654995,1.05683696853606
26378,529913.92,5336088.384,169,108,61,31.478,0,2010,2,114,311,241,0.78382807582073,64.4,19.4725274725275,127,1134.420654995,1.05683696853606
26378,529913.92,5336088.384,84,62,22,43.851,0,2011,1,86,334,248,0.783433657604432,103.5,18.7505494505494,162,1134.420654995,1.05683696853606
26378,529913.92,5336088.384,134,93,41,48.182,1,2012,1,105,321,169,0.84367557169754,3.2,20.1307692307692,64,1134.420654995,1.05683696853606
26378,529913.92,5336088.384,171,130,41,50.11,0,2013,1,105,304,162,0.811472703392555,-190.8,20.5692307692308,57,1134.420654995,1.05683696853606
26378,529913.92,5336088.384,133,57,76,52.117,2,2014,2,84,345,161,0.830026850488999,65.4,19.2153846153846,77,1134.420654995,1.05683696853606
26378,529913.92,5336088.384,0,0,0,48.956,0,2015,0,100,335,153,0.823026563721344,-212.4,22.3164835164835,53,1134.420654995,1.05683696853606
26378,529913.92,5336088.384,157,97,60,69.641,4,2016,1,87,327,177,0.825799763725954,-31.9,20.4131868131868,90,1134.420654995,1.05683696853606
26378,529913.92,5336088.384,96,95,1,34.836,3,2017,1,110,317,168,0.796247483287358,-70.8,21.2648351648352,58,1134.420654995,1.05683696853606
26378,529913.92,5336088.384,86,77,9,84.537,9,2018,1,65,299,168,0.80309713793904,-135.7,21.9263736263736,103,1134.420654995,1.05683696853606
26378,529913.92,5336088.384,143,73,70,44.403,3,2019,2,104,339,160,0.811869343668051,-112.7,22.0065934065934,56,1134.420654995,1.05683696853606
26378,529913.92,5336088.384,0,0,0,43.058,0,2020,0,89,311,169,0.816658044968689,-111.3,20.3164835164835,80,1134.420654995,1.05683696853606
26379,529913.92,5335856.728,0,0,0,64.99,0,2001,3,91,296,168,0.840868849287691,-14.2,19.5065934065934,77,1154.1758457485,1.23939712357428
26379,529913.92,5335856.728,146,62,84,37.568,0,2002,3,112,327,250,0.824889066834653,3,19.4725274725275,138,1154.1758457485,1.23939712357428
26379,529913.92,5335856.728,157,108,49,34.681,0,2003,1,110,310,160,0.785123230924066,-209,24.2648351648352,50,1154.1758457485,1.23939712357428
26379,529913.92,5335856.728,153,99,54,42.658,0,2004,1,106,329,161,0.838065779758839,104,19.0769230769231,55,1154.1758457485,1.23939712357428
26379,529913.92,5335856.728,136,124,12,57.32,2,2005,1,98,317,161,0.820155851398695,-49.6,19.2098901098901,63,1154.1758457485,1.23939712357428
26379,529913.92,5335856.728,190,62,128,47.582,0,2006,2,105,341,154,0.825234787668241,25.1,20.1736263736264,49,1154.1758457485,1.23939712357428
26379,529913.92,5335856.728,0,0,0,73.271,0,2007,0,70,314,136,0.807224392755523,229.8,18.3494505494505,66,1154.1758457485,1.23939712357428
26379,529913.92,5335856.728,0,0,0,5.34,0,2008,0,147,305,218,0.832619954395794,8.90000000000001,18.8,71,1154.1758457485,1.23939712357428
26379,529913.92,5335856.728,164,68,96,36.436,0,2009,2,106,311,162,0.862978564361448,9.4,19.7494505494506,56,1154.1758457485,1.23939712357428
26379,529913.92,5335856.728,165,103,62,30.674,0,2010,1,115,304,177,0.812782500117868,64.4,19.4725274725275,62,1154.1758457485,1.23939712357428
26379,529913.92,5335856.728,85,71,14,40.374,0,2011,1,90,333,160,0.81085868013595,103.5,18.7505494505494,70,1154.1758457485,1.23939712357428
26379,529913.92,5335856.728,135,93,42,48.963,1,2012,1,104,307,168,0.850680538422505,3.2,20.1307692307692,64,1154.1758457485,1.23939712357428
26379,529913.92,5335856.728,171,93,78,44.677,0,2013,1,110,319,161,0.816896276132411,-190.8,20.5692307692308,51,1154.1758457485,1.23939712357428
26379,529913.92,5335856.728,83,62,21,60.635,3,2014,1,74,345,153,0.828029574721394,65.4,19.2153846153846,79,1154.1758457485,1.23939712357428
26379,529913.92,5335856.728,0,0,0,50.027,0,2015,0,99,341,146,0.82688832491622,-212.4,22.3164835164835,47,1154.1758457485,1.23939712357428
26379,529913.92,5335856.728,163,94,69,58.538,4,2016,2,98,326,200,0.805791220422983,-31.9,20.4131868131868,102,1154.1758457485,1.23939712357428
26379,529913.92,5335856.728,0,0,0,40.01,0,2017,0,103,323,161,0.800533476477027,-70.8,21.2648351648352,58,1154.1758457485,1.23939712357428
26379,529913.92,5335856.728,151,126,25,63.985,2,2018,1,83,303,162,0.802065710040378,-135.7,21.9263736263736,79,1154.1758457485,1.23939712357428
26379,529913.92,5335856.728,137,102,35,42.477,2,2019,1,106,338,161,0.812564124372781,-112.7,22.0065934065934,55,1154.1758457485,1.23939712357428
26379,529913.92,5335856.728,0,0,0,38.628,0,2020,0,94,309,169,0.82375096603013,-111.3,20.3164835164835,75,1154.1758457485,1.23939712357428
26380,529913.92,5335625.072,0,0,0,61.609,0,2001,1,94,300,169,0.841307611280247,-14.2,19.5065934065934,75,1153.2918680112,0.664665309843242
26380,529913.92,5335625.072,146,63,83,37.568,0,2002,2,112,325,170,0.82380782266693,3,19.4725274725275,58,1153.2918680112,0.664665309843242
26380,529913.92,5335625.072,157,104,53,39.544,1,2003,1,104,332,153,0.804304889108467,-209,24.2648351648352,49,1153.2918680112,0.664665309843242
26380,529913.92,5335625.072,154,111,43,47.934,0,2004,1,101,331,154,0.809115065661004,104,19.0769230769231,53,1153.2918680112,0.664665309843242
26380,529913.92,5335625.072,0,0,0,68.604,0,2005,0,87,317,161,0.807323035367947,-49.6,19.2098901098901,74,1153.2918680112,0.664665309843242
26380,529913.92,5335625.072,193,62,131,37.791,0,2006,3,114,339,272,0.813418440194423,25.1,20.1736263736264,158,1153.2918680112,0.664665309843242
26380,529913.92,5335625.072,0,0,0,69.953,0,2007,0,73,316,233,0.783268875143139,229.8,18.3494505494505,160,1153.2918680112,0.664665309843242
26380,529913.92,5335625.072,0,0,0,38.377,0,2008,0,110,308,192,0.816482170124518,8.90000000000001,18.8,82,1153.2918680112,0.664665309843242
26380,529913.92,5335625.072,165,69,96,36.436,0,2009,2,106,320,161,0.86014390960975,9.4,19.7494505494506,55,1153.2918680112,0.664665309843242
26380,529913.92,5335625.072,163,93,70,34.883,0,2010,2,110,311,185,0.826448452214985,64.4,19.4725274725275,75,1153.2918680112,0.664665309843242
26380,529913.92,5335625.072,86,73,13,43.851,0,2011,1,86,337,248,0.792432677845847,103.5,18.7505494505494,162,1153.2918680112,0.664665309843242
26380,529913.92,5335625.072,131,93,38,48.963,1,2012,1,104,314,169,0.845965339265795,3.2,20.1307692307692,65,1153.2918680112,0.664665309843242
26380,529913.92,5335625.072,171,95,76,45.704,0,2013,1,109,316,170,0.829138148171409,-190.8,20.5692307692308,61,1153.2918680112,0.664665309843242
26380,529913.92,5335625.072,93,62,31,61.527,3,2014,2,73,345,153,0.82121593097478,65.4,19.2153846153846,80,1153.2918680112,0.664665309843242
26380,529913.92,5335625.072,0,0,0,53.435,0,2015,0,96,345,152,0.812065520338432,-212.4,22.3164835164835,56,1153.2918680112,0.664665309843242
26380,529913.92,5335625.072,156,96,60,77.264,6,2016,2,79,326,193,0.816768262204421,-31.9,20.4131868131868,114,1153.2918680112,0.664665309843242
26380,529913.92,5335625.072,0,0,0,40.01,0,2017,0,103,321,169,0.803278343515637,-70.8,21.2648351648352,66,1153.2918680112,0.664665309843242
26380,529913.92,5335625.072,166,119,47,43.274,0,2018,1,102,315,161,0.877193982402794,-135.7,21.9263736263736,59,1153.2918680112,0.664665309843242
26380,529913.92,5335625.072,134,94,40,48.37,4,2019,1,100,336,161,0.80091945834303,-112.7,22.0065934065934,61,1153.2918680112,0.664665309843242
26380,529913.92,5335625.072,0,0,0,89.233,0,2020,0,49,310,170,0.805257872366036,-111.3,20.3164835164835,121,1153.2918680112,0.664665309843242
26381,529913.92,5335393.415,0,0,0,58.246,0,2001,1,97,326,161,0.827876107016281,-14.2,19.5065934065934,64,1138.79743702015,-1.1094422272775
26381,529913.92,5335393.415,128,75,53,54.257,1,2002,2,93,302,169,0.821099844621181,3,19.4725274725275,76,1138.79743702015,-1.1094422272775
26381,529913.92,5335393.415,153,108,45,45.822,6,2003,1,97,329,153,0.777564267191629,-209,24.2648351648352,56,1138.79743702015,-1.1094422272775
26381,529913.92,5335393.415,152,94,58,60.289,0,2004,1,89,336,154,0.82532117759496,104,19.0769230769231,65,1138.79743702015,-1.1094422272775
26381,529913.92,5335393.415,0,0,0,67.531,0,2005,0,88,318,152,0.813567246746333,-49.6,19.2098901098901,64,1138.79743702015,-1.1094422272775
26381,529913.92,5335393.415,181,70,111,59.998,5,2006,2,95,341,162,0.799252390955566,25.1,20.1736263736264,67,1138.79743702015,-1.1094422272775
26381,529913.92,5335393.415,0,0,0,76.797,0,2007,0,67,320,146,0.824035791190137,229.8,18.3494505494505,79,1138.79743702015,-1.1094422272775
26381,529913.92,5335393.415,0,0,0,50.356,0,2008,0,100,314,226,0.838316055818015,8.90000000000001,18.8,126,1138.79743702015,-1.1094422272775
26381,529913.92,5335393.415,157,67,90,39.905,0,2009,2,102,314,154,0.842311542553893,9.4,19.7494505494506,52,1138.79743702015,-1.1094422272775
26381,529913.92,5335393.415,162,93,69,34.008,0,2010,1,111,318,177,0.816747173934964,64.4,19.4725274725275,66,1138.79743702015,-1.1094422272775
26381,529913.92,5335393.415,127,93,34,45.487,0,2011,2,84,342,185,0.777391156155304,103.5,18.7505494505494,101,1138.79743702015,-1.1094422272775
26381,529913.92,5335393.415,145,94,51,53.563,3,2012,1,98,321,162,0.847366052789114,3.2,20.1307692307692,64,1138.79743702015,-1.1094422272775
26381,529913.92,5335393.415,86,79,7,85.774,23,2013,1,73,320,169,0.817249632062789,-190.8,20.5692307692308,96,1138.79743702015,-1.1094422272775
26381,529913.92,5335393.415,93,93,0,60.635,3,2014,1,74,318,153,0.822439115932328,65.4,19.2153846153846,79,1138.79743702015,-1.1094422272775
26381,529913.92,5335393.415,144,93,51,55.859,3,2015,1,94,347,146,0.805534795527641,-212.4,22.3164835164835,52,1138.79743702015,-1.1094422272775
26381,529913.92,5335393.415,159,94,65,79.294,7,2016,2,77,331,210,0.750426954834867,-31.9,20.4131868131868,133,1138.79743702015,-1.1094422272775
26381,529913.92,5335393.415,123,93,30,54.858,5,2017,1,86,322,162,0.799909613382247,-70.8,21.2648351648352,76,1138.79743702015,-1.1094422272775
26381,529913.92,5335393.415,167,118,49,48.573,0,2018,1,97,314,145,0.823431735527793,-135.7,21.9263736263736,48,1138.79743702015,-1.1094422272775
26381,529913.92,5335393.415,134,103,31,50.316,4,2019,1,98,330,160,0.797386515836742,-112.7,22.0065934065934,62,1138.79743702015,-1.1094422272775
26381,529913.92,5335393.415,96,93,3,73.581,15,2020,1,62,311,177,0.814968594997091,-111.3,20.3164835164835,115,1138.79743702015,-1.1094422272775
26424,529913.92,5325432.192,0,0,0,47.808,0,2001,0,105,276,176,0.872057287376986,-19.6,19.9175824175824,71,1225.57039716404,-1.10208762793379
26424,529913.92,5325432.192,148,52,96,37.793,0,2002,3,111,320,185,0.847538075017488,-1.5,19.8516483516484,74,1225.57039716404,-1.10208762793379
26424,529913.92,5325432.192,145,93,52,34.683,1,2003,1,109,316,169,0.868073003781703,-210.6,24.6406593406593,60,1225.57039716404,-1.10208762793379
26424,529913.92,5325432.192,147,93,54,33.456,0,2004,1,115,323,177,0.890346729971541,98,19.4571428571429,62,1225.57039716404,-1.10208762793379
26424,529913.92,5325432.192,0,0,0,52.841,0,2005,0,101,306,162,0.84657431554228,-53,19.5769230769231,61,1225.57039716404,-1.10208762793379
26424,529913.92,5325432.192,182,60,122,33.196,0,2006,2,118,337,170,0.875155724614738,20.9,20.5340659340659,52,1225.57039716404,-1.10208762793379
26424,529913.92,5325432.192,159,93,66,49.79,0,2007,2,91,304,193,0.851792554599272,221.4,18.6978021978022,102,1225.57039716404,-1.10208762793379
26424,529913.92,5325432.192,86,68,18,32.127,0,2008,1,115,309,169,0.909307827759804,3.5,19.1615384615385,54,1225.57039716404,-1.10208762793379
26424,529913.92,5325432.192,151,69,82,36.597,0,2009,2,105,313,153,0.855464376231927,3.8,20.121978021978,48,1225.57039716404,-1.10208762793379
26424,529913.92,5325432.192,164,111,53,29.343,0,2010,1,116,304,177,0.890557478700207,57.2,19.8230769230769,61,1225.57039716404,-1.10208762793379
26424,529913.92,5325432.192,84,69,15,37.376,0,2011,1,93,321,168,0.850045998391171,98,19.0516483516484,75,1225.57039716404,-1.10208762793379
26424,529913.92,5325432.192,93,93,0,48.052,1,2012,1,104,310,169,0.900434899776384,-1.5,20.4054945054945,65,1225.57039716404,-1.10208762793379
26424,529913.92,5325432.192,174,78,96,40.853,0,2013,2,113,305,169,0.864243330723839,-195.6,20.9230769230769,56,1225.57039716404,-1.10208762793379
26424,529913.92,5325432.192,0,0,0,42.451,0,2014,0,95,341,154,0.871129875227938,58.4,19.4978021978022,59,1225.57039716404,-1.10208762793379
26424,529913.92,5325432.192,0,0,0,48.182,0,2015,0,100,323,161,0.868329137407851,-215.3,22.6472527472527,61,1225.57039716404,-1.10208762793379
26424,529913.92,5325432.192,163,101,62,48.386,3,2016,1,107,325,176,0.915079546950493,-36.2,20.6758241758242,69,1225.57039716404,-1.10208762793379
26424,529913.92,5325432.192,145,104,41,32.726,1,2017,1,112,305,168,0.851186399951098,-75,21.6263736263736,56,1225.57039716404,-1.10208762793379
26424,529913.92,5325432.192,85,66,19,48.846,0,2018,1,96,326,169,0.851540467655203,-137.6,22.2901098901099,73,1225.57039716404,-1.10208762793379
26424,529913.92,5325432.192,0,0,0,36.212,0,2019,0,112,331,169,0.845872672056068,-115.5,22.3538461538462,57,1225.57039716404,-1.10208762793379
26424,529913.92,5325432.192,0,0,0,34.687,0,2020,0,98,299,162,0.810736743897596,-114.8,20.6901098901099,64,1225.57039716404,-1.10208762793379
26428,529913.92,5324505.567,0,0,0,64.893,0,2001,1,90,340,168,0.842933841017218,-19.6,19.9175824175824,78,1018.15491515466,-1.2548514386917
26428,529913.92,5324505.567,0,0,0,64.306,0,2002,0,83,341,154,0.802496212803596,-1.5,19.8516483516484,71,1018.15491515466,-1.2548514386917
26428,529913.92,5324505.567,0,0,0,47.567,0,2003,0,94,328,154,0.840952945480415,-210.6,24.6406593406593,60,1018.15491515466,-1.2548514386917
26428,529913.92,5324505.567,0,0,0,53.54,0,2004,0,95,337,162,0.821991918677978,98,19.4571428571429,67,1018.15491515466,-1.2548514386917
26428,529913.92,5324505.567,141,93,48,68.459,2,2005,2,86,316,154,0.833457316580005,-53,19.5769230769231,68,1018.15491515466,-1.2548514386917
26428,529913.92,5324505.567,174,72,102,38.913,0,2006,2,112,342,168,0.82906472739512,20.9,20.5340659340659,56,1018.15491515466,-1.2548514386917
26428,529913.92,5324505.567,0,0,0,79.399,0,2007,0,64,308,209,0.803810445211212,221.4,18.6978021978022,145,1018.15491515466,-1.2548514386917
26428,529913.92,5324505.567,0,0,0,41.227,0,2008,0,107,312,194,0.825867655720752,3.5,19.1615384615385,87,1018.15491515466,-1.2548514386917
26428,529913.92,5324505.567,93,93,0,41.943,0,2009,1,99,319,169,0.854207194544388,3.8,20.121978021978,70,1018.15491515466,-1.2548514386917
26428,529913.92,5324505.567,0,0,0,48.135,0,2010,0,96,312,162,0.792229820568013,57.2,19.8230769230769,66,1018.15491515466,-1.2548514386917
26428,529913.92,5324505.567,109,70,39,51.913,3,2011,3,76,322,226,0.787649071592446,98,19.0516483516484,150,1018.15491515466,-1.2548514386917
26428,529913.92,5324505.567,93,93,0,63.602,3,2012,1,84,307,162,0.852997678954448,-1.5,20.4054945054945,78,1018.15491515466,-1.2548514386917
26428,529913.92,5324505.567,82,62,20,39.897,0,2013,1,114,298,169,0.851809359700692,-195.6,20.9230769230769,55,1018.15491515466,-1.2548514386917
26428,529913.92,5324505.567,85,83,2,101.691,7,2014,1,35,345,218,0.816206026197595,58.4,19.4978021978022,183,1018.15491515466,-1.2548514386917
26428,529913.92,5324505.567,0,0,0,61.524,0,2015,0,88,341,161,0.860203450540036,-215.3,22.6472527472527,73,1018.15491515466,-1.2548514386917
26428,529913.92,5324505.567,146,103,43,62.507,3,2016,1,93,339,186,0.838371244999967,-36.2,20.6758241758242,93,1018.15491515466,-1.2548514386917
26428,529913.92,5324505.567,108,93,15,63.667,4,2017,1,77,321,162,0.807965519419853,-75,21.6263736263736,85,1018.15491515466,-1.2548514386917
26428,529913.92,5324505.567,86,77,9,53.183,0,2018,1,92,322,160,0.843401926384241,-137.6,22.2901098901099,68,1018.15491515466,-1.2548514386917
26428,529913.92,5324505.567,126,97,29,67.167,5,2019,1,80,341,169,0.816728185713333,-115.5,22.3538461538462,89,1018.15491515466,-1.2548514386917
26428,529913.92,5324505.567,0,0,0,124.951,0,2020,0,16,324,176,0.815419835889928,-114.8,20.6901098901099,160,1018.15491515466,-1.2548514386917
26596,530145.576,5336320.041,0,0,0,137.949,0,2001,1,31,328,162,0.820142774165535,-14.2,19.5065934065934,131,1073.5570020303,1.31789002341407
26596,530145.576,5336320.041,116,77,39,56.249,1,2002,2,91,338,161,0.805108744151922,3,19.4725274725275,70,1073.5570020303,1.31789002341407
26596,530145.576,5336320.041,143,94,49,51.4,9,2003,1,91,320,153,0.795969501703923,-209,24.2648351648352,62,1073.5570020303,1.31789002341407
26596,530145.576,5336320.041,144,93,51,53.489,0,2004,1,96,332,154,0.817991045225757,104,19.0769230769231,58,1073.5570020303,1.31789002341407
26596,530145.576,5336320.041,0,0,0,127.071,0,2005,0,34,319,154,0.830876628422367,-49.6,19.2098901098901,120,1073.5570020303,1.31789002341407
26596,530145.576,5336320.041,197,93,104,29.272,0,2006,2,123,342,162,0.801936295985971,25.1,20.1736263736264,39,1073.5570020303,1.31789002341407
26596,530145.576,5336320.041,0,0,0,83.351,0,2007,0,62,312,232,0.790174429717677,229.8,18.3494505494505,170,1073.5570020303,1.31789002341407
26596,530145.576,5336320.041,0,0,0,70.554,0,2008,0,82,308,177,0.819469014079168,8.90000000000001,18.8,95,1073.5570020303,1.31789002341407
26596,530145.576,5336320.041,164,63,101,39.905,0,2009,2,102,321,160,0.845396446055944,9.4,19.7494505494506,58,1073.5570020303,1.31789002341407
26596,530145.576,5336320.041,164,110,54,44.595,0,2010,1,100,313,169,0.803193200654513,64.4,19.4725274725275,69,1073.5570020303,1.31789002341407
26596,530145.576,5336320.041,0,0,0,60.356,0,2011,0,67,337,233,0.781808054839818,103.5,18.7505494505494,166,1073.5570020303,1.31789002341407
26596,530145.576,5336320.041,127,93,34,59.714,4,2012,1,90,321,161,0.84231325360487,3.2,20.1307692307692,71,1073.5570020303,1.31789002341407
26596,530145.576,5336320.041,173,93,80,53.875,0,2013,1,102,319,154,0.812145636661221,-190.8,20.5692307692308,52,1073.5570020303,1.31789002341407
26596,530145.576,5336320.041,86,70,16,62.436,3,2014,1,72,348,161,0.808924474991785,65.4,19.2153846153846,89,1073.5570020303,1.31789002341407
26596,530145.576,5336320.041,93,93,0,64.337,4,2015,1,86,347,146,0.798396095667195,-212.4,22.3164835164835,60,1073.5570020303,1.31789002341407
26596,530145.576,5336320.041,165,94,71,76.276,6,2016,1,80,333,178,0.808063719687439,-31.9,20.4131868131868,98,1073.5570020303,1.31789002341407
26596,530145.576,5336320.041,127,96,31,50.938,5,2017,1,90,320,161,0.784302285005906,-70.8,21.2648351648352,71,1073.5570020303,1.31789002341407
26596,530145.576,5336320.041,166,77,89,53.026,0,2018,3,93,317,137,0.766550679002368,-135.7,21.9263736263736,44,1073.5570020303,1.31789002341407
26596,530145.576,5336320.041,142,94,48,54.192,6,2019,1,94,332,153,0.8034568870532,-112.7,22.0065934065934,59,1073.5570020303,1.31789002341407
26596,530145.576,5336320.041,0,0,0,67.166,0,2020,0,67,321,178,0.78477995352392,-111.3,20.3164835164835,111,1073.5570020303,1.31789002341407
26597,530145.576,5336088.384,0,0,0,79.376,0,2001,1,80,316,161,0.819059266788282,-14.2,19.5065934065934,81,1089.37607304942,-0.490566250284959
26597,530145.576,5336088.384,118,75,43,40.18,0,2002,2,109,321,169,0.812838751250889,3,19.4725274725275,60,1089.37607304942,-0.490566250284959
26597,530145.576,5336088.384,146,93,53,37.023,1,2003,1,107,285,160,0.806843330614712,-209,24.2648351648352,53,1089.37607304942,-0.490566250284959
26597,530145.576,5336088.384,147,100,47,41.665,0,2004,2,107,328,210,0.800705211968016,104,19.0769230769231,103,1089.37607304942,-0.490566250284959
26597,530145.576,5336088.384,0,0,0,69.684,0,2005,0,86,313,154,0.837751985195776,-49.6,19.2098901098901,68,1089.37607304942,-0.490566250284959
26597,530145.576,5336088.384,196,84,112,32.024,0,2006,3,120,341,161,0.821026577254725,25.1,20.1736263736264,41,1089.37607304942,-0.490566250284959
26597,530145.576,5336088.384,0,0,0,72.138,0,2007,0,71,305,138,0.801038043901312,229.8,18.3494505494505,67,1089.37607304942,-0.490566250284959
26597,530145.576,5336088.384,0,0,0,30.268,0,2008,0,117,314,178,0.815603396300539,8.90000000000001,18.8,61,1089.37607304942,-0.490566250284959
26597,530145.576,5336088.384,159,67,92,57.316,0,2009,2,86,314,160,0.852757564766975,9.4,19.7494505494506,74,1089.37607304942,-0.490566250284959
26597,530145.576,5336088.384,165,102,63,34.883,0,2010,2,110,313,232,0.796879016312489,64.4,19.4725274725275,122,1089.37607304942,-0.490566250284959
26597,530145.576,5336088.384,0,0,0,44.664,0,2011,0,85,337,264,0.794564986948126,103.5,18.7505494505494,179,1089.37607304942,-0.490566250284959
26597,530145.576,5336088.384,133,93,40,48.182,1,2012,1,105,322,161,0.843824037296523,3.2,20.1307692307692,56,1089.37607304942,-0.490566250284959
26597,530145.576,5336088.384,174,93,81,47.834,0,2013,1,107,312,160,0.799214281101078,-190.8,20.5692307692308,53,1089.37607304942,-0.490566250284959
26597,530145.576,5336088.384,86,67,19,52.117,2,2014,1,84,346,161,0.824148359823566,65.4,19.2153846153846,77,1089.37607304942,-0.490566250284959
26597,530145.576,5336088.384,0,0,0,43.066,0,2015,0,106,337,153,0.789108291792507,-212.4,22.3164835164835,47,1089.37607304942,-0.490566250284959
26597,530145.576,5336088.384,167,94,73,66.735,4,2016,2,90,324,194,0.808728734747871,-31.9,20.4131868131868,104,1089.37607304942,-0.490566250284959
26597,530145.576,5336088.384,128,93,35,38.554,5,2017,1,105,319,161,0.78110994599861,-70.8,21.2648351648352,56,1089.37607304942,-0.490566250284959
26597,530145.576,5336088.384,162,78,84,51.946,0,2018,2,94,298,162,0.787584907329658,-135.7,21.9263736263736,68,1089.37607304942,-0.490566250284959
26597,530145.576,5336088.384,145,70,75,41.524,2,2019,2,107,331,154,0.815124697039428,-112.7,22.0065934065934,47,1089.37607304942,-0.490566250284959
26597,530145.576,5336088.384,0,0,0,43.058,0,2020,0,89,315,170,0.795215989171178,-111.3,20.3164835164835,81,1089.37607304942,-0.490566250284959
26600,530145.576,5335393.415,0,0,0,59.381,0,2001,2,96,303,169,0.813126772662719,-14.2,19.5065934065934,73,1211.50073566416,-1.37803408353606
26600,530145.576,5335393.415,86,68,18,38.434,0,2002,1,111,300,176,0.798144580149387,3,19.4725274725275,65,1211.50073566416,-1.37803408353606
26600,530145.576,5335393.415,146,97,49,31.461,0,2003,1,114,277,168,0.789115324836992,-209,24.2648351648352,54,1211.50073566416,-1.37803408353606
26600,530145.576,5335393.415,149,25,124,47.934,0,2004,2,101,333,161,0.805055496558224,104,19.0769230769231,60,1211.50073566416,-1.37803408353606
26600,530145.576,5335393.415,0,0,0,67.531,0,2005,0,88,317,154,0.787566017877487,-49.6,19.2098901098901,66,1211.50073566416,-1.37803408353606
26600,530145.576,5335393.415,189,68,121,37.791,0,2006,2,114,337,169,0.790103943648608,25.1,20.1736263736264,55,1211.50073566416,-1.37803408353606
26600,530145.576,5335393.415,0,0,0,49.487,0,2007,0,92,314,224,0.779005978058305,229.8,18.3494505494505,132,1211.50073566416,-1.37803408353606
26600,530145.576,5335393.415,0,0,0,33.811,0,2008,0,114,309,177,0.825436201190883,8.90000000000001,18.8,63,1211.50073566416,-1.37803408353606
26600,530145.576,5335393.415,158,68,90,47.794,0,2009,2,94,299,162,0.852162542998823,9.4,19.7494505494506,68,1211.50073566416,-1.37803408353606
26600,530145.576,5335393.415,173,93,80,34.008,0,2010,1,111,305,178,0.817652447891619,64.4,19.4725274725275,67,1211.50073566416,-1.37803408353606
26600,530145.576,5335393.415,85,64,21,40.374,0,2011,1,90,336,185,0.778330250470327,103.5,18.7505494505494,95,1211.50073566416,-1.37803408353606
26600,530145.576,5335393.415,0,0,0,48.963,0,2012,0,104,303,177,0.785676444810592,3.2,20.1307692307692,73,1211.50073566416,-1.37803408353606
26600,530145.576,5335393.415,180,60,120,34.699,0,2013,2,120,316,177,0.826929786612319,-190.8,20.5692307692308,57,1211.50073566416,-1.37803408353606
26600,530145.576,5335393.415,86,68,18,52.117,2,2014,1,84,335,168,0.815568412739072,65.4,19.2153846153846,84,1211.50073566416,-1.37803408353606
26600,530145.576,5335393.415,0,0,0,46.902,0,2015,0,102,325,153,0.811741447423922,-212.4,22.3164835164835,51,1211.50073566416,-1.37803408353606
26600,530145.576,5335393.415,168,107,61,54.433,4,2016,1,102,337,161,0.788178096356943,-31.9,20.4131868131868,59,1211.50073566416,-1.37803408353606
26600,530145.576,5335393.415,110,93,17,40.01,5,2017,1,103,311,169,0.80995206604719,-70.8,21.2648351648352,66,1211.50073566416,-1.37803408353606
26600,530145.576,5335393.415,155,71,84,49.707,0,2018,3,96,312,193,0.755285041100604,-135.7,21.9263736263736,97,1211.50073566416,-1.37803408353606
26600,530145.576,5335393.415,151,94,57,34.312,2,2019,1,115,326,169,0.799314408519175,-112.7,22.0065934065934,54,1211.50073566416,-1.37803408353606
26600,530145.576,5335393.415,93,93,0,38.628,1,2020,2,94,309,185,0.80051734015025,-111.3,20.3164835164835,91,1211.50073566416,-1.37803408353606
26601,530145.576,5335161.759,0,0,0,88.597,0,2001,2,73,303,162,0.814729908202392,-14.2,19.5065934065934,89,1212.17007006885,-1.49031457721046
26601,530145.576,5335161.759,86,68,18,46.254,0,2002,1,102,298,169,0.799771519820279,3,19.4725274725275,67,1212.17007006885,-1.49031457721046
26601,530145.576,5335161.759,147,93,54,37.843,1,2003,1,106,288,154,0.796165096564854,-209,24.2648351648352,48,1212.17007006885,-1.49031457721046
26601,530145.576,5335161.759,147,26,121,56.34,0,2004,2,93,332,162,0.813688740384417,104,19.0769230769231,69,1212.17007006885,-1.49031457721046
26601,530145.576,5335161.759,0,0,0,127.071,0,2005,0,34,318,153,0.828328348945472,-49.6,19.2098901098901,119,1212.17007006885,-1.49031457721046
26601,530145.576,5335161.759,199,68,131,14.659,0,2006,3,139,339,178,0.783429245200981,25.1,20.1736263736264,39,1212.17007006885,-1.49031457721046
26601,530145.576,5335161.759,93,93,0,64.821,8,2007,1,78,313,138,0.785250803010323,229.8,18.3494505494505,60,1212.17007006885,-1.49031457721046
26601,530145.576,5335161.759,86,85,1,33.811,0,2008,1,114,307,225,0.810286663212458,8.90000000000001,18.8,111,1212.17007006885,-1.49031457721046
26601,530145.576,5335161.759,161,64,97,40.816,0,2009,2,101,296,161,0.852755353568414,9.4,19.7494505494506,60,1212.17007006885,-1.49031457721046
26601,530145.576,5335161.759,172,121,51,32.305,0,2010,1,113,310,178,0.818122880761321,64.4,19.4725274725275,65,1212.17007006885,-1.49031457721046
26601,530145.576,5335161.759,82,63,19,42.125,0,2011,1,88,336,161,0.816899489310428,103.5,18.7505494505494,73,1212.17007006885,-1.49031457721046
26601,530145.576,5335161.759,0,0,0,51.29,0,2012,0,101,306,186,0.785538087076576,3.2,20.1307692307692,85,1212.17007006885,-1.49031457721046
26601,530145.576,5335161.759,178,61,117,40.689,0,2013,2,114,316,176,0.813165648998849,-190.8,20.5692307692308,62,1212.17007006885,-1.49031457721046
26601,530145.576,5335161.759,84,66,18,49.523,0,2014,1,87,339,161,0.821271187160477,65.4,19.2153846153846,74,1212.17007006885,-1.49031457721046
26601,530145.576,5335161.759,0,0,0,54.636,0,2015,0,95,337,152,0.807696993670693,-212.4,22.3164835164835,57,1212.17007006885,-1.49031457721046
26601,530145.576,5335161.759,169,126,43,55.433,4,2016,2,101,329,234,0.770324481364123,-31.9,20.4131868131868,133,1212.17007006885,-1.49031457721046
26601,530145.576,5335161.759,110,93,17,52.855,5,2017,1,88,313,169,0.801240553104096,-70.8,21.2648351648352,81,1212.17007006885,-1.49031457721046
26601,530145.576,5335161.759,152,72,80,58.628,1,2018,2,88,315,177,0.770824865186635,-135.7,21.9263736263736,89,1212.17007006885,-1.49031457721046
26601,530145.576,5335161.759,145,94,51,44.403,3,2019,1,104,337,162,0.790638715748917,-112.7,22.0065934065934,58,1212.17007006885,-1.49031457721046
26601,530145.576,5335161.759,93,93,0,44.874,7,2020,1,87,302,177,0.81742180554551,-111.3,20.3164835164835,90,1212.17007006885,-1.49031457721046
26644,530145.576,5325200.536,0,0,0,45.47,0,2001,2,107,315,177,0.845714968600802,-19.6,19.9175824175824,70,1196.10077574557,-1.47967354839333
26644,530145.576,5325200.536,113,85,28,37.793,0,2002,2,111,297,177,0.840992107104312,-1.5,19.8516483516484,66,1196.10077574557,-1.47967354839333
26644,530145.576,5325200.536,152,63,89,36.226,1,2003,2,107,316,160,0.839228081891168,-210.6,24.6406593406593,53,1196.10077574557,-1.47967354839333
26644,530145.576,5325200.536,145,93,52,35.297,0,2004,1,113,328,170,0.858471413675663,98,19.4571428571429,57,1196.10077574557,-1.47967354839333
26644,530145.576,5325200.536,143,93,50,53.978,1,2005,1,100,311,168,0.852631465389092,-53,19.5769230769231,68,1196.10077574557,-1.47967354839333
26644,530145.576,5325200.536,170,61,109,32.248,0,2006,2,119,336,169,0.839110097396177,20.9,20.5340659340659,50,1196.10077574557,-1.47967354839333
26644,530145.576,5325200.536,0,0,0,56.179,0,2007,0,85,304,186,0.842801115356942,221.4,18.6978021978022,101,1196.10077574557,-1.47967354839333
26644,530145.576,5325200.536,0,0,0,28.738,0,2008,0,118,308,168,0.87951200400717,3.5,19.1615384615385,50,1196.10077574557,-1.47967354839333
26644,530145.576,5325200.536,167,66,101,35.769,0,2009,2,106,276,168,0.874828380220852,3.8,20.121978021978,62,1196.10077574557,-1.47967354839333
26644,530145.576,5325200.536,166,109,57,29.343,0,2010,1,116,306,176,0.854025262419917,57.2,19.8230769230769,60,1196.10077574557,-1.47967354839333
26644,530145.576,5325200.536,83,65,18,39.106,0,2011,1,91,322,185,0.807276247887041,98,19.0516483516484,94,1196.10077574557,-1.47967354839333
26644,530145.576,5325200.536,145,93,52,48.826,1,2012,1,103,304,162,0.867417349994185,-1.5,20.4054945054945,59,1196.10077574557,-1.47967354839333
26644,530145.576,5325200.536,180,93,87,39.897,0,2013,1,114,298,162,0.862993159871032,-195.6,20.9230769230769,48,1196.10077574557,-1.47967354839333
26644,530145.576,5325200.536,93,93,0,45.518,0,2014,1,91,339,160,0.833323996957345,58.4,19.4978021978022,69,1196.10077574557,-1.47967354839333
26644,530145.576,5325200.536,93,93,0,44.228,0,2015,1,104,317,160,0.860408423782113,-215.3,22.6472527472527,56,1196.10077574557,-1.47967354839333
26644,530145.576,5325200.536,166,119,47,46.041,3,2016,1,109,321,178,0.851788101724225,-36.2,20.6758241758242,69,1196.10077574557,-1.47967354839333
26644,530145.576,5325200.536,0,0,0,43.184,0,2017,0,98,311,161,0.815815706871543,-75,21.6263736263736,63,1196.10077574557,-1.47967354839333
26644,530145.576,5325200.536,0,0,0,58.689,0,2018,0,87,326,161,0.841721431119832,-137.6,22.2901098901099,74,1196.10077574557,-1.47967354839333
26644,530145.576,5325200.536,140,93,47,37.974,2,2019,1,110,335,168,0.819262634891204,-115.5,22.3538461538462,58,1196.10077574557,-1.47967354839333
26644,530145.576,5325200.536,0,0,0,33.916,0,2020,0,99,305,162,0.769933890353086,-114.8,20.6901098901099,63,1196.10077574557,-1.47967354839333
26645,530145.576,5324968.879,0,0,0,50.069,0,2001,1,103,334,176,0.841093811359286,-19.6,19.9175824175824,73,1152.11898281025,1.23494341485121
26645,530145.576,5324968.879,114,86,28,42.121,0,2002,2,106,294,170,0.831259969251965,-1.5,19.8516483516484,64,1152.11898281025,1.23494341485121
26645,530145.576,5324968.879,148,61,87,37.85,1,2003,2,105,311,161,0.841428456144322,-210.6,24.6406593406593,56,1152.11898281025,1.23494341485121
26645,530145.576,5324968.879,142,93,49,39.077,0,2004,1,109,332,170,0.838735948783942,98,19.4571428571429,61,1152.11898281025,1.23494341485121
26645,530145.576,5324968.879,0,0,0,82.549,0,2005,0,73,311,161,0.848066078380163,-53,19.5769230769231,88,1152.11898281025,1.23494341485121
26645,530145.576,5324968.879,168,61,107,38.913,0,2006,2,112,340,169,0.814933078984,20.9,20.5340659340659,57,1152.11898281025,1.23494341485121
26645,530145.576,5324968.879,0,0,0,66.867,0,2007,0,75,314,210,0.786605731141271,221.4,18.6978021978022,135,1152.11898281025,1.23494341485121
26645,530145.576,5324968.879,0,0,0,32.127,0,2008,0,115,304,169,0.858365097804425,3.5,19.1615384615385,54,1152.11898281025,1.23494341485121
26645,530145.576,5324968.879,165,64,101,36.597,0,2009,2,105,275,168,0.863590183881952,3.8,20.121978021978,63,1152.11898281025,1.23494341485121
26645,530145.576,5324968.879,165,105,60,30.115,0,2010,1,115,306,176,0.834100696236412,57.2,19.8230769230769,61,1152.11898281025,1.23494341485121
26645,530145.576,5324968.879,85,66,19,46.699,0,2011,1,82,323,226,0.780503159518525,98,19.0516483516484,144,1152.11898281025,1.23494341485121
26645,530145.576,5324968.879,142,93,49,52.58,2,2012,1,98,302,162,0.853933265856496,-1.5,20.4054945054945,64,1152.11898281025,1.23494341485121
26645,530145.576,5324968.879,177,93,84,37.152,0,2013,1,117,306,169,0.840436120786335,-195.6,20.9230769230769,52,1152.11898281025,1.23494341485121
26645,530145.576,5324968.879,0,0,0,55.522,0,2014,0,79,343,168,0.796936560418504,58.4,19.4978021978022,89,1152.11898281025,1.23494341485121
26645,530145.576,5324968.879,0,0,0,53.74,0,2015,0,95,319,154,0.817737812841168,-215.3,22.6472527472527,59,1152.11898281025,1.23494341485121
26645,530145.576,5324968.879,163,97,66,54.435,3,2016,1,101,322,169,0.865428578977283,-36.2,20.6758241758242,68,1152.11898281025,1.23494341485121
26645,530145.576,5324968.879,97,96,1,41.588,4,2017,1,100,313,161,0.790604806465558,-75,21.6263736263736,61,1152.11898281025,1.23494341485121
26645,530145.576,5324968.879,0,0,0,46.651,0,2018,0,98,329,153,0.855074783756618,-137.6,22.2901098901099,55,1152.11898281025,1.23494341485121
26645,530145.576,5324968.879,138,95,43,40.781,2,2019,1,107,338,169,0.784455428448136,-115.5,22.3538461538462,62,1152.11898281025,1.23494341485121
26645,530145.576,5324968.879,0,0,0,120.081,0,2020,0,21,309,154,0.734841613018137,-114.8,20.6901098901099,133,1152.11898281025,1.23494341485121
26646,530145.576,5324737.223,0,0,0,58.193,0,2001,0,96,336,177,0.837241796006616,-19.6,19.9175824175824,81,1083.73557240526,1.08628654030891
26646,530145.576,5324737.223,0,0,0,48.914,0,2002,0,98,341,168,0.823722620257268,-1.5,19.8516483516484,70,1083.73557240526,1.08628654030891
26646,530145.576,5324737.223,0,0,0,45.722,0,2003,0,96,322,161,0.81376589381816,-210.6,24.6406593406593,65,1083.73557240526,1.08628654030891
26646,530145.576,5324737.223,0,0,0,50.476,0,2004,0,98,332,161,0.819262367707384,98,19.4571428571429,63,1083.73557240526,1.08628654030891
26646,530145.576,5324737.223,134,93,41,69.517,2,2005,2,85,310,154,0.853055269313748,-53,19.5769230769231,69,1083.73557240526,1.08628654030891
26646,530145.576,5324737.223,181,67,114,37.927,0,2006,2,113,344,169,0.811778130272392,20.9,20.5340659340659,56,1083.73557240526,1.08628654030891
26646,530145.576,5324737.223,0,0,0,67.889,0,2007,0,74,300,193,0.797882923352474,221.4,18.6978021978022,119,1083.73557240526,1.08628654030891
26646,530145.576,5324737.223,86,59,27,35.581,0,2008,1,112,310,162,0.831924351516916,3.5,19.1615384615385,50,1083.73557240526,1.08628654030891
26646,530145.576,5324737.223,154,102,52,42.903,0,2009,1,98,317,154,0.864422716770332,3.8,20.121978021978,56,1083.73557240526,1.08628654030891
26646,530145.576,5324737.223,153,99,54,36.04,0,2010,1,108,313,170,0.819760825025015,57.2,19.8230769230769,62,1083.73557240526,1.08628654030891
26646,530145.576,5324737.223,86,70,16,45.857,0,2011,1,83,322,233,0.77843007499528,98,19.0516483516484,150,1083.73557240526,1.08628654030891
26646,530145.576,5324737.223,131,93,38,54.097,2,2012,1,96,302,162,0.851035800676338,-1.5,20.4054945054945,66,1083.73557240526,1.08628654030891
26646,530145.576,5324737.223,173,61,112,41.829,0,2013,2,112,335,169,0.84160732844195,-195.6,20.9230769230769,57,1083.73557240526,1.08628654030891
26646,530145.576,5324737.223,0,0,0,63.413,0,2014,0,70,345,153,0.806292134765037,58.4,19.4978021978022,83,1083.73557240526,1.08628654030891
26646,530145.576,5324737.223,0,0,0,58.385,0,2015,0,91,337,154,0.833936327070654,-215.3,22.6472527472527,63,1083.73557240526,1.08628654030891
26646,530145.576,5324737.223,152,94,58,63.514,3,2016,2,92,324,192,0.828973917368152,-36.2,20.6758241758242,100,1083.73557240526,1.08628654030891
26646,530145.576,5324737.223,0,0,0,47.433,0,2017,0,93,323,161,0.791150572741056,-75,21.6263736263736,68,1083.73557240526,1.08628654030891
26646,530145.576,5324737.223,0,0,0,51.043,0,2018,0,94,316,152,0.837010280894912,-137.6,22.2901098901099,58,1083.73557240526,1.08628654030891
26646,530145.576,5324737.223,120,94,26,45.544,3,2019,1,102,339,161,0.801599948731554,-115.5,22.3538461538462,59,1083.73557240526,1.08628654030891
26646,530145.576,5324737.223,0,0,0,105.306,0,2020,0,35,317,169,0.767030447299759,-114.8,20.6901098901099,134,1083.73557240526,1.08628654030891
26815,530377.232,5336320.041,0,0,0,133.401,0,2001,2,35,326,153,0.836658282868965,-14.2,19.5065934065934,118,1027.36876299744,-1.47809501119481
26815,530377.232,5336320.041,115,76,39,60.511,2,2002,2,87,339,154,0.811704342431955,3,19.4725274725275,67,1027.36876299744,-1.47809501119481
26815,530377.232,5336320.041,143,94,49,54.787,9,2003,1,87,330,146,0.810709574728951,-209,24.2648351648352,59,1027.36876299744,-1.47809501119481
26815,530377.232,5336320.041,142,93,49,63.457,3,2004,1,86,328,153,0.820547772529921,104,19.0769230769231,67,1027.36876299744,-1.47809501119481
26815,530377.232,5336320.041,0,0,0,104.254,0,2005,0,54,317,153,0.854072869903489,-49.6,19.2098901098901,99,1027.36876299744,-1.47809501119481
26815,530377.232,5336320.041,194,93,101,35.871,0,2006,4,116,343,289,0.821192983925828,25.1,20.1736263736264,173,1027.36876299744,-1.47809501119481
26815,530377.232,5336320.041,0,0,0,88.827,0,2007,0,58,322,136,0.802578935353078,229.8,18.3494505494505,78,1027.36876299744,-1.47809501119481
26815,530377.232,5336320.041,0,0,0,51.422,0,2008,0,99,316,224,0.812952467836877,8.90000000000001,18.8,125,1027.36876299744,-1.47809501119481
26815,530377.232,5336320.041,166,68,98,40.816,0,2009,2,101,320,153,0.858169500746368,9.4,19.7494505494506,52,1027.36876299744,-1.47809501119481
26815,530377.232,5336320.041,160,93,67,49.033,0,2010,1,96,308,168,0.821144516252316,64.4,19.4725274725275,72,1027.36876299744,-1.47809501119481
26815,530377.232,5336320.041,85,81,4,54.192,3,2011,1,74,339,144,0.80579756146558,103.5,18.7505494505494,70,1027.36876299744,-1.47809501119481
26815,530377.232,5336320.041,127,93,34,62.172,4,2012,1,87,326,153,0.840830386947503,3.2,20.1307692307692,66,1027.36876299744,-1.47809501119481
26815,530377.232,5336320.041,172,93,79,58.248,1,2013,1,98,324,161,0.822566870357368,-190.8,20.5692307692308,63,1027.36876299744,-1.47809501119481
26815,530377.232,5336320.041,86,71,15,63.361,3,2014,1,71,350,146,0.829552181523546,65.4,19.2153846153846,75,1027.36876299744,-1.47809501119481
26815,530377.232,5336320.041,0,0,0,60.546,0,2015,0,90,349,146,0.816166666967288,-212.4,22.3164835164835,56,1027.36876299744,-1.47809501119481
26815,530377.232,5336320.041,164,96,68,81.389,9,2016,1,75,337,178,0.803493708330631,-31.9,20.4131868131868,103,1027.36876299744,-1.47809501119481
26815,530377.232,5336320.041,127,97,30,47.311,5,2017,1,94,323,161,0.780927498402994,-70.8,21.2648351648352,67,1027.36876299744,-1.47809501119481
26815,530377.232,5336320.041,165,79,86,55.243,0,2018,3,91,308,137,0.818228072776906,-135.7,21.9263736263736,46,1027.36876299744,-1.47809501119481
26815,530377.232,5336320.041,142,76,66,57.835,6,2019,2,90,332,152,0.819534073518119,-112.7,22.0065934065934,62,1027.36876299744,-1.47809501119481
26815,530377.232,5336320.041,0,0,0,67.166,0,2020,0,67,322,162,0.797156404405505,-111.3,20.3164835164835,95,1027.36876299744,-1.47809501119481
26816,530377.232,5336088.384,0,0,0,127.052,0,2001,1,40,318,161,0.814211618090738,-14.2,19.5065934065934,121,1065.38608811252,1.17919598179377
26816,530377.232,5336088.384,117,75,42,47.927,0,2002,2,100,338,162,0.822275871576448,3,19.4725274725275,62,1065.38608811252,1.17919598179377
26816,530377.232,5336088.384,143,94,49,48.644,8,2003,1,94,326,153,0.795340549236746,-209,24.2648351648352,59,1065.38608811252,1.17919598179377
26816,530377.232,5336088.384,147,105,42,46.838,0,2004,1,102,333,162,0.811311145248861,104,19.0769230769231,60,1065.38608811252,1.17919598179377
26816,530377.232,5336088.384,0,0,0,83.777,0,2005,0,73,313,154,0.854230494154574,-49.6,19.2098901098901,81,1065.38608811252,1.17919598179377
26816,530377.232,5336088.384,186,84,102,64.115,5,2006,2,92,341,154,0.823698924344215,25.1,20.1736263736264,62,1065.38608811252,1.17919598179377
26816,530377.232,5336088.384,0,0,0,81.912,0,2007,0,63,303,153,0.843224084212062,229.8,18.3494505494505,90,1065.38608811252,1.17919598179377
26816,530377.232,5336088.384,0,0,0,44.279,0,2008,0,105,315,216,0.816803528166359,8.90000000000001,18.8,111,1065.38608811252,1.17919598179377
26816,530377.232,5336088.384,163,68,95,49.992,0,2009,2,92,318,154,0.868094744610051,9.4,19.7494505494506,62,1065.38608811252,1.17919598179377
26816,530377.232,5336088.384,165,119,46,37.626,0,2010,1,107,312,170,0.805316024295458,64.4,19.4725274725275,63,1065.38608811252,1.17919598179377
26816,530377.232,5336088.384,0,0,0,48.924,0,2011,0,80,339,160,0.817029647067608,103.5,18.7505494505494,80,1065.38608811252,1.17919598179377
26816,530377.232,5336088.384,132,93,39,55.878,3,2012,1,95,325,161,0.83768093680637,3.2,20.1307692307692,66,1065.38608811252,1.17919598179377
26816,530377.232,5336088.384,172,93,79,58.248,1,2013,1,98,314,154,0.80301652604207,-190.8,20.5692307692308,56,1065.38608811252,1.17919598179377
26816,530377.232,5336088.384,93,68,25,52.993,3,2014,2,83,347,153,0.828024193604795,65.4,19.2153846153846,70,1065.38608811252,1.17919598179377
26816,530377.232,5336088.384,0,0,0,46.902,0,2015,0,102,348,153,0.807770068596374,-212.4,22.3164835164835,51,1065.38608811252,1.17919598179377
26816,530377.232,5336088.384,166,94,72,71.538,4,2016,2,85,336,193,0.799093613685138,-31.9,20.4131868131868,108,1065.38608811252,1.17919598179377
26816,530377.232,5336088.384,126,93,33,45.579,5,2017,1,96,320,161,0.794805603426233,-70.8,21.2648351648352,65,1065.38608811252,1.17919598179377
26816,530377.232,5336088.384,165,78,87,54.126,0,2018,3,92,298,138,0.807926981350808,-135.7,21.9263736263736,46,1065.38608811252,1.17919598179377
26816,530377.232,5336088.384,145,71,74,44.403,3,2019,2,104,329,153,0.820149733161093,-112.7,22.0065934065934,49,1065.38608811252,1.17919598179377
26816,530377.232,5336088.384,0,0,0,47.708,0,2020,0,84,319,162,0.80203492444409,-111.3,20.3164835164835,78,1065.38608811252,1.17919598179377
26820,530377.232,5335161.759,0,0,0,54.753,0,2001,0,100,301,177,0.841452965947616,-14.2,19.5065934065934,77,1253.37457492534,1.462261236251
26820,530377.232,5335161.759,86,68,18,41.929,0,2002,1,107,301,176,0.822986845452033,3,19.4725274725275,69,1253.37457492534,1.462261236251
26820,530377.232,5335161.759,148,95,53,30.65,0,2003,1,115,252,161,0.795917898118227,-209,24.2648351648352,46,1253.37457492534,1.462261236251
26820,530377.232,5335161.759,148,24,124,42.658,0,2004,2,106,329,176,0.811820357078479,104,19.0769230769231,70,1253.37457492534,1.462261236251
26820,530377.232,5335161.759,0,0,0,52.687,0,2005,0,102,317,161,0.808096673239665,-49.6,19.2098901098901,59,1253.37457492534,1.462261236251
26820,530377.232,5335161.759,196,68,128,18.427,0,2006,2,135,335,177,0.771635921363823,25.1,20.1736263736264,42,1253.37457492534,1.462261236251
26820,530377.232,5335161.759,0,0,0,45.458,0,2007,0,96,308,160,0.80125252836133,229.8,18.3494505494505,64,1253.37457492534,1.462261236251
26820,530377.232,5335161.759,86,85,1,32.603,0,2008,1,115,297,184,0.812645140470877,8.90000000000001,18.8,69,1253.37457492534,1.462261236251
26820,530377.232,5335161.759,155,66,89,49.992,0,2009,2,92,292,162,0.844574564833096,9.4,19.7494505494506,70,1253.37457492534,1.462261236251
26820,530377.232,5335161.759,173,109,64,27.636,0,2010,2,119,306,201,0.810887716935911,64.4,19.4725274725275,82,1253.37457492534,1.462261236251
26820,530377.232,5335161.759,85,64,21,37.742,0,2011,1,93,330,170,0.797182982352506,103.5,18.7505494505494,77,1253.37457492534,1.462261236251
26820,530377.232,5335161.759,94,94,0,43.951,0,2012,1,110,300,177,0.799596297588192,3.2,20.1307692307692,67,1253.37457492534,1.462261236251
26820,530377.232,5335161.759,181,60,121,32.551,0,2013,2,122,302,177,0.820757385110207,-190.8,20.5692307692308,55,1253.37457492534,1.462261236251
26820,530377.232,5335161.759,93,63,30,47.847,0,2014,2,89,331,169,0.80859175263681,65.4,19.2153846153846,80,1253.37457492534,1.462261236251
26820,530377.232,5335161.759,0,0,0,43.985,0,2015,0,105,315,153,0.807474469075915,-212.4,22.3164835164835,48,1253.37457492534,1.462261236251
26820,530377.232,5335161.759,173,142,31,40.079,4,2016,1,115,327,170,0.803280965525622,-31.9,20.4131868131868,55,1253.37457492534,1.462261236251
26820,530377.232,5335161.759,112,99,13,33.357,1,2017,1,112,309,178,0.805848175856936,-70.8,21.2648351648352,66,1253.37457492534,1.462261236251
26820,530377.232,5335161.759,156,71,85,38.128,0,2018,2,107,300,178,0.782909303872486,-135.7,21.9263736263736,71,1253.37457492534,1.462261236251
26820,530377.232,5335161.759,147,94,53,29.789,2,2019,1,120,328,169,0.791311878338983,-112.7,22.0065934065934,49,1253.37457492534,1.462261236251
26820,530377.232,5335161.759,0,0,0,29.578,0,2020,0,106,296,177,0.790361008176118,-111.3,20.3164835164835,71,1253.37457492534,1.462261236251
26861,530377.232,5325663.848,0,0,0,44.302,0,2001,2,108,324,178,0.862071976292206,-19.6,19.9175824175824,70,1142.87728629425,0.20839354307906
26861,530377.232,5325663.848,152,86,66,36.936,0,2002,3,112,305,234,0.830813464793776,-1.5,19.8516483516484,122,1142.87728629425,0.20839354307906
26861,530377.232,5325663.848,160,93,67,33.931,0,2003,2,110,307,184,0.868907763769898,-210.6,24.6406593406593,74,1142.87728629425,0.20839354307906
26861,530377.232,5325663.848,152,95,57,32.552,0,2004,1,116,325,170,0.837788672019965,98,19.4571428571429,54,1142.87728629425,0.20839354307906
26861,530377.232,5325663.848,152,93,59,48.547,0,2005,4,105,313,234,0.829459680383546,-53,19.5769230769231,129,1142.87728629425,0.20839354307906
26861,530377.232,5325663.848,182,64,118,40.964,0,2006,2,110,334,169,0.833582124911489,20.9,20.5340659340659,59,1142.87728629425,0.20839354307906
26861,530377.232,5325663.848,170,93,77,42.016,0,2007,1,99,297,177,0.83190209821427,221.4,18.6978021978022,78,1142.87728629425,0.20839354307906
26861,530377.232,5325663.848,86,56,30,22.643,0,2008,1,124,307,185,0.847513765897628,3.5,19.1615384615385,61,1142.87728629425,0.20839354307906
26861,530377.232,5325663.848,166,68,98,39.189,0,2009,2,102,295,169,0.881697606542837,3.8,20.121978021978,67,1142.87728629425,0.20839354307906
26861,530377.232,5325663.848,172,120,52,24.32,0,2010,1,123,309,177,0.838664562091051,57.2,19.8230769230769,54,1142.87728629425,0.20839354307906
26861,530377.232,5325663.848,86,70,16,33.135,0,2011,1,98,319,170,0.81457789463483,98,19.0516483516484,72,1142.87728629425,0.20839354307906
26861,530377.232,5325663.848,147,93,54,42.261,0,2012,1,111,304,170,0.867385020967112,-1.5,20.4054945054945,59,1142.87728629425,0.20839354307906
26861,530377.232,5325663.848,181,53,128,37.152,0,2013,2,117,307,170,0.855442081699779,-195.6,20.9230769230769,53,1142.87728629425,0.20839354307906
26861,530377.232,5325663.848,151,70,81,36.742,0,2014,3,103,332,185,0.841331322253516,58.4,19.4978021978022,82,1142.87728629425,0.20839354307906
26861,530377.232,5325663.848,147,93,54,41.508,0,2015,1,107,340,161,0.876968387004675,-215.3,22.6472527472527,54,1142.87728629425,0.20839354307906
26861,530377.232,5325663.848,166,106,60,37.226,2,2016,1,117,333,170,0.844298613149129,-36.2,20.6758241758242,53,1142.87728629425,0.20839354307906
26861,530377.232,5325663.848,136,94,42,37.878,4,2017,2,105,299,225,0.834206062694712,-75,21.6263736263736,120,1142.87728629425,0.20839354307906
26861,530377.232,5325663.848,160,67,93,36.487,0,2018,2,108,326,162,0.856373835743053,-137.6,22.2901098901099,54,1142.87728629425,0.20839354307906
26861,530377.232,5325663.848,152,93,59,29.218,2,2019,2,120,338,216,0.841385194779542,-115.5,22.3538461538462,96,1142.87728629425,0.20839354307906
26861,530377.232,5325663.848,0,0,0,29.007,0,2020,0,106,306,185,0.774390365583805,-114.8,20.6901098901099,79,1142.87728629425,0.20839354307906
26862,530377.232,5325432.192,0,0,0,47.808,0,2001,2,105,323,170,0.813113900502661,-19.6,19.9175824175824,65,1158.89084853194,-0.83087900760077
26862,530377.232,5325432.192,152,84,68,42.121,0,2002,3,106,306,234,0.827753961073011,-1.5,19.8516483516484,128,1158.89084853194,-0.83087900760077
26862,530377.232,5325432.192,159,112,47,37.85,1,2003,1,105,308,144,0.765196401155545,-210.6,24.6406593406593,39,1158.89084853194,-0.83087900760077
26862,530377.232,5325432.192,150,93,57,35.297,0,2004,1,113,317,170,0.861296815396,98,19.4571428571429,57,1158.89084853194,-0.83087900760077
26862,530377.232,5325432.192,152,107,45,53.978,1,2005,2,100,310,248,0.830037102710986,-53,19.5769230769231,148,1158.89084853194,-0.83087900760077
26862,530377.232,5325432.192,191,60,131,29.5,0,2006,3,122,338,168,0.842948304563786,20.9,20.5340659340659,46,1158.89084853194,-0.83087900760077
26862,530377.232,5325432.192,168,93,75,50.84,0,2007,1,90,308,146,0.817860384926058,221.4,18.6978021978022,56,1158.89084853194,-0.83087900760077
26862,530377.232,5325432.192,86,58,28,25.608,0,2008,1,121,310,177,0.842385999179403,3.5,19.1615384615385,56,1158.89084853194,-0.83087900760077
26862,530377.232,5325432.192,174,68,106,31.476,0,2009,3,111,296,162,0.891510498392404,3.8,20.121978021978,51,1158.89084853194,-0.83087900760077
26862,530377.232,5325432.192,166,93,73,27.841,0,2010,1,118,311,176,0.84036268995817,57.2,19.8230769230769,58,1158.89084853194,-0.83087900760077
26862,530377.232,5325432.192,86,70,16,39.975,0,2011,1,90,321,249,0.801904689527105,98,19.0516483516484,159,1158.89084853194,-0.83087900760077
26862,530377.232,5325432.192,147,93,54,45.692,1,2012,1,107,305,162,0.866481529706722,-1.5,20.4054945054945,55,1158.89084853194,-0.83087900760077
26862,530377.232,5325432.192,183,53,130,34.009,0,2013,2,120,300,169,0.842343523325498,-195.6,20.9230769230769,49,1158.89084853194,-0.83087900760077
26862,530377.232,5325432.192,154,54,100,41.702,0,2014,2,96,338,162,0.830858470316756,58.4,19.4978021978022,66,1158.89084853194,-0.83087900760077
26862,530377.232,5325432.192,147,93,54,44.228,0,2015,1,104,335,153,0.853830544056906,-215.3,22.6472527472527,49,1158.89084853194,-0.83087900760077
26862,530377.232,5325432.192,169,131,38,42.56,3,2016,1,112,327,218,0.810366932828905,-36.2,20.6758241758242,106,1158.89084853194,-0.83087900760077
26862,530377.232,5325432.192,135,94,41,43.184,4,2017,2,98,301,225,0.830106376417867,-75,21.6263736263736,127,1158.89084853194,-0.83087900760077
26862,530377.232,5325432.192,151,67,84,53.183,0,2018,2,92,334,153,0.840552147175272,-137.6,22.2901098901099,61,1158.89084853194,-0.83087900760077
26862,530377.232,5325432.192,152,95,57,35.368,2,2019,1,113,326,161,0.796928866296938,-115.5,22.3538461538462,48,1158.89084853194,-0.83087900760077
26862,530377.232,5325432.192,0,0,0,33.916,0,2020,0,99,305,169,0.778623592861634,-114.8,20.6901098901099,70,1158.89084853194,-0.83087900760077
26863,530377.232,5325200.536,0,0,0,60.386,0,2001,0,94,322,169,0.806721014324349,-19.6,19.9175824175824,75,1147.22337410144,1.43403480347297
26863,530377.232,5325200.536,113,85,28,42.992,0,2002,2,105,298,162,0.828520917003214,-1.5,19.8516483516484,57,1147.22337410144,1.43403480347297
26863,530377.232,5325200.536,149,63,86,38.691,1,2003,2,104,323,153,0.8230149397038,-210.6,24.6406593406593,49,1147.22337410144,1.43403480347297
26863,530377.232,5325200.536,148,98,50,39.077,0,2004,1,109,330,168,0.857563063268342,98,19.4571428571429,59,1147.22337410144,1.43403480347297
26863,530377.232,5325200.536,143,93,50,58.308,2,2005,1,96,314,160,0.843293675416347,-53,19.5769230769231,64,1147.22337410144,1.43403480347297
26863,530377.232,5325200.536,172,61,111,34.14,0,2006,2,117,341,162,0.835544609026625,20.9,20.5340659340659,45,1147.22337410144,1.43403480347297
26863,530377.232,5325200.536,0,0,0,62.794,0,2007,0,79,303,240,0.80127505647963,221.4,18.6978021978022,161,1147.22337410144,1.43403480347297
26863,530377.232,5325200.536,0,0,0,30.965,0,2008,0,116,312,168,0.875257413036928,3.5,19.1615384615385,52,1147.22337410144,1.43403480347297
26863,530377.232,5325200.536,166,67,99,38.309,0,2009,2,103,290,161,0.878692452402799,3.8,20.121978021978,58,1147.22337410144,1.43403480347297
26863,530377.232,5325200.536,165,120,45,33.4,0,2010,1,111,311,169,0.837558711616876,57.2,19.8230769230769,58,1147.22337410144,1.43403480347297
26863,530377.232,5325200.536,85,67,18,40.836,0,2011,1,89,324,194,0.793070746179289,98,19.0516483516484,105,1147.22337410144,1.43403480347297
26863,530377.232,5325200.536,145,93,52,50.343,1,2012,1,101,305,161,0.857853999728714,-1.5,20.4054945054945,60,1147.22337410144,1.43403480347297
26863,530377.232,5325200.536,174,93,81,44.83,0,2013,1,109,307,162,0.835583309329033,-195.6,20.9230769230769,53,1147.22337410144,1.43403480347297
26863,530377.232,5325200.536,93,93,0,47.94,0,2014,1,88,341,152,0.824114408430398,58.4,19.4978021978022,64,1147.22337410144,1.43403480347297
26863,530377.232,5325200.536,93,93,0,47.164,0,2015,1,101,322,153,0.838603730311216,-215.3,22.6472527472527,52,1147.22337410144,1.43403480347297
26863,530377.232,5325200.536,168,134,34,46.041,3,2016,1,109,323,177,0.831805970383897,-36.2,20.6758241758242,68,1147.22337410144,1.43403480347297
26863,530377.232,5325200.536,0,0,0,49.222,0,2017,0,91,307,218,0.805903059627719,-75,21.6263736263736,127,1147.22337410144,1.43403480347297
26863,530377.232,5325200.536,0,0,0,56.478,0,2018,0,89,332,146,0.84909355955157,-137.6,22.2901098901099,57,1147.22337410144,1.43403480347297
26863,530377.232,5325200.536,140,93,47,40.781,2,2019,1,107,334,161,0.792837473614101,-115.5,22.3538461538462,54,1147.22337410144,1.43403480347297
26863,530377.232,5325200.536,0,0,0,100.133,0,2020,0,39,300,162,0.783314770143075,-114.8,20.6901098901099,123,1147.22337410144,1.43403480347297
26864,530377.232,5324968.879,0,0,0,60.386,0,2001,2,94,326,170,0.812124549824002,-19.6,19.9175824175824,76,1110.25097252415,-0.485636444364063
26864,530377.232,5324968.879,112,85,27,48.914,0,2002,2,98,296,169,0.809784400690001,-1.5,19.8516483516484,71,1110.25097252415,-0.485636444364063
26864,530377.232,5324968.879,146,62,84,45.722,6,2003,2,96,322,154,0.829609512763746,-210.6,24.6406593406593,58,1110.25097252415,-0.485636444364063
26864,530377.232,5324968.879,143,93,50,43.972,0,2004,1,104,333,168,0.834452959367932,98,19.4571428571429,64,1110.25097252415,-0.485636444364063
26864,530377.232,5324968.879,141,93,48,70.586,2,2005,1,84,316,153,0.840414560689868,-53,19.5769230769231,69,1110.25097252415,-0.485636444364063
26864,530377.232,5324968.879,170,62,108,43.128,0,2006,2,108,345,161,0.80665948537735,20.9,20.5340659340659,53,1110.25097252415,-0.485636444364063
26864,530377.232,5324968.879,0,0,0,67.889,0,2007,0,74,307,177,0.773567368123632,221.4,18.6978021978022,103,1110.25097252415,-0.485636444364063
26864,530377.232,5324968.879,0,0,0,35.581,0,2008,0,112,312,169,0.86191549132906,3.5,19.1615384615385,57,1110.25097252415,-0.485636444364063
26864,530377.232,5324968.879,169,67,102,34.937,0,2009,2,107,285,168,0.858798353297425,3.8,20.121978021978,61,1110.25097252415,-0.485636444364063
26864,530377.232,5324968.879,162,93,69,33.4,0,2010,1,111,310,169,0.797742329460746,57.2,19.8230769230769,58,1110.25097252415,-0.485636444364063
26864,530377.232,5324968.879,85,66,19,44.214,0,2011,1,85,326,241,0.755669686709713,98,19.0516483516484,156,1110.25097252415,-0.485636444364063
26864,530377.232,5324968.879,144,93,51,51.832,2,2012,1,99,304,161,0.841039489156225,-1.5,20.4054945054945,62,1110.25097252415,-0.485636444364063
26864,530377.232,5324968.879,177,93,84,39.897,0,2013,1,114,301,169,0.837317583952771,-195.6,20.9230769230769,55,1110.25097252415,-0.485636444364063
26864,530377.232,5324968.879,0,0,0,57.189,0,2014,0,77,342,154,0.797300844663375,58.4,19.4978021978022,77,1110.25097252415,-0.485636444364063
26864,530377.232,5324968.879,93,93,0,49.232,0,2015,1,99,325,153,0.795137958196655,-215.3,22.6472527472527,54,1110.25097252415,-0.485636444364063
26864,530377.232,5324968.879,167,133,34,56.456,3,2016,1,99,320,170,0.8494203050756,-36.2,20.6758241758242,71,1110.25097252415,-0.485636444364063
26864,530377.232,5324968.879,0,0,0,46.556,0,2017,0,94,305,154,0.771293489644004,-75,21.6263736263736,60,1110.25097252415,-0.485636444364063
26864,530377.232,5324968.879,0,0,0,54.278,0,2018,0,91,329,145,0.849710430333262,-137.6,22.2901098901099,54,1110.25097252415,-0.485636444364063
26864,530377.232,5324968.879,139,94,45,42.66,2,2019,1,105,339,161,0.76159187398402,-115.5,22.3538461538462,56,1110.25097252415,-0.485636444364063
26864,530377.232,5324968.879,0,0,0,122.021,0,2020,0,19,316,168,0.732976137112604,-114.8,20.6901098901099,149,1110.25097252415,-0.485636444364063
26865,530377.232,5324737.223,0,0,0,103.937,0,2001,1,59,340,176,0.825713132449461,-19.6,19.9175824175824,117,1049.46990381437,1.36605475607876
26865,530377.232,5324737.223,0,0,0,63.085,0,2002,0,84,339,161,0.821542592989011,-1.5,19.8516483516484,77,1049.46990381437,1.36605475607876
26865,530377.232,5324737.223,0,0,0,55.236,0,2003,0,85,332,153,0.811177373682852,-210.6,24.6406593406593,68,1049.46990381437,1.36605475607876
26865,530377.232,5324737.223,93,93,0,50.476,0,2004,1,98,333,160,0.822901794787003,98,19.4571428571429,62,1049.46990381437,1.36605475607876
26865,530377.232,5324737.223,142,93,49,68.459,2,2005,2,86,316,153,0.839546067250088,-53,19.5769230769231,67,1049.46990381437,1.36605475607876
26865,530377.232,5324737.223,181,69,112,46.496,0,2006,3,105,345,257,0.821620527925837,20.9,20.5340659340659,152,1049.46990381437,1.36605475607876
26865,530377.232,5324737.223,0,0,0,75.685,0,2007,0,67,301,138,0.786600860356133,221.4,18.6978021978022,71,1049.46990381437,1.36605475607876
26865,530377.232,5324737.223,86,59,27,40.06,1,2008,1,108,315,162,0.828019860829532,3.5,19.1615384615385,54,1049.46990381437,1.36605475607876
26865,530377.232,5324737.223,154,93,61,39.189,0,2009,1,102,320,154,0.858917543625072,3.8,20.121978021978,52,1049.46990381437,1.36605475607876
26865,530377.232,5324737.223,156,104,52,36.959,0,2010,1,107,314,169,0.788096321332284,57.2,19.8230769230769,62,1049.46990381437,1.36605475607876
26865,530377.232,5324737.223,86,70,16,50.189,3,2011,1,78,325,256,0.779229469323019,98,19.0516483516484,178,1049.46990381437,1.36605475607876
26865,530377.232,5324737.223,132,94,38,67.236,3,2012,1,80,306,160,0.843159765641657,-1.5,20.4054945054945,80,1049.46990381437,1.36605475607876
26865,530377.232,5324737.223,173,63,110,44.83,0,2013,2,109,336,162,0.841287953331279,-195.6,20.9230769230769,53,1049.46990381437,1.36605475607876
26865,530377.232,5324737.223,0,0,0,66.309,0,2014,0,67,345,146,0.805145801441401,58.4,19.4978021978022,79,1049.46990381437,1.36605475607876
26865,530377.232,5324737.223,0,0,0,64.904,0,2015,0,84,340,153,0.834951791082941,-215.3,22.6472527472527,69,1049.46990381437,1.36605475607876
26865,530377.232,5324737.223,152,97,55,65.55,3,2016,1,90,328,185,0.813047347752793,-36.2,20.6758241758242,95,1049.46990381437,1.36605475607876
26865,530377.232,5324737.223,97,95,2,58.211,4,2017,1,82,326,161,0.783005210060511,-75,21.6263736263736,79,1049.46990381437,1.36605475607876
26865,530377.232,5324737.223,0,0,0,52.104,0,2018,0,93,322,153,0.847740901839229,-137.6,22.2901098901099,60,1049.46990381437,1.36605475607876
26865,530377.232,5324737.223,119,93,26,50.383,3,2019,1,97,341,161,0.807368443489586,-115.5,22.3538461538462,64,1049.46990381437,1.36605475607876
26865,530377.232,5324737.223,0,0,0,112.415,0,2020,0,29,317,169,0.817454382188072,-114.8,20.6901098901099,140,1049.46990381437,1.36605475607876
27039,530608.889,5335161.759,0,0,0,46.414,0,2001,2,107,291,176,0.85285171686048,-14.2,19.5065934065934,69,1233.24074430427,-0.408728034332314
27039,530608.889,5335161.759,93,67,26,35.028,0,2002,2,115,300,177,0.828121021599958,3,19.4725274725275,62,1233.24074430427,-0.408728034332314
27039,530608.889,5335161.759,148,100,48,32.289,0,2003,1,113,258,160,0.819041285861607,-209,24.2648351648352,47,1233.24074430427,-0.408728034332314
27039,530608.889,5335161.759,153,96,57,30.455,0,2004,1,119,325,169,0.820176500754461,104,19.0769230769231,50,1233.24074430427,-0.408728034332314
27039,530608.889,5335161.759,0,0,0,53.818,0,2005,0,101,309,162,0.825652638249582,-49.6,19.2098901098901,61,1233.24074430427,-0.408728034332314
27039,530608.889,5335161.759,185,67,118,51.23,0,2006,2,102,335,162,0.804445438488015,25.1,20.1736263736264,60,1233.24074430427,-0.408728034332314
27039,530608.889,5335161.759,166,126,40,54.835,1,2007,1,87,299,161,0.815407129460638,229.8,18.3494505494505,74,1233.24074430427,-0.408728034332314
27039,530608.889,5335161.759,0,0,0,22.96,0,2008,0,124,300,178,0.822548636895721,8.90000000000001,18.8,54,1233.24074430427,-0.408728034332314
27039,530608.889,5335161.759,168,69,99,42.704,0,2009,2,99,298,153,0.801166624120061,9.4,19.7494505494506,54,1233.24074430427,-0.408728034332314
27039,530608.889,5335161.759,162,62,100,29.89,0,2010,2,116,305,178,0.805058213791876,64.4,19.4725274725275,62,1233.24074430427,-0.408728034332314
27039,530608.889,5335161.759,127,72,55,35.138,0,2011,2,96,327,169,0.805133534726819,103.5,18.7505494505494,73,1233.24074430427,-0.408728034332314
27039,530608.889,5335161.759,149,100,49,43.951,0,2012,1,110,314,169,0.857021278836975,3.2,20.1307692307692,59,1233.24074430427,-0.408728034332314
27039,530608.889,5335161.759,183,130,53,31.499,0,2013,1,123,301,177,0.83675926063656,-190.8,20.5692307692308,54,1233.24074430427,-0.408728034332314
27039,530608.889,5335161.759,152,60,92,38.759,0,2014,2,101,338,169,0.816202160661844,65.4,19.2153846153846,68,1233.24074430427,-0.408728034332314
27039,530608.889,5335161.759,0,0,0,41.258,0,2015,0,108,337,153,0.85816159383611,-212.4,22.3164835164835,45,1233.24074430427,-0.408728034332314
27039,530608.889,5335161.759,165,101,64,33.496,0,2016,2,121,310,201,0.827088702009349,-31.9,20.4131868131868,80,1233.24074430427,-0.408728034332314
27039,530608.889,5335161.759,113,93,20,39.276,5,2017,1,104,307,176,0.816708203113439,-70.8,21.2648351648352,72,1233.24074430427,-0.408728034332314
27039,530608.889,5335161.759,155,76,79,41.213,0,2018,2,104,298,160,0.855774625353524,-135.7,21.9263736263736,56,1233.24074430427,-0.408728034332314
27039,530608.889,5335161.759,154,98,56,29.789,2,2019,1,120,329,170,0.800345623882469,-112.7,22.0065934065934,50,1233.24074430427,-0.408728034332314
27039,530608.889,5335161.759,0,0,0,25.314,0,2020,0,113,269,185,0.804603180255236,-111.3,20.3164835164835,72,1233.24074430427,-0.408728034332314
27040,530608.889,5334930.103,0,0,0,72.507,0,2001,2,85,299,176,0.859655594491174,-14.2,19.5065934065934,91,1186.95433503889,1.46165335767382
27040,530608.889,5334930.103,86,66,20,35.866,0,2002,1,114,293,177,0.844213580544225,3,19.4725274725275,63,1186.95433503889,1.46165335767382
27040,530608.889,5334930.103,150,93,57,38.683,1,2003,1,105,240,154,0.801009088616622,-209,24.2648351648352,49,1186.95433503889,1.46165335767382
27040,530608.889,5334930.103,145,93,52,35.887,0,2004,1,113,324,170,0.805298415268004,104,19.0769230769231,57,1186.95433503889,1.46165335767382
27040,530608.889,5334930.103,157,93,64,59.382,2,2005,2,96,306,168,0.797471447548224,-49.6,19.2098901098901,72,1186.95433503889,1.46165335767382
27040,530608.889,5334930.103,194,60,134,33.942,0,2006,2,118,338,169,0.8125967624811,25.1,20.1736263736264,51,1186.95433503889,1.46165335767382
27040,530608.889,5334930.103,167,96,71,54.835,1,2007,1,87,296,162,0.856647718538574,229.8,18.3494505494505,75,1186.95433503889,1.46165335767382
27040,530608.889,5334930.103,86,86,0,25.972,0,2008,1,121,309,186,0.813094792148228,8.90000000000001,18.8,65,1186.95433503889,1.46165335767382
27040,530608.889,5334930.103,164,69,95,35.592,0,2009,2,107,307,162,0.859790772017384,9.4,19.7494505494506,55,1186.95433503889,1.46165335767382
27040,530608.889,5334930.103,165,93,72,30.674,0,2010,1,115,311,177,0.807163043290618,64.4,19.4725274725275,62,1186.95433503889,1.46165335767382
27040,530608.889,5334930.103,127,64,63,43.012,0,2011,2,87,330,176,0.78457357481472,103.5,18.7505494505494,89,1186.95433503889,1.46165335767382
27040,530608.889,5334930.103,132,97,35,49.75,1,2012,1,103,301,169,0.837549889871097,3.2,20.1307692307692,66,1186.95433503889,1.46165335767382
27040,530608.889,5334930.103,175,61,114,41.66,0,2013,2,113,292,169,0.844695607684543,-190.8,20.5692307692308,56,1186.95433503889,1.46165335767382
27040,530608.889,5334930.103,135,43,92,47.847,0,2014,2,89,335,169,0.817189849176002,65.4,19.2153846153846,80,1186.95433503889,1.46165335767382
27040,530608.889,5334930.103,93,93,0,47.919,0,2015,1,101,302,154,0.81573152913458,-212.4,22.3164835164835,53,1186.95433503889,1.46165335767382
27040,530608.889,5334930.103,171,115,56,54.433,4,2016,1,102,318,170,0.885340837466415,-31.9,20.4131868131868,68,1186.95433503889,1.46165335767382
27040,530608.889,5334930.103,93,93,0,30.52,1,2017,1,116,312,177,0.787905936472643,-70.8,21.2648351648352,61,1186.95433503889,1.46165335767382
27040,530608.889,5334930.103,0,0,0,49.707,0,2018,0,96,304,168,0.830569082465679,-135.7,21.9263736263736,72,1186.95433503889,1.46165335767382
27040,530608.889,5334930.103,139,94,45,32.54,2,2019,1,117,336,170,0.80943141674838,-112.7,22.0065934065934,53,1186.95433503889,1.46165335767382
27040,530608.889,5334930.103,0,0,0,29.578,0,2020,0,106,285,178,0.810231379109254,-111.3,20.3164835164835,72,1186.95433503889,1.46165335767382
27041,530608.889,5334698.446,0,0,0,73.836,0,2001,0,84,307,170,0.849042011776228,-14.2,19.5065934065934,86,1131.07681430216,-1.44776401984153
27041,530608.889,5334698.446,86,67,19,47.086,0,2002,1,101,323,170,0.852619941828807,3,19.4725274725275,69,1131.07681430216,-1.44776401984153
27041,530608.889,5334698.446,150,93,57,43.097,3,2003,1,100,321,153,0.797422938522268,-209,24.2648351648352,53,1131.07681430216,-1.44776401984153
27041,530608.889,5334698.446,145,99,46,44.704,0,2004,2,104,333,217,0.836292739562442,104,19.0769230769231,113,1131.07681430216,-1.44776401984153
27041,530608.889,5334698.446,157,93,64,60.337,2,2005,2,95,312,154,0.823234753644477,-49.6,19.2098901098901,59,1131.07681430216,-1.44776401984153
27041,530608.889,5334698.446,194,63,131,32.975,0,2006,2,119,344,169,0.815791638385781,25.1,20.1736263736264,50,1131.07681430216,-1.44776401984153
27041,530608.889,5334698.446,161,120,41,72.138,8,2007,1,71,295,162,0.86142080337922,229.8,18.3494505494505,91,1131.07681430216,-1.44776401984153
27041,530608.889,5334698.446,0,0,0,21.062,0,2008,0,126,313,201,0.804670934963891,8.90000000000001,18.8,75,1131.07681430216,-1.44776401984153
27041,530608.889,5334698.446,162,69,93,39.905,0,2009,2,102,318,168,0.865874973527301,9.4,19.7494505494506,66,1131.07681430216,-1.44776401984153
27041,530608.889,5334698.446,166,113,53,34.883,0,2010,1,110,314,177,0.821996086195127,64.4,19.4725274725275,67,1131.07681430216,-1.44776401984153
27041,530608.889,5334698.446,123,64,59,45.487,0,2011,2,84,330,169,0.82195338707293,103.5,18.7505494505494,85,1131.07681430216,-1.44776401984153
27041,530608.889,5334698.446,134,98,36,55.878,3,2012,1,95,304,169,0.835940001181241,3.2,20.1307692307692,74,1131.07681430216,-1.44776401984153
27041,530608.889,5334698.446,179,61,118,40.689,0,2013,2,114,296,161,0.835153312726662,-190.8,20.5692307692308,47,1131.07681430216,-1.44776401984153
27041,530608.889,5334698.446,131,43,88,61.527,3,2014,2,73,338,169,0.826990790104884,65.4,19.2153846153846,96,1131.07681430216,-1.44776401984153
27041,530608.889,5334698.446,0,0,0,58.262,0,2015,0,92,326,153,0.840781348495839,-212.4,22.3164835164835,61,1131.07681430216,-1.44776401984153
27041,530608.889,5334698.446,168,101,67,63.64,4,2016,1,93,331,177,0.896012309805763,-31.9,20.4131868131868,84,1131.07681430216,-1.44776401984153
27041,530608.889,5334698.446,93,93,0,35.588,4,2017,1,109,320,177,0.805983087794691,-70.8,21.2648351648352,68,1131.07681430216,-1.44776401984153
27041,530608.889,5334698.446,0,0,0,48.573,0,2018,0,97,314,161,0.833559542016235,-135.7,21.9263736263736,64,1131.07681430216,-1.44776401984153
27041,530608.889,5334698.446,134,94,40,41.524,2,2019,1,107,338,170,0.823653031247885,-112.7,22.0065934065934,63,1131.07681430216,-1.44776401984153
27041,530608.889,5334698.446,0,0,0,38.628,0,2020,0,94,306,177,0.822091734307975,-111.3,20.3164835164835,83,1131.07681430216,-1.44776401984153
27042,530608.889,5334466.79,0,0,0,140.321,0,2001,0,29,315,176,0.849968452879409,-14.2,19.5065934065934,147,1076.36892784086,-1.44531574123413
27042,530608.889,5334466.79,86,73,13,52.355,1,2002,1,95,339,169,0.861559998728841,3,19.4725274725275,74,1076.36892784086,-1.44531574123413
27042,530608.889,5334466.79,145,94,51,50.557,9,2003,1,92,328,153,0.795526671472924,-209,24.2648351648352,61,1076.36892784086,-1.44531574123413
27042,530608.889,5334466.79,140,94,46,49.052,0,2004,1,100,337,170,0.880543123743848,104,19.0769230769231,70,1076.36892784086,-1.44531574123413
27042,530608.889,5334466.79,141,93,48,65.397,2,2005,2,90,314,162,0.863378322550195,-49.6,19.2098901098901,72,1076.36892784086,-1.44531574123413
27042,530608.889,5334466.79,182,69,113,41.884,0,2006,2,110,345,168,0.830156269495355,25.1,20.1736263736264,58,1076.36892784086,-1.44531574123413
27042,530608.889,5334466.79,0,0,0,101.365,0,2007,0,47,312,208,0.828369553065742,229.8,18.3494505494505,161,1076.36892784086,-1.44531574123413
27042,530608.889,5334466.79,0,0,0,33.811,0,2008,0,114,312,201,0.823516855116711,8.90000000000001,18.8,87,1076.36892784086,-1.44531574123413
27042,530608.889,5334466.79,155,71,84,45.692,0,2009,2,96,328,161,0.867906010777326,9.4,19.7494505494506,65,1076.36892784086,-1.44531574123413
27042,530608.889,5334466.79,152,94,58,47.876,0,2010,1,97,316,176,0.83288243909831,64.4,19.4725274725275,79,1076.36892784086,-1.44531574123413
27042,530608.889,5334466.79,94,93,1,85.402,19,2011,2,41,338,217,0.828296799140653,103.5,18.7505494505494,176,1076.36892784086,-1.44531574123413
27042,530608.889,5334466.79,112,93,19,56.626,3,2012,1,94,322,177,0.877043551080266,3.2,20.1307692307692,83,1076.36892784086,-1.44531574123413
27042,530608.889,5334466.79,0,0,0,64.259,0,2013,0,92,303,177,0.862360015291198,-190.8,20.5692307692308,85,1076.36892784086,-1.44531574123413
27042,530608.889,5334466.79,86,79,7,70.341,4,2014,1,64,346,169,0.845683789528208,65.4,19.2153846153846,105,1076.36892784086,-1.44531574123413
27042,530608.889,5334466.79,0,0,0,70.452,0,2015,0,79,342,153,0.840034936540632,-212.4,22.3164835164835,74,1076.36892784086,-1.44531574123413
27042,530608.889,5334466.79,151,93,58,63.64,4,2016,1,93,336,177,0.891697738602202,-31.9,20.4131868131868,84,1076.36892784086,-1.44531574123413
27042,530608.889,5334466.79,0,0,0,43.089,0,2017,0,99,321,192,0.849283722763641,-70.8,21.2648351648352,93,1076.36892784086,-1.44531574123413
27042,530608.889,5334466.79,147,97,50,55.243,0,2018,1,91,341,154,0.894535475589258,-135.7,21.9263736263736,63,1076.36892784086,-1.44531574123413
27042,530608.889,5334466.79,134,93,41,57.835,6,2019,1,90,344,178,0.83325192649897,-112.7,22.0065934065934,88,1076.36892784086,-1.44531574123413
27042,530608.889,5334466.79,0,0,0,109.871,0,2020,0,33,312,177,0.842523535024927,-111.3,20.3164835164835,144,1076.36892784086,-1.44531574123413
27080,530608.889,5325663.848,0,0,0,45.47,0,2001,2,107,324,185,0.841011104159183,-19.6,19.9175824175824,78,1103.16842364073,-1.48340343174793
27080,530608.889,5325663.848,116,84,32,39.521,0,2002,3,109,311,185,0.841368953284318,-1.5,19.8516483516484,76,1103.16842364073,-1.48340343174793
27080,530608.889,5325663.848,146,98,48,36.226,1,2003,1,107,323,154,0.801747772536267,-210.6,24.6406593406593,47,1103.16842364073,-1.48340343174793
27080,530608.889,5325663.848,150,93,57,36.233,0,2004,2,112,311,232,0.822848867140145,98,19.4571428571429,120,1103.16842364073,-1.48340343174793
27080,530608.889,5325663.848,147,93,54,51.731,0,2005,2,102,313,218,0.827651711777988,-53,19.5769230769231,116,1103.16842364073,-1.48340343174793
27080,530608.889,5325663.848,181,64,117,36.023,0,2006,3,115,335,226,0.850135813421136,20.9,20.5340659340659,111,1103.16842364073,-1.48340343174793
27080,530608.889,5325663.848,161,97,64,47.742,0,2007,2,93,298,232,0.831841040374675,221.4,18.6978021978022,139,1103.16842364073,-1.48340343174793
27080,530608.889,5325663.848,174,146,28,21.696,0,2008,1,125,306,201,0.844555724825941,3.5,19.1615384615385,76,1103.16842364073,-1.48340343174793
27080,530608.889,5325663.848,159,67,92,49.095,0,2009,2,92,296,169,0.924696156587235,3.8,20.121978021978,77,1103.16842364073,-1.48340343174793
27080,530608.889,5325663.848,166,143,23,25.022,0,2010,2,122,302,233,0.823906542122949,57.2,19.8230769230769,111,1103.16842364073,-1.48340343174793
27080,530608.889,5325663.848,0,0,0,32.326,0,2011,0,99,318,233,0.809473010526457,98,19.0516483516484,134,1103.16842364073,-1.48340343174793
27080,530608.889,5325663.848,145,93,52,48.826,1,2012,2,103,305,192,0.895480635149618,-1.5,20.4054945054945,89,1103.16842364073,-1.48340343174793
27080,530608.889,5325663.848,171,50,121,38.967,0,2013,2,115,313,176,0.85649231256776,-195.6,20.9230769230769,61,1103.16842364073,-1.48340343174793
27080,530608.889,5325663.848,93,86,7,39.515,0,2014,2,99,343,162,0.847715473118288,58.4,19.4978021978022,63,1103.16842364073,-1.48340343174793
27080,530608.889,5325663.848,147,93,54,40.609,0,2015,1,108,338,154,0.849357174065157,-215.3,22.6472527472527,46,1103.16842364073,-1.48340343174793
27080,530608.889,5325663.848,164,93,71,52.478,3,2016,2,103,326,218,0.814557289589225,-36.2,20.6758241758242,115,1103.16842364073,-1.48340343174793
27080,530608.889,5325663.848,126,98,28,41.588,4,2017,1,100,308,162,0.80745938897327,-75,21.6263736263736,62,1103.16842364073,-1.48340343174793
27080,530608.889,5325663.848,158,71,87,45.596,0,2018,2,99,340,162,0.829596819663925,-137.6,22.2901098901099,63,1103.16842364073,-1.48340343174793
27080,530608.889,5325663.848,132,93,39,33.673,2,2019,2,115,332,217,0.808278938386925,-115.5,22.3538461538462,102,1103.16842364073,-1.48340343174793
27080,530608.889,5325663.848,0,0,0,33.916,0,2020,0,99,303,176,0.791011098500364,-114.8,20.6901098901099,77,1103.16842364073,-1.48340343174793
27082,530608.889,5325200.536,0,0,0,66.107,0,2001,2,89,328,169,0.841159837029697,-19.6,19.9175824175824,80,1114.53609274162,1.22956160012667
27082,530608.889,5325200.536,111,80,31,37.793,0,2002,2,111,322,168,0.843239495595949,-1.5,19.8516483516484,57,1114.53609274162,1.22956160012667
27082,530608.889,5325200.536,141,93,48,41.288,2,2003,1,101,323,146,0.828838503811921,-210.6,24.6406593406593,45,1114.53609274162,1.22956160012667
27082,530608.889,5325200.536,147,103,44,40.984,0,2004,1,107,319,162,0.857749370144494,98,19.4571428571429,55,1114.53609274162,1.22956160012667
27082,530608.889,5325200.536,86,73,13,63.195,2,2005,1,91,316,240,0.839624365511531,-53,19.5769230769231,149,1114.53609274162,1.22956160012667
27082,530608.889,5325200.536,190,66,124,36.964,0,2006,2,114,341,160,0.842168596566052,20.9,20.5340659340659,46,1114.53609274162,1.22956160012667
27082,530608.889,5325200.536,168,94,74,57.307,1,2007,2,84,304,241,0.803932615428227,221.4,18.6978021978022,157,1114.53609274162,1.22956160012667
27082,530608.889,5325200.536,86,57,29,37.799,0,2008,1,110,308,242,0.841220832593573,3.5,19.1615384615385,132,1114.53609274162,1.22956160012667
27082,530608.889,5325200.536,160,69,91,57.399,0,2009,2,85,299,145,0.840547533438838,3.8,20.121978021978,60,1114.53609274162,1.22956160012667
27082,530608.889,5325200.536,156,93,63,36.959,0,2010,2,107,309,249,0.831795214884196,57.2,19.8230769230769,142,1114.53609274162,1.22956160012667
27082,530608.889,5325200.536,86,72,14,41.704,0,2011,1,88,324,264,0.814627090569276,98,19.0516483516484,176,1114.53609274162,1.22956160012667
27082,530608.889,5325200.536,147,93,54,51.832,2,2012,1,99,312,160,0.856791036049316,-1.5,20.4054945054945,61,1114.53609274162,1.22956160012667
27082,530608.889,5325200.536,173,100,73,45.861,0,2013,1,108,312,162,0.843699547823088,-195.6,20.9230769230769,54,1114.53609274162,1.22956160012667
27082,530608.889,5325200.536,98,82,16,51.343,2,2014,3,84,342,225,0.852363225775133,58.4,19.4978021978022,141,1114.53609274162,1.22956160012667
27082,530608.889,5325200.536,0,0,0,46.165,0,2015,0,102,340,152,0.859588697210784,-215.3,22.6472527472527,50,1114.53609274162,1.22956160012667
27082,530608.889,5325200.536,162,104,58,59.55,3,2016,2,96,325,225,0.822370496147959,-36.2,20.6758241758242,129,1114.53609274162,1.22956160012667
27082,530608.889,5325200.536,116,101,15,53.006,4,2017,2,87,306,217,0.816684890124995,-75,21.6263736263736,130,1114.53609274162,1.22956160012667
27082,530608.889,5325200.536,148,68,80,58.689,1,2018,2,87,336,146,0.847134328614683,-137.6,22.2901098901099,59,1114.53609274162,1.22956160012667
27082,530608.889,5325200.536,149,93,56,48.476,3,2019,1,99,326,154,0.802297773710813,-115.5,22.3538461538462,55,1114.53609274162,1.22956160012667
27082,530608.889,5325200.536,0,0,0,40.543,0,2020,0,91,311,160,0.796260379904095,-114.8,20.6901098901099,69,1114.53609274162,1.22956160012667
27083,530608.889,5324968.879,0,0,0,69.82,0,2001,1,86,332,169,0.83318304459551,-19.6,19.9175824175824,83,1106.52090510529,-1.47214692172112
27083,530608.889,5324968.879,110,80,30,54.447,1,2002,2,92,329,161,0.80334482256625,-1.5,19.8516483516484,69,1106.52090510529,-1.47214692172112
27083,530608.889,5324968.879,139,94,45,47.567,8,2003,1,94,324,153,0.81545265079635,-210.6,24.6406593406593,59,1106.52090510529,-1.47214692172112
27083,530608.889,5324968.879,147,94,53,40.984,0,2004,1,107,320,161,0.830320454979886,98,19.4571428571429,54,1106.52090510529,-1.47214692172112
27083,530608.889,5324968.879,86,74,12,120.725,33,2005,1,38,316,160,0.853098148959872,-53,19.5769230769231,122,1106.52090510529,-1.47214692172112
27083,530608.889,5324968.879,190,66,124,38.913,0,2006,2,112,344,160,0.814392000239689,20.9,20.5340659340659,48,1106.52090510529,-1.47214692172112
27083,530608.889,5324968.879,166,93,73,69.998,7,2007,1,72,307,177,0.780660298668514,221.4,18.6978021978022,105,1106.52090510529,-1.47214692172112
27083,530608.889,5324968.879,86,57,29,51.62,3,2008,1,98,309,168,0.844260388195058,3.5,19.1615384615385,70,1106.52090510529,-1.47214692172112
27083,530608.889,5324968.879,165,69,96,41.943,0,2009,2,99,297,145,0.823076910606684,3.8,20.121978021978,46,1106.52090510529,-1.47214692172112
27083,530608.889,5324968.879,158,101,57,34.261,0,2010,1,110,310,169,0.810537749931448,57.2,19.8230769230769,59,1106.52090510529,-1.47214692172112
27083,530608.889,5324968.879,86,72,14,44.214,0,2011,1,85,326,242,0.78034883264996,98,19.0516483516484,157,1106.52090510529,-1.47214692172112
27083,530608.889,5324968.879,146,93,53,52.58,2,2012,1,98,311,161,0.84468978556744,-1.5,20.4054945054945,63,1106.52090510529,-1.47214692172112
27083,530608.889,5324968.879,175,98,77,39.897,0,2013,1,114,317,169,0.845032618001709,-195.6,20.9230769230769,55,1106.52090510529,-1.47214692172112
27083,530608.889,5324968.879,98,96,2,52.21,3,2014,1,83,344,153,0.8147373278712,58.4,19.4978021978022,70,1106.52090510529,-1.47214692172112
27083,530608.889,5324968.879,93,93,0,48.182,0,2015,1,100,337,154,0.837063437746371,-215.3,22.6472527472527,54,1106.52090510529,-1.47214692172112
27083,530608.889,5324968.879,162,104,58,62.507,3,2016,1,93,317,178,0.823544029961774,-36.2,20.6758241758242,85,1106.52090510529,-1.47214692172112
27083,530608.889,5324968.879,112,96,16,46.556,4,2017,1,94,304,154,0.79421111504332,-75,21.6263736263736,60,1106.52090510529,-1.47214692172112
27083,530608.889,5324968.879,154,67,87,54.278,0,2018,2,91,332,145,0.852547361056083,-137.6,22.2901098901099,54,1106.52090510529,-1.47214692172112
27083,530608.889,5324968.879,151,98,53,43.615,3,2019,1,104,329,161,0.784240408286396,-115.5,22.3538461538462,57,1106.52090510529,-1.47214692172112
27083,530608.889,5324968.879,0,0,0,38.801,0,2020,0,93,314,160,0.760714626635177,-114.8,20.6901098901099,67,1106.52090510529,-1.47214692172112
27250,530840.545,5337015.01,0,0,0,140.321,0,2001,1,29,309,161,0.831607713117136,-14.2,19.5065934065934,132,981.402008822193,1.3199238085145
27250,530840.545,5337015.01,93,93,0,69.227,6,2002,2,80,336,248,0.794174615073779,3,19.4725274725275,168,981.402008822193,1.3199238085145
27250,530840.545,5337015.01,141,94,47,59.231,9,2003,1,82,319,146,0.786587338695568,-209,24.2648351648352,64,981.402008822193,1.3199238085145
27250,530840.545,5337015.01,133,94,39,76.142,5,2004,1,74,339,161,0.810019029377716,104,19.0769230769231,87,981.402008822193,1.3199238085145
27250,530840.545,5337015.01,0,0,0,123.832,0,2005,0,37,313,160,0.825241083399283,-49.6,19.2098901098901,123,981.402008822193,1.3199238085145
27250,530840.545,5337015.01,183,61,122,39.784,0,2006,3,112,343,288,0.813699981496825,25.1,20.1736263736264,176,981.402008822193,1.3199238085145
27250,530840.545,5337015.01,0,0,0,91.166,0,2007,0,56,312,184,0.793992260396977,229.8,18.3494505494505,128,981.402008822193,1.3199238085145
27250,530840.545,5337015.01,0,0,0,52.486,0,2008,0,98,314,177,0.827736372620806,8.90000000000001,18.8,79,981.402008822193,1.3199238085145
27250,530840.545,5337015.01,145,68,77,48.881,0,2009,2,93,318,154,0.836339878132769,9.4,19.7494505494506,61,981.402008822193,1.3199238085145
27250,530840.545,5337015.01,136,94,42,58.47,1,2010,1,88,310,176,0.846206024406221,64.4,19.4725274725275,88,981.402008822193,1.3199238085145
27250,530840.545,5337015.01,112,65,47,79.548,19,2011,3,47,333,233,0.791046557777329,103.5,18.7505494505494,186,981.402008822193,1.3199238085145
27250,530840.545,5337015.01,0,0,0,65.698,0,2012,0,83,306,160,0.834576243323826,3.2,20.1307692307692,77,981.402008822193,1.3199238085145
27250,530840.545,5337015.01,164,94,70,69.609,12,2013,2,87,326,184,0.821362740415368,-190.8,20.5692307692308,97,981.402008822193,1.3199238085145
27250,530840.545,5337015.01,0,0,0,91.049,0,2014,0,46,343,162,0.805545395685104,65.4,19.2153846153846,116,981.402008822193,1.3199238085145
27250,530840.545,5337015.01,0,0,0,88.469,0,2015,0,62,321,146,0.808180752380226,-212.4,22.3164835164835,84,981.402008822193,1.3199238085145
27250,530840.545,5337015.01,161,98,63,67.739,4,2016,1,89,330,185,0.802259167814917,-31.9,20.4131868131868,96,981.402008822193,1.3199238085145
27250,530840.545,5337015.01,93,93,0,50.01,5,2017,2,91,325,201,0.804024612122666,-70.8,21.2648351648352,110,981.402008822193,1.3199238085145
27250,530840.545,5337015.01,136,94,42,69.567,7,2018,1,78,318,136,0.773377426789386,-135.7,21.9263736263736,58,981.402008822193,1.3199238085145
27250,530840.545,5337015.01,120,93,27,92.122,10,2019,1,60,343,154,0.796583702173077,-112.7,22.0065934065934,94,981.402008822193,1.3199238085145
27250,530840.545,5337015.01,0,0,0,118.376,0,2020,0,25,322,169,0.781108635794459,-111.3,20.3164835164835,144,981.402008822193,1.3199238085145
27251,530840.545,5336783.354,0,0,0,142.779,0,2001,2,27,302,160,0.83082017903369,-14.2,19.5065934065934,133,965.079451955994,0.291644756366321
27251,530840.545,5336783.354,86,74,12,96.375,9,2002,1,57,341,249,0.787931123727034,3,19.4725274725275,192,965.079451955994,0.291644756366321
27251,530840.545,5336783.354,137,94,43,55.649,9,2003,1,86,320,152,0.795910250989812,-209,24.2648351648352,66,965.079451955994,0.291644756366321
27251,530840.545,5336783.354,143,93,50,57.298,0,2004,1,92,339,160,0.82499678419821,104,19.0769230769231,68,965.079451955994,0.291644756366321
27251,530840.545,5336783.354,0,0,0,128.152,0,2005,0,33,314,153,0.819930545934689,-49.6,19.2098901098901,120,965.079451955994,0.291644756366321
27251,530840.545,5336783.354,183,65,118,26.696,0,2006,3,126,344,297,0.802092175594231,25.1,20.1736263736264,171,965.079451955994,0.291644756366321
27251,530840.545,5336783.354,0,0,0,93.278,0,2007,0,54,312,225,0.756931850007861,229.8,18.3494505494505,171,965.079451955994,0.291644756366321
27251,530840.545,5336783.354,0,0,0,70.554,0,2008,0,82,313,170,0.832848565273477,8.90000000000001,18.8,88,965.079451955994,0.291644756366321
27251,530840.545,5336783.354,167,64,103,48.881,0,2009,2,93,315,152,0.820654907352533,9.4,19.7494505494506,59,965.079451955994,0.291644756366321
27251,530840.545,5336783.354,156,80,76,47.876,0,2010,2,97,316,169,0.806307177458504,64.4,19.4725274725275,72,965.079451955994,0.291644756366321
27251,530840.545,5336783.354,116,76,40,62.197,6,2011,3,65,339,249,0.766945363226759,103.5,18.7505494505494,184,965.079451955994,0.291644756366321
27251,530840.545,5336783.354,0,0,0,65.698,0,2012,0,83,319,160,0.842764113220348,3.2,20.1307692307692,77,965.079451955994,0.291644756366321
27251,530840.545,5336783.354,163,138,25,63.222,6,2013,1,93,310,178,0.806873434859488,-190.8,20.5692307692308,85,965.079451955994,0.291644756366321
27251,530840.545,5336783.354,0,0,0,80.252,0,2014,0,55,343,154,0.808384914514431,65.4,19.2153846153846,99,965.079451955994,0.291644756366321
27251,530840.545,5336783.354,0,0,0,90.98,0,2015,0,60,308,145,0.808010588813529,-212.4,22.3164835164835,85,965.079451955994,0.291644756366321
27251,530840.545,5336783.354,162,106,56,68.696,4,2016,1,88,329,184,0.816787900017853,-31.9,20.4131868131868,96,965.079451955994,0.291644756366321
27251,530840.545,5336783.354,0,0,0,54.858,0,2017,0,86,320,169,0.785931482903115,-70.8,21.2648351648352,83,965.079451955994,0.291644756366321
27251,530840.545,5336783.354,86,78,8,134.693,41,2018,1,21,315,130,0.766664902811213,-135.7,21.9263736263736,109,965.079451955994,0.291644756366321
27251,530840.545,5336783.354,135,79,56,58.784,6,2019,2,89,344,153,0.786377810788633,-112.7,22.0065934065934,64,965.079451955994,0.291644756366321
27251,530840.545,5336783.354,0,0,0,104.427,0,2020,0,37,317,177,0.778630455490069,-111.3,20.3164835164835,140,965.079451955994,0.291644756366321
27252,530840.545,5336551.697,0,0,0,137.949,0,2001,2,31,304,161,0.828376046591595,-14.2,19.5065934065934,130,958.775161343713,0.883769682673244
27252,530840.545,5336551.697,93,74,19,56.249,1,2002,3,91,340,256,0.794073824368007,3,19.4725274725275,165,958.775161343713,0.883769682673244
27252,530840.545,5336551.697,138,94,44,53.082,9,2003,1,89,322,146,0.802531986596407,-209,24.2648351648352,57,958.775161343713,0.883769682673244
27252,530840.545,5336551.697,142,93,49,60.289,0,2004,1,89,338,154,0.82005287088632,104,19.0769230769231,65,958.775161343713,0.883769682673244
27252,530840.545,5336551.697,0,0,0,117.451,0,2005,0,43,313,146,0.821694209810729,-49.6,19.2098901098901,103,958.775161343713,0.883769682673244
27252,530840.545,5336551.697,177,65,112,62.7,5,2006,3,93,344,256,0.80015412952008,25.1,20.1736263736264,163,958.775161343713,0.883769682673244
27252,530840.545,5336551.697,0,0,0,93.278,0,2007,0,54,310,128,0.771241256550875,229.8,18.3494505494505,74,958.775161343713,0.883769682673244
27252,530840.545,5336551.697,0,0,0,60.348,0,2008,0,91,317,169,0.833382334296969,8.90000000000001,18.8,78,958.775161343713,0.883769682673244
27252,530840.545,5336551.697,173,67,106,40.816,0,2009,3,101,313,144,0.80002782271221,9.4,19.7494505494506,43,958.775161343713,0.883769682673244
27252,530840.545,5336551.697,157,80,77,44.595,0,2010,3,100,317,240,0.793270388903686,64.4,19.4725274725275,140,958.775161343713,0.883769682673244
27252,530840.545,5336551.697,118,75,43,57.674,3,2011,3,70,340,250,0.761344828466003,103.5,18.7505494505494,180,958.775161343713,0.883769682673244
27252,530840.545,5336551.697,0,0,0,62.172,0,2012,0,87,319,160,0.841745239287559,3.2,20.1307692307692,73,958.775161343713,0.883769682673244
27252,530840.545,5336551.697,165,137,28,60.197,3,2013,1,96,310,169,0.817424579944998,-190.8,20.5692307692308,73,958.775161343713,0.883769682673244
27252,530840.545,5336551.697,0,0,0,93.452,0,2014,0,44,347,153,0.812286048638018,65.4,19.2153846153846,109,958.775161343713,0.883769682673244
27252,530840.545,5336551.697,0,0,0,76.154,0,2015,0,73,308,146,0.804155907808659,-212.4,22.3164835164835,73,958.775161343713,0.883769682673244
27252,530840.545,5336551.697,159,102,57,75.304,6,2016,2,81,327,201,0.787103133988387,-31.9,20.4131868131868,120,958.775161343713,0.883769682673244
27252,530840.545,5336551.697,0,0,0,54.858,0,2017,0,86,315,169,0.774845631861821,-70.8,21.2648351648352,83,958.775161343713,0.883769682673244
27252,530840.545,5336551.697,86,76,10,133.303,40,2018,1,22,313,129,0.762524786814235,-135.7,21.9263736263736,107,958.775161343713,0.883769682673244
27252,530840.545,5336551.697,134,79,55,58.784,6,2019,2,89,344,153,0.781820722335761,-112.7,22.0065934065934,64,958.775161343713,0.883769682673244
27252,530840.545,5336551.697,0,0,0,120.274,0,2020,0,23,316,169,0.783009007544873,-111.3,20.3164835164835,146,958.775161343713,0.883769682673244
27253,530840.545,5336320.041,0,0,0,128.287,0,2001,1,39,301,169,0.810089854284977,-14.2,19.5065934065934,130,1004.57355810462,-1.35371097670807
27253,530840.545,5336320.041,85,69,16,55.241,1,2002,1,92,336,257,0.799615480738009,3,19.4725274725275,165,1004.57355810462,-1.35371097670807
27253,530840.545,5336320.041,149,125,24,46.751,6,2003,1,96,326,146,0.798976658587818,-209,24.2648351648352,50,1004.57355810462,-1.35371097670807
27253,530840.545,5336320.041,146,93,53,58.275,0,2004,1,91,337,160,0.820098468286164,104,19.0769230769231,69,1004.57355810462,-1.35371097670807
27253,530840.545,5336320.041,0,0,0,98.71,0,2005,0,59,318,152,0.83200219481483,-49.6,19.2098901098901,93,1004.57355810462,-1.35371097670807
27253,530840.545,5336320.041,190,62,128,45.262,0,2006,3,107,344,249,0.810798858583997,25.1,20.1736263736264,142,1004.57355810462,-1.35371097670807
27253,530840.545,5336320.041,0,0,0,125.523,0,2007,0,26,316,130,0.798553893555553,229.8,18.3494505494505,104,1004.57355810462,-1.35371097670807
27253,530840.545,5336320.041,0,0,0,49.235,0,2008,0,101,309,225,0.813314495924086,8.90000000000001,18.8,124,1004.57355810462,-1.35371097670807
27253,530840.545,5336320.041,165,62,103,47.794,0,2009,2,94,314,154,0.842912992056962,9.4,19.7494505494506,60,1004.57355810462,-1.35371097670807
27253,530840.545,5336320.041,162,81,81,42.533,0,2010,3,102,313,234,0.797859534613267,64.4,19.4725274725275,132,1004.57355810462,-1.35371097670807
27253,530840.545,5336320.041,112,78,34,56.801,3,2011,3,71,338,240,0.788554436407233,103.5,18.7505494505494,169,1004.57355810462,-1.35371097670807
27253,530840.545,5336320.041,132,93,39,63.026,4,2012,1,86,334,154,0.849687472615215,3.2,20.1307692307692,68,1004.57355810462,-1.35371097670807
27253,530840.545,5336320.041,171,93,78,57.289,0,2013,1,99,328,169,0.812865779741002,-190.8,20.5692307692308,70,1004.57355810462,-1.35371097670807
27253,530840.545,5336320.041,86,73,13,59.753,3,2014,1,75,319,153,0.811789628176567,65.4,19.2153846153846,78,1004.57355810462,-1.35371097670807
27253,530840.545,5336320.041,150,77,73,57.061,4,2015,2,93,349,153,0.810475930269167,-212.4,22.3164835164835,60,1004.57355810462,-1.35371097670807
27253,530840.545,5336320.041,160,94,66,71.538,4,2016,2,85,332,202,0.801325575018233,-31.9,20.4131868131868,117,1004.57355810462,-1.35371097670807
27253,530840.545,5336320.041,132,100,32,34.091,2,2017,2,111,316,193,0.781038581419272,-70.8,21.2648351648352,82,1004.57355810462,-1.35371097670807
27253,530840.545,5336320.041,86,73,13,138.934,42,2018,1,18,320,178,0.74144604751866,-135.7,21.9263736263736,160,1004.57355810462,-1.35371097670807
27253,530840.545,5336320.041,139,100,39,52.242,4,2019,1,96,337,153,0.802132753554444,-112.7,22.0065934065934,57,1004.57355810462,-1.35371097670807
27253,530840.545,5336320.041,133,94,39,46.748,9,2020,1,85,323,161,0.7866257807834,-111.3,20.3164835164835,76,1004.57355810462,-1.35371097670807
27259,530840.545,5334930.103,0,0,0,60.5,0,2001,1,95,292,177,0.858368322198997,-14.2,19.5065934065934,82,1161.74030307824,1.12679139821978
27259,530840.545,5334930.103,86,65,21,39.312,0,2002,1,110,302,176,0.830756192179383,3,19.4725274725275,66,1161.74030307824,1.12679139821978
27259,530840.545,5334930.103,151,96,55,37.843,1,2003,1,106,305,153,0.786208885658409,-209,24.2648351648352,47,1161.74030307824,1.12679139821978
27259,530840.545,5334930.103,145,93,52,37.796,0,2004,1,111,317,176,0.808484678764792,104,19.0769230769231,65,1161.74030307824,1.12679139821978
27259,530840.545,5334930.103,152,112,40,61.305,2,2005,1,94,304,168,0.798350024785691,-49.6,19.2098901098901,74,1161.74030307824,1.12679139821978
27259,530840.545,5334930.103,195,60,135,32.024,0,2006,3,120,337,169,0.81387638127318,25.1,20.1736263736264,49,1161.74030307824,1.12679139821978
27259,530840.545,5334930.103,166,100,66,59.346,3,2007,1,83,299,162,0.874780349216366,229.8,18.3494505494505,79,1161.74030307824,1.12679139821978
27259,530840.545,5334930.103,86,85,1,18.424,0,2008,1,129,304,209,0.808628292026598,8.90000000000001,18.8,80,1161.74030307824,1.12679139821978
27259,530840.545,5334930.103,160,66,94,43.681,0,2009,2,98,306,168,0.860089282830478,9.4,19.7494505494506,70,1161.74030307824,1.12679139821978
27259,530840.545,5334930.103,162,93,69,35.777,0,2010,1,109,311,170,0.798017804056876,64.4,19.4725274725275,61,1161.74030307824,1.12679139821978
27259,530840.545,5334930.103,131,64,67,41.246,0,2011,2,89,328,169,0.827671391625983,103.5,18.7505494505494,80,1161.74030307824,1.12679139821978
27259,530840.545,5334930.103,134,98,36,49.75,1,2012,1,103,299,169,0.850591382536107,3.2,20.1307692307692,66,1161.74030307824,1.12679139821978
27259,530840.545,5334930.103,174,58,116,42.653,0,2013,2,112,304,176,0.83692887911943,-190.8,20.5692307692308,64,1161.74030307824,1.12679139821978
27259,530840.545,5334930.103,135,46,89,47.847,0,2014,3,89,332,217,0.823974142952088,65.4,19.2153846153846,128,1161.74030307824,1.12679139821978
27259,530840.545,5334930.103,93,93,0,51.131,0,2015,1,98,296,154,0.835692788765584,-212.4,22.3164835164835,56,1161.74030307824,1.12679139821978
27259,530840.545,5334930.103,170,100,70,52.443,4,2016,1,104,337,169,0.882077000714032,-31.9,20.4131868131868,65,1161.74030307824,1.12679139821978
27259,530840.545,5334930.103,93,93,0,40.757,5,2017,1,102,313,170,0.801783077812991,-70.8,21.2648351648352,68,1161.74030307824,1.12679139821978
27259,530840.545,5334930.103,96,93,3,44.3,0,2018,1,101,304,168,0.839991838485532,-135.7,21.9263736263736,67,1161.74030307824,1.12679139821978
27259,530840.545,5334930.103,137,93,44,34.312,2,2019,1,115,334,169,0.823725436896325,-112.7,22.0065934065934,54,1161.74030307824,1.12679139821978
27259,530840.545,5334930.103,0,0,0,33.036,0,2020,0,101,295,177,0.805209905489296,-111.3,20.3164835164835,76,1161.74030307824,1.12679139821978
27260,530840.545,5334698.446,0,0,0,140.321,0,2001,1,29,308,168,0.821951088147431,-14.2,19.5065934065934,139,1133.63193958415,0.377384583311174
27260,530840.545,5334698.446,86,67,19,60.511,2,2002,1,87,329,170,0.817321875445703,3,19.4725274725275,83,1133.63193958415,0.377384583311174
27260,530840.545,5334698.446,152,93,59,42.204,2,2003,1,101,319,153,0.764470713973272,-209,24.2648351648352,52,1133.63193958415,0.377384583311174
27260,530840.545,5334698.446,145,99,46,44.704,0,2004,1,104,333,177,0.776135300911334,104,19.0769230769231,73,1133.63193958415,0.377384583311174
27260,530840.545,5334698.446,156,93,63,60.337,2,2005,2,95,310,168,0.812567987597047,-49.6,19.2098901098901,73,1133.63193958415,0.377384583311174
27260,530840.545,5334698.446,197,63,134,28.392,0,2006,2,124,342,169,0.797822879992462,25.1,20.1736263736264,45,1133.63193958415,0.377384583311174
27260,530840.545,5334698.446,161,120,41,75.602,8,2007,1,68,304,162,0.859590772141188,229.8,18.3494505494505,94,1133.63193958415,0.377384583311174
27260,530840.545,5334698.446,0,0,0,15.285,0,2008,0,133,303,210,0.806033524697522,8.90000000000001,18.8,77,1133.63193958415,0.377384583311174
27260,530840.545,5334698.446,162,66,96,39.011,0,2009,2,103,313,169,0.857186430286635,9.4,19.7494505494506,66,1133.63193958415,0.377384583311174
27260,530840.545,5334698.446,166,119,47,34.008,0,2010,1,111,314,169,0.793935042075046,64.4,19.4725274725275,58,1133.63193958415,0.377384583311174
27260,530840.545,5334698.446,127,64,63,45.487,0,2011,2,84,329,169,0.834618798282153,103.5,18.7505494505494,85,1133.63193958415,0.377384583311174
27260,530840.545,5334698.446,131,93,38,48.963,1,2012,1,104,300,176,0.838655270656619,3.2,20.1307692307692,72,1133.63193958415,0.377384583311174
27260,530840.545,5334698.446,175,59,116,42.653,0,2013,2,112,292,162,0.807198881560806,-190.8,20.5692307692308,50,1133.63193958415,0.377384583311174
27260,530840.545,5334698.446,132,40,92,52.117,2,2014,2,84,335,176,0.825600077230722,65.4,19.2153846153846,92,1133.63193958415,0.377384583311174
27260,530840.545,5334698.446,0,0,0,53.435,0,2015,0,96,325,154,0.820906819716188,-212.4,22.3164835164835,58,1133.63193958415,0.377384583311174
27260,530840.545,5334698.446,173,93,80,51.406,4,2016,1,105,320,170,0.884044047665207,-31.9,20.4131868131868,65,1133.63193958415,0.377384583311174
27260,530840.545,5334698.446,93,93,0,40.757,5,2017,2,102,317,185,0.823027643315174,-70.8,21.2648351648352,83,1133.63193958415,0.377384583311174
27260,530840.545,5334698.446,0,0,0,49.707,0,2018,0,96,317,200,0.768109933501908,-135.7,21.9263736263736,104,1133.63193958415,0.377384583311174
27260,530840.545,5334698.446,136,93,43,38.672,2,2019,1,110,339,170,0.834347446283566,-112.7,22.0065934065934,60,1133.63193958415,0.377384583311174
27260,530840.545,5334698.446,0,0,0,114.428,0,2020,0,29,316,176,0.825400973724179,-111.3,20.3164835164835,147,1133.63193958415,0.377384583311174
27298,530840.545,5325895.505,0,0,0,50.069,0,2001,2,103,318,185,0.891624609158088,-19.6,19.9175824175824,82,1053.67170507398,1.0252190856233
27298,530840.545,5325895.505,109,94,15,36.089,0,2002,2,113,299,224,0.878898691306315,-1.5,19.8516483516484,111,1053.67170507398,1.0252190856233
27298,530840.545,5325895.505,135,94,41,36.226,1,2003,1,107,324,176,0.896290647898801,-210.6,24.6406593406593,69,1053.67170507398,1.0252190856233
27298,530840.545,5325895.505,148,93,55,38.127,0,2004,1,110,325,161,0.845786756205926,98,19.4571428571429,51,1053.67170507398,1.0252190856233
27298,530840.545,5325895.505,137,93,44,51.731,0,2005,2,102,305,169,0.868295611625814,-53,19.5769230769231,67,1053.67170507398,1.0252190856233
27298,530840.545,5325895.505,181,72,109,26.089,0,2006,2,126,339,184,0.898919471569367,20.9,20.5340659340659,58,1053.67170507398,1.0252190856233
27298,530840.545,5325895.505,163,98,65,42.016,0,2007,2,99,292,217,0.895612358773256,221.4,18.6978021978022,118,1053.67170507398,1.0252190856233
27298,530840.545,5325895.505,86,82,4,28.738,0,2008,1,118,304,178,0.911331190876124,3.5,19.1615384615385,60,1053.67170507398,1.0252190856233
27298,530840.545,5325895.505,141,69,72,37.445,0,2009,3,104,306,185,0.903116488851788,3.8,20.121978021978,81,1053.67170507398,1.0252190856233
27298,530840.545,5325895.505,149,93,56,25.725,0,2010,2,121,296,200,0.89464473064651,57.2,19.8230769230769,79,1053.67170507398,1.0252190856233
27298,530840.545,5325895.505,0,0,0,33.961,0,2011,0,97,315,194,0.85512873538719,98,19.0516483516484,97,1053.67170507398,1.0252190856233
27298,530840.545,5325895.505,140,93,47,45.692,1,2012,1,107,310,177,0.907644500088129,-1.5,20.4054945054945,70,1053.67170507398,1.0252190856233
27298,530840.545,5325895.505,168,71,97,38.967,0,2013,3,115,305,186,0.890382567280717,-195.6,20.9230769230769,71,1053.67170507398,1.0252190856233
27298,530840.545,5325895.505,0,0,0,39.515,0,2014,0,99,322,184,0.86914427639187,58.4,19.4978021978022,85,1053.67170507398,1.0252190856233
27298,530840.545,5325895.505,0,0,0,49.232,0,2015,0,99,330,162,0.880447743740633,-215.3,22.6472527472527,63,1053.67170507398,1.0252190856233
27298,530840.545,5325895.505,157,93,64,43.685,3,2016,1,111,337,169,0.909287609954503,-36.2,20.6758241758242,58,1053.67170507398,1.0252190856233
27298,530840.545,5325895.505,0,0,0,35.682,0,2017,0,108,307,168,0.869241978620685,-75,21.6263736263736,60,1053.67170507398,1.0252190856233
27298,530840.545,5325895.505,86,77,9,84.108,9,2018,1,64,317,176,0.89618007136397,-137.6,22.2901098901099,112,1053.67170507398,1.0252190856233
27298,530840.545,5325895.505,0,0,0,43.615,0,2019,0,104,332,185,0.864364826376637,-115.5,22.3538461538462,81,1053.67170507398,1.0252190856233
27298,530840.545,5325895.505,0,0,0,37.111,0,2020,0,95,299,193,0.886224126416797,-114.8,20.6901098901099,98,1053.67170507398,1.0252190856233
27469,531072.201,5337015.01,0,0,0,146.262,0,2001,0,24,323,184,0.829184788750635,-14.2,19.5065934065934,160,876.86803435446,-1.14317663686234
27469,531072.201,5337015.01,106,86,20,77.91,6,2002,3,72,347,248,0.775910363612788,3,19.4725274725275,176,876.86803435446,-1.14317663686234
27469,531072.201,5337015.01,0,0,0,85.275,0,2003,0,58,332,146,0.78018367815571,-209,24.2648351648352,88,876.86803435446,-1.14317663686234
27469,531072.201,5337015.01,93,93,0,68.945,5,2004,1,81,339,153,0.787297714209442,104,19.0769230769231,72,876.86803435446,-1.14317663686234
27469,531072.201,5337015.01,0,0,0,131.384,0,2005,0,30,306,153,0.81140328214142,-49.6,19.2098901098901,123,876.86803435446,-1.14317663686234
27469,531072.201,5337015.01,171,66,105,65.564,5,2006,3,91,349,289,0.803113294317086,25.1,20.1736263736264,198,876.86803435446,-1.14317663686234
27469,531072.201,5337015.01,108,93,15,93.278,9,2007,1,54,334,160,0.877388572530756,229.8,18.3494505494505,106,876.86803435446,-1.14317663686234
27469,531072.201,5337015.01,0,0,0,54.625,0,2008,0,96,319,217,0.803316786280894,8.90000000000001,18.8,121,876.86803435446,-1.14317663686234
27469,531072.201,5337015.01,133,80,53,81.712,10,2009,2,66,323,153,0.819714476189889,9.4,19.7494505494506,87,876.86803435446,-1.14317663686234
27469,531072.201,5337015.01,137,97,40,56.091,1,2010,1,90,314,169,0.814401410707531,64.4,19.4725274725275,79,876.86803435446,-1.14317663686234
27469,531072.201,5337015.01,102,65,37,60.356,4,2011,3,67,324,234,0.788840306280853,103.5,18.7505494505494,167,876.86803435446,-1.14317663686234
27469,531072.201,5337015.01,0,0,0,77.237,0,2012,0,71,310,160,0.837655809898675,3.2,20.1307692307692,89,876.86803435446,-1.14317663686234
27469,531072.201,5337015.01,93,70,23,64.259,7,2013,2,92,326,178,0.785131341670263,-190.8,20.5692307692308,86,876.86803435446,-1.14317663686234
27469,531072.201,5337015.01,86,70,16,115.11,16,2014,1,24,346,153,0.782376912574512,65.4,19.2153846153846,129,876.86803435446,-1.14317663686234
27469,531072.201,5337015.01,0,0,0,83.6,0,2015,0,66,322,138,0.807802350730956,-212.4,22.3164835164835,72,876.86803435446,-1.14317663686234
27469,531072.201,5337015.01,118,95,23,83.559,10,2016,2,73,334,201,0.794790618838797,-31.9,20.4131868131868,128,876.86803435446,-1.14317663686234
27469,531072.201,5337015.01,118,93,25,70.161,5,2017,1,72,323,161,0.777206166753663,-70.8,21.2648351648352,89,876.86803435446,-1.14317663686234
27469,531072.201,5337015.01,0,0,0,138.934,0,2018,0,18,348,129,0.768600057977427,-135.7,21.9263736263736,111,876.86803435446,-1.14317663686234
27469,531072.201,5337015.01,124,93,31,77.403,9,2019,1,73,344,153,0.802992161747017,-112.7,22.0065934065934,80,876.86803435446,-1.14317663686234
27469,531072.201,5337015.01,0,0,0,121.236,0,2020,0,22,326,169,0.775235844885152,-111.3,20.3164835164835,147,876.86803435446,-1.14317663686234
27471,531072.201,5336551.697,0,0,0,148.389,0,2001,1,22,331,184,0.836302327401814,-14.2,19.5065934065934,162,881.491190025655,-0.486133089748279
27471,531072.201,5336551.697,86,84,2,65.245,6,2002,1,83,342,146,0.793145119022976,3,19.4725274725275,63,881.491190025655,-0.486133089748279
27471,531072.201,5336551.697,139,94,45,68.2,14,2003,1,73,334,145,0.804351522358924,-209,24.2648351648352,72,881.491190025655,-0.486133089748279
27471,531072.201,5336551.697,126,94,32,65.651,4,2004,1,84,337,145,0.814278536788736,104,19.0769230769231,61,881.491190025655,-0.486133089748279
27471,531072.201,5336551.697,86,86,0,133.579,43,2005,1,28,317,152,0.824738898160464,-49.6,19.2098901098901,124,881.491190025655,-0.486133089748279
27471,531072.201,5336551.697,182,67,115,62.7,5,2006,3,93,345,250,0.791198220288982,25.1,20.1736263736264,157,881.491190025655,-0.486133089748279
27471,531072.201,5336551.697,0,0,0,93.278,0,2007,0,54,328,153,0.913220333032507,229.8,18.3494505494505,99,881.491190025655,-0.486133089748279
27471,531072.201,5336551.697,86,84,2,68.329,7,2008,1,84,316,177,0.811191288234434,8.90000000000001,18.8,93,881.491190025655,-0.486133089748279
27471,531072.201,5336551.697,128,93,35,52.307,0,2009,1,90,320,154,0.834224385647315,9.4,19.7494505494506,64,881.491190025655,-0.486133089748279
27471,531072.201,5336551.697,151,80,71,45.662,0,2010,2,99,315,168,0.799356807137575,64.4,19.4725274725275,69,881.491190025655,-0.486133089748279
27471,531072.201,5336551.697,111,93,18,62.197,6,2011,2,65,323,256,0.781497227314914,103.5,18.7505494505494,191,881.491190025655,-0.486133089748279
27471,531072.201,5336551.697,93,93,0,72.285,4,2012,1,76,324,162,0.857541320373016,3.2,20.1307692307692,86,881.491190025655,-0.486133089748279
27471,531072.201,5336551.697,157,142,15,71.818,14,2013,1,85,304,176,0.834969764148474,-190.8,20.5692307692308,91,881.491190025655,-0.486133089748279
27471,531072.201,5336551.697,84,83,1,83.707,7,2014,1,52,346,152,0.794762800839179,65.4,19.2153846153846,100,881.491190025655,-0.486133089748279
27471,531072.201,5336551.697,0,0,0,79.216,0,2015,0,70,316,144,0.817220383402897,-212.4,22.3164835164835,74,881.491190025655,-0.486133089748279
27471,531072.201,5336551.697,153,105,48,74.347,5,2016,1,82,331,177,0.815321105567005,-31.9,20.4131868131868,95,881.491190025655,-0.486133089748279
27471,531072.201,5336551.697,118,95,23,70.161,5,2017,1,72,317,146,0.806905940396103,-70.8,21.2648351648352,74,881.491190025655,-0.486133089748279
27471,531072.201,5336551.697,0,0,0,131.871,0,2018,0,23,321,138,0.823310891538652,-135.7,21.9263736263736,115,881.491190025655,-0.486133089748279
27471,531072.201,5336551.697,122,93,29,94.028,10,2019,1,58,333,153,0.815156156141229,-112.7,22.0065934065934,95,881.491190025655,-0.486133089748279
27471,531072.201,5336551.697,0,0,0,108.611,0,2020,0,34,321,169,0.79442707777991,-111.3,20.3164835164835,135,881.491190025655,-0.486133089748279
27472,531072.201,5336320.041,0,0,0,139.123,0,2001,2,30,325,160,0.8254800654137,-14.2,19.5065934065934,130,953.304456938562,-1.38567298606873
27472,531072.201,5336320.041,86,72,14,56.249,1,2002,1,91,340,288,0.790160501260704,3,19.4725274725275,197,953.304456938562,-1.38567298606873
27472,531072.201,5336320.041,152,111,41,56.519,9,2003,1,85,329,146,0.815530201246124,-209,24.2648351648352,61,953.304456938562,-1.38567298606873
27472,531072.201,5336320.041,142,94,48,68.945,5,2004,1,81,331,144,0.790234219547245,104,19.0769230769231,63,953.304456938562,-1.38567298606873
27472,531072.201,5336320.041,145,93,52,70.755,2,2005,2,85,312,146,0.831521136513311,-49.6,19.2098901098901,61,953.304456938562,-1.38567298606873
27472,531072.201,5336320.041,182,64,118,68.618,5,2006,3,89,343,273,0.823642393679029,25.1,20.1736263736264,184,953.304456938562,-1.38567298606873
27472,531072.201,5336320.041,0,0,0,83.351,0,2007,0,62,322,136,0.802646428104131,229.8,18.3494505494505,74,953.304456938562,-1.38567298606873
27472,531072.201,5336320.041,0,0,0,57.965,0,2008,0,93,314,184,0.824832590015919,8.90000000000001,18.8,91,953.304456938562,-1.38567298606873
27472,531072.201,5336320.041,165,93,72,46.733,0,2009,1,95,310,160,0.846374822730995,9.4,19.7494505494506,65,953.304456938562,-1.38567298606873
27472,531072.201,5336320.041,163,80,83,42.533,0,2010,2,102,314,169,0.790148006445429,64.4,19.4725274725275,67,953.304456938562,-1.38567298606873
27472,531072.201,5336320.041,117,78,39,55.069,3,2011,3,73,329,225,0.780199055610501,103.5,18.7505494505494,152,953.304456938562,-1.38567298606873
27472,531072.201,5336320.041,133,93,40,64.79,4,2012,1,84,312,153,0.842748844545083,3.2,20.1307692307692,69,953.304456938562,-1.38567298606873
27472,531072.201,5336320.041,168,76,92,59.216,2,2013,2,97,314,170,0.829273238355069,-190.8,20.5692307692308,73,953.304456938562,-1.38567298606873
27472,531072.201,5336320.041,82,63,19,68.254,3,2014,1,66,349,146,0.828926310424328,65.4,19.2153846153846,80,953.304456938562,-1.38567298606873
27472,531072.201,5336320.041,0,0,0,67.781,0,2015,0,82,350,145,0.818214115119378,-212.4,22.3164835164835,63,953.304456938562,-1.38567298606873
27472,531072.201,5336320.041,154,94,60,79.294,7,2016,1,77,329,177,0.823283981918384,-31.9,20.4131868131868,100,953.304456938562,-1.38567298606873
27472,531072.201,5336320.041,116,93,23,53.845,5,2017,1,87,317,162,0.789042359752301,-70.8,21.2648351648352,75,953.304456938562,-1.38567298606873
27472,531072.201,5336320.041,86,60,26,134.693,41,2018,1,21,319,145,0.840765539591494,-135.7,21.9263736263736,124,953.304456938562,-1.38567298606873
27472,531072.201,5336320.041,0,0,0,55.103,0,2019,0,93,333,153,0.808715946903981,-112.7,22.0065934065934,60,953.304456938562,-1.38567298606873
27472,531072.201,5336320.041,0,0,0,61.958,0,2020,0,71,318,168,0.799448845123134,-111.3,20.3164835164835,97,953.304456938562,-1.38567298606873
27473,531072.201,5336088.384,0,0,0,117.838,0,2001,1,48,308,161,0.843800790577432,-14.2,19.5065934065934,113,983.297467496542,0.71159841136546
27473,531072.201,5336088.384,86,71,15,48.781,0,2002,1,99,328,169,0.821749421508616,3,19.4725274725275,70,983.297467496542,0.71159841136546
27473,531072.201,5336088.384,153,93,60,46.751,6,2003,1,96,330,153,0.836884144989352,-209,24.2648351648352,57,983.297467496542,0.71159841136546
27473,531072.201,5336088.384,143,94,49,60.289,0,2004,1,89,335,146,0.793136737970875,104,19.0769230769231,57,983.297467496542,0.71159841136546
27473,531072.201,5336088.384,139,108,31,68.604,2,2005,1,87,312,153,0.840806131453036,-49.6,19.2098901098901,66,983.297467496542,0.71159841136546
27473,531072.201,5336088.384,183,66,117,59.998,5,2006,3,95,339,241,0.84755916217839,25.1,20.1736263736264,146,983.297467496542,0.71159841136546
27473,531072.201,5336088.384,0,0,0,73.271,0,2007,0,70,319,176,0.804837249752888,229.8,18.3494505494505,106,983.297467496542,0.71159841136546
27473,531072.201,5336088.384,0,0,0,63.985,0,2008,0,88,311,185,0.842466949366023,8.90000000000001,18.8,97,983.297467496542,0.71159841136546
27473,531072.201,5336088.384,165,93,72,48.881,0,2009,1,93,296,161,0.852698367742166,9.4,19.7494505494506,68,983.297467496542,0.71159841136546
27473,531072.201,5336088.384,164,77,87,41.525,0,2010,2,103,311,170,0.803750690758354,64.4,19.4725274725275,67,983.297467496542,0.71159841136546
27473,531072.201,5336088.384,116,78,38,50.716,3,2011,3,78,324,226,0.806121112334266,103.5,18.7505494505494,148,983.297467496542,0.71159841136546
27473,531072.201,5336088.384,133,94,39,58.925,4,2012,1,91,322,161,0.852063230169792,3.2,20.1307692307692,70,983.297467496542,0.71159841136546
27473,531072.201,5336088.384,168,80,88,53.875,0,2013,2,102,310,170,0.839035117330371,-190.8,20.5692307692308,68,983.297467496542,0.71159841136546
27473,531072.201,5336088.384,84,63,21,67.238,3,2014,1,67,346,153,0.840416798460125,65.4,19.2153846153846,86,983.297467496542,0.71159841136546
27473,531072.201,5336088.384,0,0,0,55.859,0,2015,0,94,323,146,0.834698187516589,-212.4,22.3164835164835,52,983.297467496542,0.71159841136546
27473,531072.201,5336088.384,155,94,61,70.593,4,2016,2,86,336,193,0.840578614849863,-31.9,20.4131868131868,107,983.297467496542,0.71159841136546
27473,531072.201,5336088.384,116,96,20,50.01,5,2017,1,91,313,169,0.804337447831332,-70.8,21.2648351648352,78,983.297467496542,0.71159841136546
27473,531072.201,5336088.384,86,59,27,140.288,43,2018,1,17,301,184,0.795200121513195,-135.7,21.9263736263736,167,983.297467496542,0.71159841136546
27473,531072.201,5336088.384,84,77,7,49.342,4,2019,1,99,329,161,0.816979583356253,-112.7,22.0065934065934,62,983.297467496542,0.71159841136546
27473,531072.201,5336088.384,0,0,0,50.678,0,2020,0,81,315,169,0.813632082543999,-111.3,20.3164835164835,88,983.297467496542,0.71159841136546
27474,531072.201,5335856.728,0,0,0,124.601,0,2001,1,42,302,160,0.822751239816607,-14.2,19.5065934065934,118,1032.77995554644,-1.4862025603266
27474,531072.201,5335856.728,86,69,17,47.086,0,2002,1,101,337,169,0.828270838487331,3,19.4725274725275,68,1032.77995554644,-1.4862025603266
27474,531072.201,5335856.728,142,94,48,45.822,6,2003,1,97,327,153,0.835693279665653,-209,24.2648351648352,56,1032.77995554644,-1.4862025603266
27474,531072.201,5335856.728,148,99,49,49.052,0,2004,2,100,319,265,0.919121995566099,104,19.0769230769231,165,1032.77995554644,-1.4862025603266
27474,531072.201,5335856.728,0,0,0,116.262,0,2005,0,44,311,153,0.820676115665208,-49.6,19.2098901098901,109,1032.77995554644,-1.4862025603266
27474,531072.201,5335856.728,195,65,130,33.942,0,2006,2,118,342,160,0.832473363811055,25.1,20.1736263736264,42,1032.77995554644,-1.4862025603266
27474,531072.201,5335856.728,0,0,0,79.276,0,2007,0,65,315,186,0.795534455485929,229.8,18.3494505494505,121,1032.77995554644,-1.4862025603266
27474,531072.201,5335856.728,0,0,0,97.03,0,2008,0,59,309,224,0.832517563801535,8.90000000000001,18.8,165,1032.77995554644,-1.4862025603266
27474,531072.201,5335856.728,167,71,96,45.692,0,2009,2,96,319,154,0.851849734347049,9.4,19.7494505494506,58,1032.77995554644,-1.4862025603266
27474,531072.201,5335856.728,154,81,73,37.626,0,2010,3,107,311,186,0.82616838798127,64.4,19.4725274725275,79,1032.77995554644,-1.4862025603266
27474,531072.201,5335856.728,114,70,44,54.192,3,2011,3,74,334,241,0.8104601439065,103.5,18.7505494505494,167,1032.77995554644,-1.4862025603266
27474,531072.201,5335856.728,101,96,5,57.38,3,2012,1,93,323,162,0.857181384802971,3.2,20.1307692307692,69,1032.77995554644,-1.4862025603266
27474,531072.201,5335856.728,182,93,89,41.66,0,2013,3,113,308,185,0.821841031013859,-190.8,20.5692307692308,72,1032.77995554644,-1.4862025603266
27474,531072.201,5335856.728,93,86,7,57.169,3,2014,2,78,347,161,0.826331508954822,65.4,19.2153846153846,83,1032.77995554644,-1.4862025603266
27474,531072.201,5335856.728,93,93,0,52.267,1,2015,1,97,350,160,0.826077180995885,-212.4,22.3164835164835,63,1032.77995554644,-1.4862025603266
27474,531072.201,5335856.728,161,120,41,55.433,4,2016,1,101,338,185,0.858073882851165,-31.9,20.4131868131868,84,1032.77995554644,-1.4862025603266
27474,531072.201,5335856.728,108,93,15,51.887,5,2017,1,89,317,162,0.815718340204475,-70.8,21.2648351648352,73,1032.77995554644,-1.4862025603266
27474,531072.201,5335856.728,155,75,80,50.86,0,2018,3,95,319,153,0.870489753261636,-135.7,21.9263736263736,58,1032.77995554644,-1.4862025603266
27474,531072.201,5335856.728,139,94,45,50.316,4,2019,1,98,335,162,0.81521859555841,-112.7,22.0065934065934,64,1032.77995554644,-1.4862025603266
27474,531072.201,5335856.728,0,0,0,38.628,0,2020,0,94,324,162,0.811281863488504,-111.3,20.3164835164835,68,1032.77995554644,-1.4862025603266
27475,531072.201,5335625.072,0,0,0,141.543,0,2001,1,28,300,162,0.820892089695527,-14.2,19.5065934065934,134,1071.32427058198,1.29560753142014
27475,531072.201,5335625.072,86,69,17,52.355,1,2002,1,95,337,169,0.832367428627586,3,19.4725274725275,74,1071.32427058198,1.29560753142014
27475,531072.201,5335625.072,142,94,48,53.932,9,2003,1,88,328,153,0.82404051548546,-209,24.2648351648352,65,1071.32427058198,1.29560753142014
27475,531072.201,5335625.072,149,101,48,52.452,0,2004,2,97,325,266,0.889480552325696,104,19.0769230769231,169,1071.32427058198,1.29560753142014
27475,531072.201,5335625.072,0,0,0,112.504,0,2005,0,47,311,152,0.814801856913529,-49.6,19.2098901098901,105,1071.32427058198,1.29560753142014
27475,531072.201,5335625.072,195,64,131,35.871,0,2006,3,116,344,154,0.82167027262425,25.1,20.1736263736264,38,1071.32427058198,1.29560753142014
27475,531072.201,5335625.072,0,0,0,93.278,0,2007,0,54,315,162,0.803792477028806,229.8,18.3494505494505,108,1071.32427058198,1.29560753142014
27475,531072.201,5335625.072,0,0,0,83.868,0,2008,0,71,314,178,0.81973785264988,8.90000000000001,18.8,107,1071.32427058198,1.29560753142014
27475,531072.201,5335625.072,165,74,91,53.52,0,2009,2,89,319,162,0.835500282252136,9.4,19.7494505494506,73,1071.32427058198,1.29560753142014
27475,531072.201,5335625.072,156,81,75,40.532,0,2010,2,104,315,177,0.817073827724896,64.4,19.4725274725275,73,1071.32427058198,1.29560753142014
27475,531072.201,5335625.072,114,71,43,62.197,6,2011,3,65,337,225,0.779729537662212,103.5,18.7505494505494,160,1071.32427058198,1.29560753142014
27475,531072.201,5335625.072,95,94,1,60.516,4,2012,1,89,333,162,0.848415161907898,3.2,20.1307692307692,73,1071.32427058198,1.29560753142014
27475,531072.201,5335625.072,177,93,84,48.952,0,2013,2,106,310,193,0.763065744665138,-190.8,20.5692307692308,87,1071.32427058198,1.29560753142014
27475,531072.201,5335625.072,93,93,0,59.753,3,2014,1,75,345,161,0.811079330618544,65.4,19.2153846153846,86,1071.32427058198,1.29560753142014
27475,531072.201,5335625.072,0,0,0,61.636,0,2015,0,89,348,153,0.802446785594904,-212.4,22.3164835164835,64,1071.32427058198,1.29560753142014
27475,531072.201,5335625.072,154,94,60,70.593,4,2016,2,86,336,192,0.823831115622187,-31.9,20.4131868131868,106,1071.32427058198,1.29560753142014
27475,531072.201,5335625.072,110,94,16,55.893,5,2017,1,85,317,161,0.802164784722327,-70.8,21.2648351648352,76,1071.32427058198,1.29560753142014
27475,531072.201,5335625.072,156,73,83,53.026,0,2018,3,93,317,152,0.892772780508439,-135.7,21.9263736263736,59,1071.32427058198,1.29560753142014
27475,531072.201,5335625.072,138,94,44,57.835,6,2019,1,90,341,160,0.792801123305695,-112.7,22.0065934065934,70,1071.32427058198,1.29560753142014
27475,531072.201,5335625.072,0,0,0,119.321,0,2020,0,24,319,176,0.791376374595393,-111.3,20.3164835164835,152,1071.32427058198,1.29560753142014
27691,531303.858,5336320.041,0,0,0,148.389,0,2001,1,22,340,154,0.834820432075456,-14.2,19.5065934065934,132,896.777599981728,1.24738292350417
27691,531303.858,5336320.041,86,76,10,72.925,6,2002,1,77,336,152,0.811977035229888,3,19.4725274725275,75,896.777599981728,1.24738292350417
27691,531303.858,5336320.041,151,101,50,62.082,10,2003,1,79,342,146,0.824750505292681,-209,24.2648351648352,67,896.777599981728,1.24738292350417
27691,531303.858,5336320.041,145,94,51,64.548,4,2004,1,85,334,137,0.806064943003762,104,19.0769230769231,52,896.777599981728,1.24738292350417
27691,531303.858,5336320.041,137,93,44,77.217,2,2005,2,79,313,146,0.842001424989701,-49.6,19.2098901098901,67,896.777599981728,1.24738292350417
27691,531303.858,5336320.041,181,64,117,67.08,5,2006,2,90,348,153,0.84029767235504,25.1,20.1736263736264,63,896.777599981728,1.24738292350417
27691,531303.858,5336320.041,0,0,0,98.887,0,2007,0,49,309,136,0.806478337688173,229.8,18.3494505494505,87,896.777599981728,1.24738292350417
27691,531303.858,5336320.041,86,75,11,56.825,3,2008,1,94,318,168,0.824673743150034,8.90000000000001,18.8,74,896.777599981728,1.24738292350417
27691,531303.858,5336320.041,160,93,67,56.055,0,2009,1,87,327,160,0.839592608810183,9.4,19.7494505494506,73,896.777599981728,1.24738292350417
27691,531303.858,5336320.041,161,81,80,57.267,1,2010,2,89,314,169,0.815790818024691,64.4,19.4725274725275,80,896.777599981728,1.24738292350417
27691,531303.858,5336320.041,117,78,39,59.451,3,2011,2,68,329,136,0.779626728341998,103.5,18.7505494505494,68,896.777599981728,1.24738292350417
27691,531303.858,5336320.041,132,93,39,65.698,4,2012,1,83,319,160,0.847285686991406,3.2,20.1307692307692,77,896.777599981728,1.24738292350417
27691,531303.858,5336320.041,168,79,89,58.248,1,2013,3,98,332,297,0.860149360190249,-190.8,20.5692307692308,199,896.777599981728,1.24738292350417
27691,531303.858,5336320.041,86,72,14,95.724,8,2014,1,42,351,154,0.832528290374665,65.4,19.2153846153846,112,896.777599981728,1.24738292350417
27691,531303.858,5336320.041,0,0,0,89.757,0,2015,0,61,349,145,0.826615568165914,-212.4,22.3164835164835,84,896.777599981728,1.24738292350417
27691,531303.858,5336320.041,158,95,63,73.405,5,2016,2,83,346,202,0.800480331162619,-31.9,20.4131868131868,119,896.777599981728,1.24738292350417
27691,531303.858,5336320.041,117,97,20,62.452,5,2017,1,79,311,162,0.818622693628713,-70.8,21.2648351648352,83,896.777599981728,1.24738292350417
27691,531303.858,5336320.041,163,56,107,51.946,0,2018,2,94,319,137,0.840984276896805,-135.7,21.9263736263736,43,896.777599981728,1.24738292350417
27691,531303.858,5336320.041,0,0,0,61.753,0,2019,0,86,332,154,0.846371369794788,-112.7,22.0065934065934,68,896.777599981728,1.24738292350417
27691,531303.858,5336320.041,0,0,0,121.236,0,2020,0,22,319,161,0.819640730774169,-111.3,20.3164835164835,139,896.777599981728,1.24738292350417
27692,531303.858,5336088.384,0,0,0,134.559,0,2001,1,34,311,154,0.84166629751892,-14.2,19.5065934065934,120,934.974405255576,-0.0469009194090675
27692,531303.858,5336088.384,86,72,14,54.257,1,2002,1,93,330,168,0.820677136202763,3,19.4725274725275,75,934.974405255576,-0.0469009194090675
27692,531303.858,5336088.384,150,94,56,53.932,9,2003,1,88,330,153,0.821595385627512,-209,24.2648351648352,65,934.974405255576,-0.0469009194090675
27692,531303.858,5336088.384,143,94,49,65.651,4,2004,1,84,335,145,0.795933075122303,104,19.0769230769231,61,934.974405255576,-0.0469009194090675
27692,531303.858,5336088.384,139,109,30,72.914,2,2005,1,83,312,152,0.831148672567145,-49.6,19.2098901098901,69,934.974405255576,-0.0469009194090675
27692,531303.858,5336088.384,182,64,118,68.618,5,2006,3,89,345,272,0.8367451274469,25.1,20.1736263736264,183,934.974405255576,-0.0469009194090675
27692,531303.858,5336088.384,0,0,0,76.797,0,2007,0,67,320,137,0.807145197617176,229.8,18.3494505494505,70,934.974405255576,-0.0469009194090675
27692,531303.858,5336088.384,86,86,0,56.825,3,2008,1,94,315,162,0.816056451696397,8.90000000000001,18.8,68,934.974405255576,-0.0469009194090675
27692,531303.858,5336088.384,165,93,72,51.133,0,2009,1,91,302,153,0.839939897427704,9.4,19.7494505494506,62,934.974405255576,-0.0469009194090675
27692,531303.858,5336088.384,166,77,89,42.533,0,2010,2,102,314,170,0.804008464941362,64.4,19.4725274725275,68,934.974405255576,-0.0469009194090675
27692,531303.858,5336088.384,116,78,38,54.192,3,2011,3,74,326,218,0.774943571021927,103.5,18.7505494505494,144,934.974405255576,-0.0469009194090675
27692,531303.858,5336088.384,133,93,40,63.026,4,2012,1,86,323,161,0.84517137786174,3.2,20.1307692307692,75,934.974405255576,-0.0469009194090675
27692,531303.858,5336088.384,168,80,88,57.289,0,2013,2,99,320,168,0.847087240921869,-190.8,20.5692307692308,69,934.974405255576,-0.0469009194090675
27692,531303.858,5336088.384,86,67,19,79.141,7,2014,1,56,347,153,0.831814698906054,65.4,19.2153846153846,97,934.974405255576,-0.0469009194090675
27692,531303.858,5336088.384,0,0,0,63.473,0,2015,0,87,349,154,0.809810756954256,-212.4,22.3164835164835,67,934.974405255576,-0.0469009194090675
27692,531303.858,5336088.384,155,94,61,77.264,6,2016,1,79,337,169,0.805298576187593,-31.9,20.4131868131868,90,934.974405255576,-0.0469009194090675
27692,531303.858,5336088.384,116,96,20,49.099,5,2017,1,92,309,170,0.795353094522276,-70.8,21.2648351648352,78,934.974405255576,-0.0469009194090675
27692,531303.858,5336088.384,77,54,23,141.597,43,2018,1,16,302,161,0.811607694853734,-135.7,21.9263736263736,145,934.974405255576,-0.0469009194090675
27692,531303.858,5336088.384,82,71,11,51.278,4,2019,1,97,332,161,0.816697378967216,-112.7,22.0065934065934,64,934.974405255576,-0.0469009194090675
27692,531303.858,5336088.384,0,0,0,109.871,0,2020,0,33,316,169,0.82315462854992,-111.3,20.3164835164835,136,934.974405255576,-0.0469009194090675
27693,531303.858,5335856.728,0,0,0,136.799,0,2001,1,32,300,153,0.834469449516032,-14.2,19.5065934065934,121,1023.20975783195,-1.51315411940063
27693,531303.858,5335856.728,84,67,17,54.257,1,2002,1,93,336,170,0.829485319357529,3,19.4725274725275,77,1023.20975783195,-1.51315411940063
27693,531303.858,5335856.728,141,94,47,50.557,9,2003,1,92,331,153,0.823595246623919,-209,24.2648351648352,61,1023.20975783195,-1.51315411940063
27693,531303.858,5335856.728,145,94,51,60.289,0,2004,1,89,322,154,0.804512515612983,104,19.0769230769231,65,1023.20975783195,-1.51315411940063
27693,531303.858,5335856.728,0,0,0,124.905,0,2005,0,36,313,153,0.812237468514549,-49.6,19.2098901098901,117,1023.20975783195,-1.51315411940063
27693,531303.858,5335856.728,194,65,129,35.871,0,2006,5,116,344,265,0.839609063747725,25.1,20.1736263736264,149,1023.20975783195,-1.51315411940063
27693,531303.858,5335856.728,0,0,0,80.565,0,2007,0,64,309,209,0.799896765083162,229.8,18.3494505494505,145,1023.20975783195,-1.51315411940063
27693,531303.858,5335856.728,0,0,0,105.615,0,2008,0,50,308,232,0.83104664640962,8.90000000000001,18.8,182,1023.20975783195,-1.51315411940063
27693,531303.858,5335856.728,166,70,96,49.992,0,2009,2,92,318,160,0.84010101787189,9.4,19.7494505494506,68,1023.20975783195,-1.51315411940063
27693,531303.858,5335856.728,154,81,73,41.525,0,2010,3,103,310,240,0.804601904026163,64.4,19.4725274725275,137,1023.20975783195,-1.51315411940063
27693,531303.858,5335856.728,119,65,54,57.674,3,2011,3,70,336,233,0.798233210831231,103.5,18.7505494505494,163,1023.20975783195,-1.51315411940063
27693,531303.858,5335856.728,93,93,0,63.899,4,2012,1,85,332,161,0.850627030166952,3.2,20.1307692307692,76,1023.20975783195,-1.51315411940063
27693,531303.858,5335856.728,176,94,82,56.253,0,2013,2,100,310,185,0.804291827023515,-190.8,20.5692307692308,85,1023.20975783195,-1.51315411940063
27693,531303.858,5335856.728,86,86,0,69.288,4,2014,1,65,346,161,0.825182404084825,65.4,19.2153846153846,96,1023.20975783195,-1.51315411940063
27693,531303.858,5335856.728,93,93,0,51.131,0,2015,1,98,350,161,0.792736115579127,-212.4,22.3164835164835,63,1023.20975783195,-1.51315411940063
27693,531303.858,5335856.728,153,96,57,73.405,5,2016,1,83,337,177,0.842996564310677,-31.9,20.4131868131868,94,1023.20975783195,-1.51315411940063
27693,531303.858,5335856.728,110,93,17,50.938,5,2017,1,90,320,169,0.807015826176532,-70.8,21.2648351648352,79,1023.20975783195,-1.51315411940063
27693,531303.858,5335856.728,145,75,70,65.082,3,2018,3,82,320,154,0.820630525036341,-135.7,21.9263736263736,72,1023.20975783195,-1.51315411940063
27693,531303.858,5335856.728,140,101,39,55.103,6,2019,1,93,338,160,0.805406894773637,-112.7,22.0065934065934,67,1023.20975783195,-1.51315411940063
27693,531303.858,5335856.728,0,0,0,41.261,0,2020,0,91,320,169,0.812510884449217,-111.3,20.3164835164835,78,1023.20975783195,-1.51315411940063
27694,531303.858,5335625.072,0,0,0,143.976,0,2001,0,26,299,161,0.83505241840011,-14.2,19.5065934065934,135,1037.34113730573,0.486615836098716
27694,531303.858,5335625.072,86,69,17,59.408,1,2002,1,88,340,169,0.832175973245722,3,19.4725274725275,81,1037.34113730573,0.486615836098716
27694,531303.858,5335625.072,141,94,47,57.405,9,2003,1,84,329,152,0.821054151094181,-209,24.2648351648352,68,1037.34113730573,0.486615836098716
27694,531303.858,5335625.072,144,94,50,63.457,3,2004,1,86,326,160,0.814120649112246,104,19.0769230769231,74,1037.34113730573,0.486615836098716
27694,531303.858,5335625.072,0,0,0,131.384,0,2005,0,30,312,153,0.821672044229726,-49.6,19.2098901098901,123,1037.34113730573,0.486615836098716
27694,531303.858,5335625.072,186,64,122,56.165,2,2006,3,98,345,280,0.831732978112953,25.1,20.1736263736264,182,1037.34113730573,0.486615836098716
27694,531303.858,5335625.072,0,0,0,93.278,0,2007,0,54,312,169,0.788944598775388,229.8,18.3494505494505,115,1037.34113730573,0.486615836098716
27694,531303.858,5335625.072,0,0,0,110.643,0,2008,0,45,311,160,0.85552561716723,8.90000000000001,18.8,115,1037.34113730573,0.486615836098716
27694,531303.858,5335625.072,164,73,91,56.055,0,2009,2,87,317,161,0.84358490950636,9.4,19.7494505494506,74,1037.34113730573,0.486615836098716
27694,531303.858,5335625.072,154,81,73,43.554,0,2010,3,101,311,232,0.823912846067732,64.4,19.4725274725275,131,1037.34113730573,0.486615836098716
27694,531303.858,5335625.072,121,66,55,58.557,3,2011,3,69,338,225,0.785717519146622,103.5,18.7505494505494,156,1037.34113730573,0.486615836098716
27694,531303.858,5335625.072,0,0,0,63.026,0,2012,0,86,333,161,0.847780395248194,3.2,20.1307692307692,75,1037.34113730573,0.486615836098716
27694,531303.858,5335625.072,176,94,82,55.12,0,2013,2,101,318,186,0.752743101701883,-190.8,20.5692307692308,85,1037.34113730573,0.486615836098716
27694,531303.858,5335625.072,0,0,0,81.388,0,2014,0,54,347,168,0.811151728090772,65.4,19.2153846153846,114,1037.34113730573,0.486615836098716
27694,531303.858,5335625.072,0,0,0,64.337,0,2015,0,86,348,168,0.768914276783707,-212.4,22.3164835164835,82,1037.34113730573,0.486615836098716
27694,531303.858,5335625.072,153,94,59,72.466,5,2016,1,84,336,177,0.837869771415506,-31.9,20.4131868131868,93,1037.34113730573,0.486615836098716
27694,531303.858,5335625.072,109,93,16,55.893,5,2017,1,85,319,162,0.804749881761006,-70.8,21.2648351648352,77,1037.34113730573,0.486615836098716
27694,531303.858,5335625.072,146,74,72,65.082,3,2018,3,82,319,161,0.818212324263534,-135.7,21.9263736263736,79,1037.34113730573,0.486615836098716
27694,531303.858,5335625.072,138,94,44,57.835,6,2019,1,90,344,160,0.80588253065864,-112.7,22.0065934065934,70,1037.34113730573,0.486615836098716
27694,531303.858,5335625.072,0,0,0,111.017,0,2020,0,32,320,170,0.807208634789012,-111.3,20.3164835164835,138,1037.34113730573,0.486615836098716
27695,531303.858,5335393.415,0,0,0,141.543,0,2001,1,28,320,168,0.858434818530486,-14.2,19.5065934065934,140,966.56314963469,1.47898930977641
27695,531303.858,5335393.415,104,71,33,77.91,6,2002,2,72,323,162,0.842915106990555,3,19.4725274725275,90,966.56314963469,1.47898930977641
27695,531303.858,5335393.415,141,94,47,54.787,9,2003,1,87,326,152,0.817615498715686,-209,24.2648351648352,65,966.56314963469,1.47898930977641
27695,531303.858,5335393.415,135,94,41,65.651,4,2004,1,84,333,168,0.868698948826122,104,19.0769230769231,84,966.56314963469,1.47898930977641
27695,531303.858,5335393.415,0,0,0,128.152,0,2005,0,33,310,153,0.827218858852308,-49.6,19.2098901098901,120,966.56314963469,1.47898930977641
27695,531303.858,5335393.415,186,60,126,54.95,2,2006,3,99,344,273,0.829962767789897,25.1,20.1736263736264,174,966.56314963469,1.47898930977641
27695,531303.858,5335393.415,0,0,0,79.276,0,2007,0,65,304,154,0.822271683435974,229.8,18.3494505494505,89,966.56314963469,1.47898930977641
27695,531303.858,5335393.415,0,0,0,49.235,0,2008,0,101,313,168,0.80965069901758,8.90000000000001,18.8,67,966.56314963469,1.47898930977641
27695,531303.858,5335393.415,155,93,62,42.704,0,2009,1,99,317,154,0.850893271757014,9.4,19.7494505494506,55,966.56314963469,1.47898930977641
27695,531303.858,5335393.415,152,100,52,44.595,0,2010,2,100,315,217,0.928890987647563,64.4,19.4725274725275,117,966.56314963469,1.47898930977641
27695,531303.858,5335393.415,122,74,48,57.674,3,2011,3,70,336,233,0.798034047531899,103.5,18.7505494505494,163,966.56314963469,1.47898930977641
27695,531303.858,5335393.415,86,83,3,64.79,4,2012,1,84,333,168,0.847925057973672,3.2,20.1307692307692,84,966.56314963469,1.47898930977641
27695,531303.858,5335393.415,179,93,86,43.661,0,2013,1,111,313,176,0.812136625357152,-190.8,20.5692307692308,65,966.56314963469,1.47898930977641
27695,531303.858,5335393.415,0,0,0,72.498,0,2014,0,62,341,225,0.837341196041396,65.4,19.2153846153846,163,966.56314963469,1.47898930977641
27695,531303.858,5335393.415,93,93,0,72.296,4,2015,1,77,345,145,0.787917070143656,-212.4,22.3164835164835,68,966.56314963469,1.47898930977641
27695,531303.858,5335393.415,148,94,54,77.264,6,2016,2,79,333,192,0.830488049209504,-31.9,20.4131868131868,113,966.56314963469,1.47898930977641
27695,531303.858,5335393.415,107,93,14,62.452,5,2017,1,79,317,162,0.826973364952966,-70.8,21.2648351648352,83,966.56314963469,1.47898930977641
27695,531303.858,5335393.415,97,79,18,56.362,0,2018,2,90,339,154,0.859977102091339,-135.7,21.9263736263736,64,966.56314963469,1.47898930977641
27695,531303.858,5335393.415,0,0,0,56.906,0,2019,0,91,334,168,0.851497605872269,-112.7,22.0065934065934,77,966.56314963469,1.47898930977641
27695,531303.858,5335393.415,0,0,0,122.207,0,2020,0,21,314,169,0.860770360086199,-111.3,20.3164835164835,148,966.56314963469,1.47898930977641
27750,531303.858,5322652.316,0,0,0,107.144,0,2001,1,56,332,168,0.831119708480474,-19.6,19.9175824175824,112,860.677938307604,0.1849519011419
27750,531303.858,5322652.316,0,0,0,77.787,0,2002,0,71,341,234,0.864377082368989,-1.5,19.8516483516484,163,860.677938307604,0.1849519011419
27750,531303.858,5322652.316,0,0,0,56.096,0,2003,0,84,332,145,0.830896954301428,-210.6,24.6406593406593,61,860.677938307604,0.1849519011419
27750,531303.858,5322652.316,0,0,0,55.406,0,2004,0,93,334,161,0.854855268403029,98,19.4571428571429,68,860.677938307604,0.1849519011419
27750,531303.858,5322652.316,0,0,0,130.301,0,2005,0,29,319,161,0.861163205582964,-53,19.5769230769231,132,860.677938307604,0.1849519011419
27750,531303.858,5322652.316,100,69,31,42.032,0,2006,3,109,340,248,0.866025220128872,20.9,20.5340659340659,139,860.677938307604,0.1849519011419
27750,531303.858,5322652.316,0,0,0,91.898,0,2007,0,54,318,137,0.835080101969613,221.4,18.6978021978022,83,860.677938307604,0.1849519011419
27750,531303.858,5322652.316,0,0,0,92.415,0,2008,0,62,312,161,0.858157878402958,3.5,19.1615384615385,99,860.677938307604,0.1849519011419
27750,531303.858,5322652.316,122,94,28,57.399,0,2009,1,85,329,154,0.860016049388245,3.8,20.121978021978,69,860.677938307604,0.1849519011419
27750,531303.858,5322652.316,148,93,55,52.729,1,2010,2,92,299,241,0.852910565654152,57.2,19.8230769230769,149,860.677938307604,0.1849519011419
27750,531303.858,5322652.316,101,93,8,69.109,11,2011,2,57,330,200,0.845055443734802,98,19.0516483516484,143,860.677938307604,0.1849519011419
27750,531303.858,5322652.316,0,0,0,57.856,0,2012,0,91,304,169,0.870532236201377,-1.5,20.4054945054945,78,860.677938307604,0.1849519011419
27750,531303.858,5322652.316,82,61,21,55.142,0,2013,1,100,313,162,0.860594997053736,-195.6,20.9230769230769,62,860.677938307604,0.1849519011419
27750,531303.858,5322652.316,0,0,0,87.241,0,2014,0,48,346,233,0.868738477961097,58.4,19.4978021978022,185,860.677938307604,0.1849519011419
27750,531303.858,5322652.316,93,93,0,69.226,4,2015,1,79,346,153,0.865383621104202,-215.3,22.6472527472527,74,860.677938307604,0.1849519011419
27750,531303.858,5322652.316,115,94,21,73.981,5,2016,2,81,334,225,0.829350806419423,-36.2,20.6758241758242,144,860.677938307604,0.1849519011419
27750,531303.858,5322652.316,104,93,11,70.248,4,2017,2,71,309,217,0.850892544459685,-75,21.6263736263736,146,860.677938307604,0.1849519011419
27750,531303.858,5322652.316,86,84,2,49.976,0,2018,1,95,317,138,0.837579021376721,-137.6,22.2901098901099,43,860.677938307604,0.1849519011419
27750,531303.858,5322652.316,107,94,13,80.87,9,2019,1,69,339,160,0.83646019500174,-115.5,22.3538461538462,91,860.677938307604,0.1849519011419
27750,531303.858,5322652.316,0,0,0,110.183,0,2020,0,31,306,160,0.844744021095931,-114.8,20.6901098901099,129,860.677938307604,0.1849519011419
27751,531303.858,5322420.659,0,0,0,92.238,0,2001,1,69,329,162,0.834565968997567,-19.6,19.9175824175824,93,845.967897367635,-1.5093405405338
27751,531303.858,5322420.659,104,94,10,74.768,6,2002,1,74,336,176,0.851859438138147,-1.5,19.8516483516484,102,845.967897367635,-1.5093405405338
27751,531303.858,5322420.659,0,0,0,68.593,0,2003,0,71,326,160,0.855496249087716,-210.6,24.6406593406593,89,845.967897367635,-1.5093405405338
27751,531303.858,5322420.659,118,94,24,59.292,0,2004,1,89,338,168,0.837006808220612,98,19.4571428571429,79,845.967897367635,-1.5093405405338
27751,531303.858,5322420.659,93,93,0,75.955,2,2005,2,79,320,185,0.861621839433883,-53,19.5769230769231,106,845.967897367635,-1.5093405405338
27751,531303.858,5322420.659,153,93,60,51.215,1,2006,2,101,346,249,0.851183894205224,20.9,20.5340659340659,148,845.967897367635,-1.5093405405338
27751,531303.858,5322420.659,0,0,0,111.541,0,2007,0,37,317,224,0.840337721270553,221.4,18.6978021978022,187,845.967897367635,-1.5093405405338
27751,531303.858,5322420.659,0,0,0,81.353,0,2008,0,72,312,168,0.888369931410083,3.5,19.1615384615385,96,845.967897367635,-1.5093405405338
27751,531303.858,5322420.659,93,93,0,61.594,4,2009,1,81,329,161,0.86719855598278,3.8,20.121978021978,80,845.967897367635,-1.5093405405338
27751,531303.858,5322420.659,0,0,0,49.296,0,2010,0,95,305,169,0.859113461874756,57.2,19.8230769230769,74,845.967897367635,-1.5093405405338
27751,531303.858,5322420.659,86,86,0,89.336,17,2011,1,36,324,226,0.86068316465488,98,19.0516483516484,190,845.967897367635,-1.5093405405338
27751,531303.858,5322420.659,93,93,0,61.88,3,2012,1,86,306,168,0.867553941105646,-1.5,20.4054945054945,82,845.967897367635,-1.5093405405338
27751,531303.858,5322420.659,0,0,0,54.039,0,2013,0,101,311,169,0.859486049489847,-195.6,20.9230769230769,68,845.967897367635,-1.5093405405338
27751,531303.858,5322420.659,0,0,0,84.821,0,2014,0,50,346,153,0.825476743044185,58.4,19.4978021978022,103,845.967897367635,-1.5093405405338
27751,531303.858,5322420.659,93,93,0,75.791,7,2015,1,72,341,153,0.821082557065343,-215.3,22.6472527472527,81,845.967897367635,-1.5093405405338
27751,531303.858,5322420.659,133,94,39,73.981,5,2016,2,81,331,202,0.834994928535217,-36.2,20.6758241758242,121,845.967897367635,-1.5093405405338
27751,531303.858,5322420.659,101,93,8,71.458,4,2017,1,70,311,162,0.836709682377062,-75,21.6263736263736,92,845.967897367635,-1.5093405405338
27751,531303.858,5322420.659,83,70,13,47.734,0,2018,1,97,314,186,0.83756003101193,-137.6,22.2901098901099,89,845.967897367635,-1.5093405405338
27751,531303.858,5322420.659,99,94,5,73.476,8,2019,1,75,339,161,0.847311439456858,-115.5,22.3538461538462,86,845.967897367635,-1.5093405405338
27751,531303.858,5322420.659,0,0,0,115.379,0,2020,0,26,317,170,0.840173467586001,-114.8,20.6901098901099,144,845.967897367635,-1.5093405405338
27911,531535.514,5336088.384,0,0,0,142.779,0,2001,1,27,303,162,0.798257398890467,-14.2,19.5065934065934,135,940.58114246784,-0.878217882174782
27911,531535.514,5336088.384,86,70,16,59.408,1,2002,1,88,337,154,0.798155222354344,3,19.4725274725275,66,940.58114246784,-0.878217882174782
27911,531535.514,5336088.384,147,97,50,54.787,9,2003,1,87,331,153,0.823710122432579,-209,24.2648351648352,66,940.58114246784,-0.878217882174782
27911,531535.514,5336088.384,138,94,44,68.945,5,2004,1,81,334,153,0.809451471173658,104,19.0769230769231,72,940.58114246784,-0.878217882174782
27911,531535.514,5336088.384,146,94,52,76.135,2,2005,1,80,309,153,0.834615792413459,-49.6,19.2098901098901,73,940.58114246784,-0.878217882174782
27911,531535.514,5336088.384,177,61,116,52.496,1,2006,3,101,348,280,0.832702187984502,25.1,20.1736263736264,179,940.58114246784,-0.878217882174782
27911,531535.514,5336088.384,0,0,0,79.276,0,2007,0,65,325,145,0.816083876589933,229.8,18.3494505494505,80,940.58114246784,-0.878217882174782
27911,531535.514,5336088.384,0,0,0,80.139,0,2008,0,74,315,177,0.829954668431881,8.90000000000001,18.8,103,940.58114246784,-0.878217882174782
27911,531535.514,5336088.384,153,101,52,51.133,0,2009,1,91,314,161,0.843547660705387,9.4,19.7494505494506,70,940.58114246784,-0.878217882174782
27911,531535.514,5336088.384,161,80,81,43.554,0,2010,2,101,310,177,0.833235483042011,64.4,19.4725274725275,76,940.58114246784,-0.878217882174782
27911,531535.514,5336088.384,111,82,29,68.956,11,2011,3,58,331,201,0.775693035922921,103.5,18.7505494505494,143,940.58114246784,-0.878217882174782
27911,531535.514,5336088.384,0,0,0,69.488,0,2012,0,79,306,153,0.834646107958181,3.2,20.1307692307692,74,940.58114246784,-0.878217882174782
27911,531535.514,5336088.384,172,72,100,52.58,0,2013,3,103,303,161,0.842466648502268,-190.8,20.5692307692308,58,940.58114246784,-0.878217882174782
27911,531535.514,5336088.384,84,82,2,86.044,7,2014,1,50,346,160,0.820905972748693,65.4,19.2153846153846,110,940.58114246784,-0.878217882174782
27911,531535.514,5336088.384,0,0,0,69.551,0,2015,0,80,349,168,0.823505867188839,-212.4,22.3164835164835,88,940.58114246784,-0.878217882174782
27911,531535.514,5336088.384,159,123,36,67.739,4,2016,1,89,304,193,0.806376073276126,-31.9,20.4131868131868,104,940.58114246784,-0.878217882174782
27911,531535.514,5336088.384,0,0,0,61.347,0,2017,0,80,314,170,0.814323437557289,-70.8,21.2648351648352,90,940.58114246784,-0.878217882174782
27911,531535.514,5336088.384,0,0,0,136.091,0,2018,0,20,341,152,0.8288436423824,-135.7,21.9263736263736,132,940.58114246784,-0.878217882174782
27911,531535.514,5336088.384,0,0,0,55.996,0,2019,0,92,341,154,0.795344143727846,-112.7,22.0065934065934,62,940.58114246784,-0.878217882174782
27911,531535.514,5336088.384,86,84,2,55.961,12,2020,1,76,315,170,0.817844942781918,-111.3,20.3164835164835,94,940.58114246784,-0.878217882174782
27912,531535.514,5335856.728,0,0,0,142.779,0,2001,2,27,301,161,0.847548599239305,-14.2,19.5065934065934,134,987.01657475787,-1.45374766170413
27912,531535.514,5335856.728,86,77,9,60.511,2,2002,1,87,342,160,0.807755480820591,3,19.4725274725275,73,987.01657475787,-1.45374766170413
27912,531535.514,5335856.728,0,0,0,51.4,0,2003,0,91,329,146,0.811192128107945,-209,24.2648351648352,55,987.01657475787,-1.45374766170413
27912,531535.514,5335856.728,141,108,33,61.327,1,2004,1,88,335,146,0.811807829008928,104,19.0769230769231,58,987.01657475787,-1.45374766170413
27912,531535.514,5335856.728,0,0,0,124.905,0,2005,0,36,315,152,0.822746947369917,-49.6,19.2098901098901,116,987.01657475787,-1.45374766170413
27912,531535.514,5335856.728,176,60,116,67.08,5,2006,3,90,346,274,0.854471890189575,25.1,20.1736263736264,184,987.01657475787,-1.45374766170413
27912,531535.514,5335856.728,0,0,0,78.031,0,2007,0,66,311,146,0.801579658142145,229.8,18.3494505494505,80,987.01657475787,-1.45374766170413
27912,531535.514,5335856.728,86,77,9,68.329,7,2008,1,84,311,162,0.830460299147915,8.90000000000001,18.8,78,987.01657475787,-1.45374766170413
27912,531535.514,5335856.728,147,79,68,48.881,0,2009,2,93,318,153,0.830355304255404,9.4,19.7494505494506,60,987.01657475787,-1.45374766170413
27912,531535.514,5335856.728,163,120,43,44.595,0,2010,1,100,317,170,0.80578308929635,64.4,19.4725274725275,70,987.01657475787,-1.45374766170413
27912,531535.514,5335856.728,114,67,47,60.356,4,2011,3,67,337,241,0.774331055704296,103.5,18.7505494505494,174,987.01657475787,-1.45374766170413
27912,531535.514,5335856.728,0,0,0,63.899,0,2012,0,85,313,153,0.83344505196569,3.2,20.1307692307692,68,987.01657475787,-1.45374766170413
27912,531535.514,5335856.728,175,70,105,53.875,0,2013,3,102,313,161,0.813326423275353,-190.8,20.5692307692308,59,987.01657475787,-1.45374766170413
27912,531535.514,5335856.728,93,54,39,71.412,5,2014,3,63,324,233,0.832314891230232,65.4,19.2153846153846,170,987.01657475787,-1.45374766170413
27912,531535.514,5335856.728,86,80,6,66.912,4,2015,1,83,342,169,0.722220372372175,-212.4,22.3164835164835,86,987.01657475787,-1.45374766170413
27912,531535.514,5335856.728,141,94,47,83.559,10,2016,1,73,311,177,0.827663722042778,-31.9,20.4131868131868,104,987.01657475787,-1.45374766170413
27912,531535.514,5335856.728,111,98,13,62.452,5,2017,1,79,317,162,0.771390195664735,-70.8,21.2648351648352,83,987.01657475787,-1.45374766170413
27912,531535.514,5335856.728,150,94,56,70.722,8,2018,1,77,342,146,0.813978264885813,-135.7,21.9263736263736,69,987.01657475787,-1.45374766170413
27912,531535.514,5335856.728,100,96,4,62.781,6,2019,1,85,345,153,0.77782051804324,-112.7,22.0065934065934,68,987.01657475787,-1.45374766170413
27912,531535.514,5335856.728,0,0,0,79.603,0,2020,0,57,317,177,0.801431541997688,-111.3,20.3164835164835,120,987.01657475787,-1.45374766170413
27913,531535.514,5335625.072,0,0,0,140.321,0,2001,2,29,302,162,0.858056292290845,-14.2,19.5065934065934,133,970.156168315083,-0.103765996865066
27913,531535.514,5335625.072,86,78,8,62.806,4,2002,1,85,342,169,0.839383256926493,3,19.4725274725275,84,970.156168315083,-0.103765996865066
27913,531535.514,5335625.072,0,0,0,62.082,0,2003,0,79,322,146,0.811970341036608,-209,24.2648351648352,67,970.156168315083,-0.103765996865066
27913,531535.514,5335625.072,136,94,42,71.001,5,2004,1,79,331,146,0.817043627558415,104,19.0769230769231,67,970.156168315083,-0.103765996865066
27913,531535.514,5335625.072,0,0,0,132.475,0,2005,0,29,314,152,0.833054235425509,-49.6,19.2098901098901,123,970.156168315083,-0.103765996865066
27913,531535.514,5335625.072,178,60,118,59.998,5,2006,3,95,348,273,0.852707882805129,25.1,20.1736263736264,178,970.156168315083,-0.103765996865066
27913,531535.514,5335625.072,0,0,0,80.565,0,2007,0,64,312,153,0.808459798515384,229.8,18.3494505494505,89,970.156168315083,-0.103765996865066
27913,531535.514,5335625.072,86,78,8,78.88,13,2008,1,75,317,161,0.819119355048923,8.90000000000001,18.8,86,970.156168315083,-0.103765996865066
27913,531535.514,5335625.072,149,93,56,46.733,0,2009,1,95,308,146,0.826899255396828,9.4,19.7494505494506,51,970.156168315083,-0.103765996865066
27913,531535.514,5335625.072,160,93,67,51.429,0,2010,1,94,316,170,0.818366214966505,64.4,19.4725274725275,76,970.156168315083,-0.103765996865066
27913,531535.514,5335625.072,113,65,48,66.971,10,2011,3,60,338,233,0.785769778708613,103.5,18.7505494505494,173,970.156168315083,-0.103765996865066
27913,531535.514,5335625.072,0,0,0,63.899,0,2012,0,85,307,153,0.837722374654369,3.2,20.1307692307692,68,970.156168315083,-0.103765996865066
27913,531535.514,5335625.072,171,63,108,63.222,6,2013,2,93,309,160,0.805597131296041,-190.8,20.5692307692308,67,970.156168315083,-0.103765996865066
27913,531535.514,5335625.072,86,53,33,92.257,7,2014,1,45,328,234,0.860911959618545,65.4,19.2153846153846,189,970.156168315083,-0.103765996865066
27913,531535.514,5335625.072,86,81,5,120.183,34,2015,1,33,343,160,0.774345244249423,-212.4,22.3164835164835,127,970.156168315083,-0.103765996865066
27913,531535.514,5335625.072,141,94,47,81.389,9,2016,1,75,334,162,0.810576437940929,-31.9,20.4131868131868,87,970.156168315083,-0.103765996865066
27913,531535.514,5335625.072,109,93,16,67.885,5,2017,1,74,319,161,0.786995122668669,-70.8,21.2648351648352,87,970.156168315083,-0.103765996865066
27913,531535.514,5335625.072,151,94,57,65.082,3,2018,1,82,340,161,0.821025596153362,-135.7,21.9263736263736,79,970.156168315083,-0.103765996865066
27913,531535.514,5335625.072,0,0,0,69.493,0,2019,0,79,346,153,0.812104143404408,-112.7,22.0065934065934,74,970.156168315083,-0.103765996865066
27913,531535.514,5335625.072,0,0,0,74.828,0,2020,0,61,316,170,0.810224709272733,-111.3,20.3164835164835,109,970.156168315083,-0.103765996865066
27914,531535.514,5335393.415,0,0,0,143.976,0,2001,1,26,340,168,0.8692466216155,-14.2,19.5065934065934,142,927.942771646123,0.836652615797249
27914,531535.514,5335393.415,98,93,5,97.809,10,2002,1,56,341,161,0.847877002248794,3,19.4725274725275,105,927.942771646123,0.836652615797249
27914,531535.514,5335393.415,136,93,43,63.061,10,2003,1,78,323,153,0.83095347373901,-209,24.2648351648352,75,927.942771646123,0.836652615797249
27914,531535.514,5335393.415,127,95,32,71.001,5,2004,1,79,320,153,0.833101061712593,104,19.0769230769231,74,927.942771646123,0.836652615797249
27914,531535.514,5335393.415,0,0,0,134.699,0,2005,0,27,317,152,0.835641899960288,-49.6,19.2098901098901,125,927.942771646123,0.836652615797249
27914,531535.514,5335393.415,181,93,88,58.71,4,2006,2,96,347,240,0.824180947634076,25.1,20.1736263736264,144,927.942771646123,0.836652615797249
27914,531535.514,5335393.415,0,0,0,81.912,0,2007,0,63,301,154,0.833709468428259,229.8,18.3494505494505,91,927.942771646123,0.836652615797249
27914,531535.514,5335393.415,86,70,16,67.241,6,2008,1,85,313,170,0.832692863210067,8.90000000000001,18.8,85,927.942771646123,0.836652615797249
27914,531535.514,5335393.415,144,66,78,51.133,0,2009,2,91,320,161,0.863042460439337,9.4,19.7494505494506,70,927.942771646123,0.836652615797249
27914,531535.514,5335393.415,145,93,52,46.755,0,2010,1,98,312,161,0.831860241591544,64.4,19.4725274725275,63,927.942771646123,0.836652615797249
27914,531535.514,5335393.415,110,69,41,74.719,15,2011,3,52,330,233,0.800714639902037,103.5,18.7505494505494,181,927.942771646123,0.836652615797249
27914,531535.514,5335393.415,86,80,6,63.026,4,2012,1,86,339,161,0.856206972774262,3.2,20.1307692307692,75,927.942771646123,0.836652615797249
27914,531535.514,5335393.415,166,146,20,89.126,21,2013,1,70,301,177,0.812254965749389,-190.8,20.5692307692308,107,927.942771646123,0.836652615797249
27914,531535.514,5335393.415,85,52,33,93.452,7,2014,1,44,326,225,0.929186922056536,65.4,19.2153846153846,181,927.942771646123,0.836652615797249
27914,531535.514,5335393.415,93,93,0,81.356,8,2015,1,68,349,169,0.775498842627571,-212.4,22.3164835164835,101,927.942771646123,0.836652615797249
27914,531535.514,5335393.415,151,93,58,69.641,4,2016,1,87,334,177,0.782223669241413,-31.9,20.4131868131868,90,927.942771646123,0.836652615797249
27914,531535.514,5335393.415,0,0,0,70.161,0,2017,0,72,355,329,0.861374886522172,-70.8,21.2648351648352,257,927.942771646123,0.836652615797249
27914,531535.514,5335393.415,0,0,0,50.86,0,2018,0,95,342,161,0.857619846142577,-135.7,21.9263736263736,66,927.942771646123,0.836652615797249
27914,531535.514,5335393.415,131,94,37,61.753,6,2019,1,86,344,153,0.833464225048881,-112.7,22.0065934065934,67,927.942771646123,0.836652615797249
27914,531535.514,5335393.415,0,0,0,117.437,0,2020,0,26,321,184,0.837675351327574,-111.3,20.3164835164835,158,927.942771646123,0.836652615797249
27916,531535.514,5334930.103,0,0,0,135.67,0,2001,1,33,342,177,0.862140950838525,-14.2,19.5065934065934,144,985.050677983636,-1.41384603500716
27916,531535.514,5334930.103,0,0,0,54.257,0,2002,0,93,308,168,0.823090899411807,3,19.4725274725275,75,985.050677983636,-1.41384603500716
27916,531535.514,5334930.103,137,94,43,45.822,6,2003,1,97,328,153,0.837547360831673,-209,24.2648351648352,56,985.050677983636,-1.41384603500716
27916,531535.514,5334930.103,135,107,28,53.489,0,2004,1,96,337,170,0.815770898393863,104,19.0769230769231,74,985.050677983636,-1.41384603500716
27916,531535.514,5334930.103,0,0,0,65.397,0,2005,0,90,310,154,0.850925721139475,-49.6,19.2098901098901,64,985.050677983636,-1.41384603500716
27916,531535.514,5334930.103,187,97,90,32.975,0,2006,1,119,345,169,0.838316216944132,25.1,20.1736263736264,50,985.050677983636,-1.41384603500716
27916,531535.514,5334930.103,0,0,0,86.296,0,2007,0,60,301,168,0.846994994034884,229.8,18.3494505494505,108,985.050677983636,-1.41384603500716
27916,531535.514,5334930.103,0,0,0,44.279,0,2008,0,105,314,170,0.843478589015128,8.90000000000001,18.8,65,985.050677983636,-1.41384603500716
27916,531535.514,5334930.103,135,93,42,44.675,0,2009,1,97,333,161,0.874775308803133,9.4,19.7494505494506,64,985.050677983636,-1.41384603500716
27916,531535.514,5334930.103,153,93,60,40.532,0,2010,2,104,309,216,0.875897845292725,64.4,19.4725274725275,112,985.050677983636,-1.41384603500716
27916,531535.514,5334930.103,115,68,47,53.325,3,2011,2,75,321,160,0.82967019598071,103.5,18.7505494505494,85,985.050677983636,-1.41384603500716
27916,531535.514,5334930.103,0,0,0,60.516,0,2012,0,89,304,168,0.867070841500884,3.2,20.1307692307692,79,985.050677983636,-1.41384603500716
27916,531535.514,5334930.103,173,64,109,42.653,0,2013,2,112,311,177,0.856890218992808,-190.8,20.5692307692308,65,985.050677983636,-1.41384603500716
27916,531535.514,5334930.103,0,0,0,64.303,0,2014,0,70,353,225,0.938036371161709,65.4,19.2153846153846,155,985.050677983636,-1.41384603500716
27916,531535.514,5334930.103,0,0,0,129.977,0,2015,0,24,346,160,0.829321291999978,-212.4,22.3164835164835,136,985.050677983636,-1.41384603500716
27916,531535.514,5334930.103,0,0,0,59.597,0,2016,0,97,347,216,0.849021598010716,-31.9,20.4131868131868,119,985.050677983636,-1.41384603500716
27916,531535.514,5334930.103,103,93,10,108.97,13,2017,2,39,324,202,0.851658661564871,-70.8,21.2648351648352,163,985.050677983636,-1.41384603500716
27916,531535.514,5334930.103,147,97,50,60.79,1,2018,1,86,354,160,0.858224266124992,-135.7,21.9263736263736,74,985.050677983636,-1.41384603500716
27916,531535.514,5334930.103,127,93,34,58.784,6,2019,1,89,337,162,0.845521712271047,-112.7,22.0065934065934,73,985.050677983636,-1.41384603500716
27916,531535.514,5334930.103,0,0,0,101.92,0,2020,0,39,317,168,0.849921090057139,-111.3,20.3164835164835,129,985.050677983636,-1.41384603500716
28130,531767.17,5336088.384,0,0,0,146.262,0,2001,1,24,325,162,0.848500523594953,-14.2,19.5065934065934,138,882.026192106106,-1.52103570752254
28130,531767.17,5336088.384,86,72,14,74.884,6,2002,1,75,335,152,0.807995951218099,3,19.4725274725275,77,882.026192106106,-1.52103570752254
28130,531767.17,5336088.384,145,93,52,58.309,9,2003,1,83,333,145,0.822348931367691,-209,24.2648351648352,62,882.026192106106,-1.52103570752254
28130,531767.17,5336088.384,139,97,42,67.88,5,2004,1,82,337,153,0.830009681688807,104,19.0769230769231,71,882.026192106106,-1.52103570752254
28130,531767.17,5336088.384,0,0,0,136.996,0,2005,0,25,313,154,0.844881700417747,-49.6,19.2098901098901,129,882.026192106106,-1.52103570752254
28130,531767.17,5336088.384,172,62,110,64.115,5,2006,2,92,348,161,0.825907592179908,25.1,20.1736263736264,69,882.026192106106,-1.52103570752254
28130,531767.17,5336088.384,0,0,0,87.612,0,2007,0,59,325,146,0.828502268513729,229.8,18.3494505494505,87,882.026192106106,-1.52103570752254
28130,531767.17,5336088.384,0,0,0,56.825,0,2008,0,94,317,177,0.828309034914823,8.90000000000001,18.8,83,882.026192106106,-1.52103570752254
28130,531767.17,5336088.384,0,0,0,54.775,0,2009,0,88,318,154,0.854810710246192,9.4,19.7494505494506,66,882.026192106106,-1.52103570752254
28130,531767.17,5336088.384,159,79,80,49.033,0,2010,2,96,314,168,0.830550102444258,64.4,19.4725274725275,72,882.026192106106,-1.52103570752254
28130,531767.17,5336088.384,114,93,21,55.069,3,2011,1,73,325,153,0.81099245824319,103.5,18.7505494505494,80,882.026192106106,-1.52103570752254
28130,531767.17,5336088.384,0,0,0,64.79,0,2012,0,84,305,152,0.831841305249637,3.2,20.1307692307692,68,882.026192106106,-1.52103570752254
28130,531767.17,5336088.384,165,72,93,59.216,2,2013,2,97,310,161,0.837273531398078,-190.8,20.5692307692308,64,882.026192106106,-1.52103570752254
28130,531767.17,5336088.384,0,0,0,89.796,0,2014,0,47,345,160,0.825808398366759,65.4,19.2153846153846,113,882.026192106106,-1.52103570752254
28130,531767.17,5336088.384,0,0,0,84.767,0,2015,0,65,352,322,0.812202982901768,-212.4,22.3164835164835,257,882.026192106106,-1.52103570752254
28130,531767.17,5336088.384,160,94,66,65.695,4,2016,2,91,304,192,0.803315005353895,-31.9,20.4131868131868,101,882.026192106106,-1.52103570752254
28130,531767.17,5336088.384,0,0,0,69.008,0,2017,0,73,325,160,0.832941969058233,-70.8,21.2648351648352,87,882.026192106106,-1.52103570752254
28130,531767.17,5336088.384,0,0,0,138.934,0,2018,0,18,342,146,0.837995285826911,-135.7,21.9263736263736,128,882.026192106106,-1.52103570752254
28130,531767.17,5336088.384,0,0,0,72.044,0,2019,0,77,341,153,0.822362163476703,-112.7,22.0065934065934,76,882.026192106106,-1.52103570752254
28130,531767.17,5336088.384,86,84,2,68.556,14,2020,1,66,314,170,0.811518125759107,-111.3,20.3164835164835,104,882.026192106106,-1.52103570752254
28131,531767.17,5335856.728,0,0,0,141.543,0,2001,1,28,321,161,0.856738613813471,-14.2,19.5065934065934,133,909.051637661013,-1.51614012466729
28131,531767.17,5335856.728,86,82,4,74.884,6,2002,1,75,346,161,0.812806304737745,3,19.4725274725275,86,909.051637661013,-1.51614012466729
28131,531767.17,5335856.728,93,93,0,51.4,9,2003,1,91,330,146,0.81873854811951,-209,24.2648351648352,55,909.051637661013,-1.51614012466729
28131,531767.17,5335856.728,135,94,41,71.001,5,2004,1,79,338,153,0.830306302041613,104,19.0769230769231,74,909.051637661013,-1.51614012466729
28131,531767.17,5335856.728,0,0,0,140.635,0,2005,0,22,316,153,0.835325452165967,-49.6,19.2098901098901,131,909.051637661013,-1.51614012466729
28131,531767.17,5335856.728,177,60,117,61.319,5,2006,3,94,346,280,0.849666400898876,25.1,20.1736263736264,186,909.051637661013,-1.51614012466729
28131,531767.17,5335856.728,0,0,0,79.276,0,2007,0,65,327,145,0.808823465115116,229.8,18.3494505494505,80,909.051637661013,-1.51614012466729
28131,531767.17,5335856.728,86,83,3,77.652,13,2008,1,76,312,162,0.847782322803083,8.90000000000001,18.8,86,909.051637661013,-1.51614012466729
28131,531767.17,5335856.728,151,81,70,51.133,0,2009,2,91,315,154,0.842542208244088,9.4,19.7494505494506,63,909.051637661013,-1.51614012466729
28131,531767.17,5335856.728,161,101,60,46.755,0,2010,2,98,317,241,0.813178208156546,64.4,19.4725274725275,143,909.051637661013,-1.51614012466729
28131,531767.17,5335856.728,113,67,46,63.131,7,2011,3,64,326,257,0.783697417467701,103.5,18.7505494505494,193,909.051637661013,-1.51614012466729
28131,531767.17,5335856.728,0,0,0,78.262,0,2012,0,70,312,146,0.828831848422744,3.2,20.1307692307692,76,909.051637661013,-1.51614012466729
28131,531767.17,5335856.728,171,69,102,62.199,5,2013,2,94,308,169,0.80901638034331,-190.8,20.5692307692308,75,909.051637661013,-1.51614012466729
28131,531767.17,5335856.728,86,52,34,111.863,13,2014,1,27,328,233,0.818933257984844,65.4,19.2153846153846,206,909.051637661013,-1.51614012466729
28131,531767.17,5335856.728,86,80,6,78.176,8,2015,1,71,346,161,0.717003745128088,-212.4,22.3164835164835,90,909.051637661013,-1.51614012466729
28131,531767.17,5335856.728,145,101,44,76.276,6,2016,2,80,339,217,0.791043772510736,-31.9,20.4131868131868,137,909.051637661013,-1.51614012466729
28131,531767.17,5335856.728,109,93,16,76.462,6,2017,1,67,320,161,0.791708548982417,-70.8,21.2648351648352,94,909.051637661013,-1.51614012466729
28131,531767.17,5335856.728,156,98,58,60.79,1,2018,1,86,340,152,0.833024316738682,-135.7,21.9263736263736,66,909.051637661013,-1.51614012466729
28131,531767.17,5335856.728,0,0,0,72.044,0,2019,0,77,346,153,0.785020442062309,-112.7,22.0065934065934,76,909.051637661013,-1.51614012466729
28131,531767.17,5335856.728,0,0,0,118.376,0,2020,0,25,317,178,0.804787131884506,-111.3,20.3164835164835,153,909.051637661013,-1.51614012466729
